*** 1 - 50 (/course/1969831/strongs-numbers-biblical-hebrew/1/)	
אֵת	a (accusative case)
יְהוֹוָה יִראֶה	Jehovah-jireh
יְהוֹוָה נִסִּי	Jehovah-nissi
יְהוֹוָה צִּדקֵנוּ	the LORD is our righteousness
יְהוֹוָה שָׁלוֹם	"Jehovah-Shalom, Jehovah is peace"
יְהוֹוָה שָׁמָּה	Jehovah-shammah
יְהוֹוָה	LORD
עַל	"over, upon, above"
אֵל אֶל	"to, into, towards, against"
אֲשֶׁר	"which, who, that"
כּוֹל כּוֹל	"all, the whole"
אָמַר	to say
לוֹא לוֹה	"no, not"
בֵּן	son
כִּי	"because, that, for, when"
הָיָה	"to come, become, come to pass"
עָשָׂה	to accomplish
אֱלוֹהִים	God
בּוֹא	to come
מֶלֶך	king
יִשׂרָאֵל	"Israel, ""God strives"""
אֶרֶץ	"land, earth"
יוֹם	day
פָּנִים	"face, faces, before"
בַּיִת	house
נָתַן	"to give, put, set"
אִישׁ	man
הוּא הִיא	"he, she, it"
עַם	"folk, men, nation, people"
יָד	hand
הָלַך	"to go, come, walk"
דָּבָר	"word, speech"
רָאָה	to see
עַד	"until, as far as, while"
מִן	"from, than"
אָב	father
זֶה	this
שָׁמַע	to hear
דָּבַר	to speak
עִיר	excitement
אַת	"you, yourself"
יָשַׁב	"to sit, remain, dwell"
דָּוִד דָּוִידּ	David
אִם	if
יָצָא	to go out
שׁוּב	"to return, turn back"
עִם	"with, against"
אֶחָד	one
לָקַח	to take
יָדַע	to know
*** 51 - 100 (/course/1969831/strongs-numbers-biblical-hebrew/2/)	
עָלָה	"to go up, ascend, climb"
עַיִן	eye
שָׁנֶה שָׁנָה	year
אֲנִי	"I, Myself"
שֵׁם	name
שָׁלַח	to send
הִנֵּה	behold
מוּת	to die
שָׁם	"there, thither"
הֵם הֵמָּה	like
יְהוּדָה	Judah
אָכַל	to eat
אֵת	with (denoting proximity)
עֶבֶד	"slave, servant"
אַיִן	nothing
הֲדַרעֶזֶר	Hadarezer
אִשָּׁה נָשִׁים	"woman, wife"
שְׁנַיִם שְׁתּתַּיִם	two
גַּם	"also, moreover"
כֵּן	"so, thus"
מוֹשֶׁה	Moses
נֶפֶשׁ	"soul, living being, life, self, person, desire, passion, emotion"
כּוֹהֵן	priest
אֵלֶּה	these
מָה	what? how?
קָרָא	"to call, proclaim, read"
אַל	not
אַחַר	"after, the following part"
דֶּרֶך	"way, road, distance"
רַע רָעָה	adversity
נָשָׂא נָסָה	"lift, carry"
יְרוּשָׁלִַם יְרוּשָׁלַיִם	Jerusalem
אָח	brother
קוּם	"to arise, stand up"
מִצרַיִם	Egypt
יְהוֹוִה	God (yeh-ho-vee')
זוֹאתּ	"likewise, same"
רוֹאשׁ	head
לֵב	"heart, inner man, mind, will"
בַּת	daughter
שׂוּם שִׂים	"to put, place, set"
מַיִם	water(s)
מֵאָה מֵאיָה	hundred
כּוֹה	"thus, here"
טּוֹב	beautiful
גּוֹי גּוֹי	"nation, people"
עָבַר	to alienate
אָדָם	"man, mankind"
הַר	"mountain, hill"
*** 101 - 150 (/course/1969831/strongs-numbers-biblical-hebrew/3/)	
גָּדוֹל גָּדוֹל	great
עָמַד	stand
קוֹל	"sound, voice"
אֶלֶף	thousand
תַּחַת	"underneath, below"
חַי	age
נָכָה	"struck, smite"
יָלַד	"to bear, bring forth"
פֶּה	mouth
צָּוָה	"command, lay charge, give charge"
עוֹד עוֹד	"again, continuance"
צָּבָא צֶּבָאָה	"army, war, warfare"
שָׁמַר	"keep, watch"
קוֹדֶשׁ	"holy, apartness, sacredness"
רַב	abundance
מָצָא	find
אֲדוֹנָי	Lord
עוֹלָם עוֹלָם	"long duration, forever"
נָפַל	"fall, lie"
עַתּתָּה	now
שָׁלוֹשׁ שְׁלוֹשָׁה	three
מִי	who
מִשׁפָּט	"judgement, justice"
שָׁמַיִם שָׁמֶה	"heaven, sky"
שַׂר	"chief, ruler, prince"
תָּוֶך	midst
חֶרֶב	sword
בֵּין	"interval, space between"
שָׁאוּל	"Saul, asked of Yah"
כֶּסֶף	"silver, money"
נָא	I/we pray
מִזבֵַּח	altar
מָקוֹם מְקוֹמָה	place
יָם	sea
שֶׁבַע שִׁבעָה	seven
זָהָב	gold
יָרַד	come or go down
אֵשׁ	fire
רוַּח	"breath, wind, spirit"
נְאוּם	"utterance, declares"
בָּנָה	build
שַׁעַר	gate
נָגַד	to be conspicuous
יוֹשֵׁב בַּשֶּׁבֶת	"Josheb-basshebeth, ""sitting in the seat"""
אֵל אֱלוֹהֵי יִשׂרָאֵל	"El-Elohe-Israel, ""the mighty God of Israel"""
אֵל בֵּיתּ ־ אֵל	"El-bethel, ""the God of Bethel"""
דָּם	blood
אָנוֹכִי	"I, myself"
יַעֲקוֹב	Jacob
מָלַך	consult
*** 151 - 200 (/course/1969831/strongs-numbers-biblical-hebrew/4/)	
אַהֲרוֹן	Aaron
דִּי	"who, which, that"
אוֹהֶל	tent
חָמֵשׁ חֲמִשָּׁה	five
עָשָׂר	ten
סָבִיבּ סֶבִיבָּה	"circuit, round about"
שָׂדֶה שָׂדַי	"field, land"
יָרֵא	to affright
בָּרַך	"to kneel, bless"
עָנָה	to testify
עֵץ	"tree, wood"
אָדוֹן אָדוֹן	lord
כְּלִי	"utensil, article, vessel"
אוֹ אַו	or
מִלחָמָה	"battle, war"
אַרבַּע אַרבָּעָה	four
הֵן	behold
נָבִיא	"prophet, spokesman, speaker"
גְּדוּדָה	cutting
עֶשׂרִים	twenty
מִשׁפָּחָה	"family, clan"
פָּקַד	"to attend to, visit, muster, appoint"
מְאוֹד	very
סוּר שׂוּר	"to turn aside, depart"
לֶחֶם	bread
חַטָּאָה חַטָּאתּ	sin
עֵת	time
שְׁלוֹמוֹה	Solomon
לֵוִיִי לֵוִי	Levites
חָזַק	"to be firm, strong, to strengthen"
כָּרַת	"to cut off, cut down"
עָבַד	"to serve, work"
עוֹלָה עוֹלָה	ascent
פְּלִשׁתִּי	Philistines
בְּרִיתּ	covenant
קָרַב	"to come near, approach"
חוֹדֶשׁ	"month, new moon"
אוֹיֵב אוֹיֵב	"enemy, foe"
אַף	"anger, nostril, nose"
צּוֹאן צְּאוֹן	flock
אֶבֶן	stone
מַעַן	"purpose, intent"
עָוַן	eye
מִדבָּר	desert
בָּשָׂר	flesh
פַּרעוֹה	Pharaoh
חָיָה	to live
בָּבֶל	Babylon
רָשָׁע	"wicked, criminal"
חֲמוֹרָה	heap
*** 201 - 250 (/course/1969831/strongs-numbers-biblical-hebrew/5/)	
אַרבַּע	Arba
מָלֵא מָלָא	"to be full, to fill"
לֵבָב	heart
מַטֶּה מַטָּה	tribe
אֵל	God
אַמָּה	cubits
חֵסֵד	favour
רֶגֶל	feet
גְּבוּל גֶּבוּל	border
נַעַר	men
חָטָא	"to miss, to go wrong, to sin"
שָׁלוֹם שָׁלוֹם	peace
מַעֲשֶׂה	work
לַיְלָה	night
זָכַר	to remember
יָרַשׁ יָרֵשׁ	to possess
עָווֹן עָווֹן	iniquity
זֶרַע	descendants
רָבָה	to multiply
כָּתַב	to write
קֶרֶב	midst
אֲדָמָה	land
בָּקַשׁ	to seek
חַיִל	army
מוֹעֵד	meeting
נַחֲלָה	inheritance
אֱנוֹשׁ	man
אֵם	mother
כּוּן	"to be firm, to establish"
תּוֹרָה תּוֹרָה	law
יְהוֹשׁוַּע יְהוֹשׁוַּע	Joshua
בֶּגֶד	apparel
שָׁתָה	to drink
מַחֲנֶה	camp
שֵׁשׁ שִׁשָּׁה	six
אִישׁ־חַיִל	valiant
אִישׁ ־ טּוֹב	Ish-tob
בּוֹקֶר	morning
יוֹסֵף	Joseph
מַלאָך	angel
נָטָה	"to stretch out, to spread out, to extend, to incline, to bend"
נָצַל	to deliver
יָסַף	to add
מִנחָה	offering
עָזַב	self
אָהַב אָהֵב	to love
שָׁכַב	to lie down
יָשַׁע	to deliver
צַּדִּיק	"just, righteous"
כָּלָה	to be complete
*** 251 - 300 (/course/1969831/strongs-numbers-biblical-hebrew/6/)	
שָׁפַט	to judge
אָסַף	to gather
אָרוֹן אָרוֹן	"ark, chest"
בַּד	"alone, separation"
כָּבוֹד כָּבוֹד	glorious
כַּף	"hand, palm"
שֶׁמֶן	"oil, fat"
יָכוֹל יָכוֹל	to be able
בְּהֵמָה	cattle
שֵׁבֶט	"tribe, rod, staff"
חָצֵר	court
רוּם	to be exalted
אוֹזֶן	ear
שָׁבַע	to swear
סֵפֶר סִפרָה	book
רָאֶה	"conscious, seeing"
רֵַע רֵיַע	neighbor
גָּלָה	to uncover
אָבַד	to perish
אַיִל	ram
בָּקָר	"cattle, herd, an ox"
יַרדֵּן	Jordan
רִאשׁוֹן רִאשׁוֹן	"first, chief"
מוֹאָב	Moab
מִצוָה	commandment
אֶפרַיִם	Ephraim
מֶלֶך	king
זָקֵן	elders
חֶסֶד	Hesed
לָחַם	to devour
עֶשֶׂר עֲשָׂרָה	ten
אַברָהָם	Abraham
קָדַשׁ	"to be set apart, to be consecrated"
שָׂפָה שֶׂפֶת	lips
שְׁלוֹשִׁים שְׁלוֹשִׁים	thirty
שָׁאַל שָׁאֵל	to ask
שָׁחָה	to worship
בִּין	"to understand, to discern"
בִּניָמִין	Benjamin
דּוֹר דּוֹר	generation
הָרַג	"to kill, to slay"
מְלָאכָּה	work
אַחֵר	other
הָלַל	to shine
דָּרַשׁ	to seek
חוּץ חוּץ	outside
פֶּתַח	doorway
רָעָה	to break
חֲמִשִּׁים	fifty
זֶבַח	sacrifice
*** 301 - 350 (/course/1969831/strongs-numbers-biblical-hebrew/7/)	
אַך	surely
טָּמֵא	to be unclean
סָפַר	"to tell, to recount"
גִּבּוֹר גִּבּוֹר	"strong, mighty"
נוּס	"to flee, to escape"
סָבַב	to surround
צְּדָקָה	righteousness (tsedaqah)
שֵׁנִי	second
מָוֶת	death
צָּפוֹן צָּפוֹן	north
בָּחַר	to choose
כָּסָה	to cover
נַעַר	scattered
צִּיוֹן	Zion
אַשּׁוּר אַשּׁוּר	Asshur
נֶגֶד	before
נָגַע	to touch
שָׂמַח	"to rejoice, to be glad"
חָכמָה	wisdom
עֵדָה	congregation
שָׁבַר	to break
יִרמְיָה יִרמְיָהוּ	Jeremiah
רוֹב	abundance
שָׁחַת	to destroy
שָׂנֵא	to hate
מְנַשֶּׁה	Manasseh
נָסַע	"to journey, to set out"
יוֹאָב	Joab
עֲבוֹדָה עֲבוֹדָה	"labor, service"
פָּתַח	to appear
רָדַף	to pursue
חָלַל	to pierce
חָנָה	"to decline, to bend down"
אָז	"at that time, then"
יַחַד	"unitedness, together"
יַיִן	wine
נַחַל נַחלָה	brook
כְּמוֹ כָּמוֹ	"like, as, when"
מַעַל	"upwards, above"
נְחוֹשֶׁת	"copper, bronze"
שְׁמוּאֵל	Samuel
יָמִין	right hand
מִשׁכָּן	"dwelling place, tabernacle"
סוּס סוּס	crane
יֵשׁ	"being, substance, existence, is"
חָכָם	wise
אַרבָּעִים	forty
כִּסֵּא כִּסֵּה	throne
פָּנָה	to turn
אַף	also
*** 351 - 400 (/course/1969831/strongs-numbers-biblical-hebrew/8/)	
גִּלעָד	Gilead
זָבַח	to slaughter for sacrifice
מִספָּר	number
נָשִׂיא נָשִׂא	captain
עֶרֶב	evening
שֶׁמֶשׁ	sun
אֲרָם	Aram
חוֹמָה	wall
פֵּן	"or, lest"
פַּר פָּר	bull
שָׁאַר	"to remain, to be left over"
קָבַר	to bury
אָבֵל כְּרָמִים	Abel-keramim
חִזקִיָה חִזקִיָהוּ	Hezekiah
בַּיִת	Bajith
שָׁכַן	"to settle down, to abide, to dwell"
אֶמֶת	"truth, firmness, faithfulness"
חֲמַת רַבָּה	Rabbah
קָבַץ	"to gather, to collect"
חוֹק	statute
עֶצֶם	"bone, substance"
חֵצִי	half
כּוַֹח כּוַֹח	ability
נָגַשׁ	"to draw near, approach"
שָׁלַך	"to throw, to cast"
חָשַׁב	to think
קָהָל	assembly
אוֹר	light
חֵמָה חֵמָא	"wrath, heat, rage"
לָכַד	"to capture, to seize"
בָּטַח	to trust
יָשָׁר	"upright, straight"
רֶכֶב	chariot
אֲנַחנוּ	"we, ourselves"
בְּכוֹר	firstborn
נָהָר	"river, stream"
פְּרִי	fruit
פַּעַם פַּעֲמָה	"anvil, footstep, this once"
צֶּדֶק	"rightness, righteousness (tsedeq)"
קָדוֹשׁ קָדוֹשׁ	"holy, sacred"
לָשׁוֹן לָשׁוֹן	tongue
מַמלָכָה	"kingdom, reign"
שָׂרַף	to burn
תּוֹעֵבַה תּוֹעֵבַה	abomination
בָּכָה	to weep
קָטַר	to make sacrifices smoke
שָׁלַם	to amend
גָּדַל	to grow up
כָּבַד כָּבֵד	"to be heavy, weighty"
מִגרָשׁ מִגרָשָׁה	"common land, open land"
*** 401 - 450 (/course/1969831/strongs-numbers-biblical-hebrew/9/)	
שָׁפַך	to pour out
אָחוֹת	sister
יָדָה	to throw
נָבָא	to prophesy
בּוּשׁ	to be ashamed
שֶׁקֶר	falsehood
בִּלתִּי	no
יָטַב	"to be good, well"
אֲבִישָׁלוֹם אַבשָׁלוֹם	Absalom
אֲדַד	Hadad
נֶגֶב	south
עַמּוּד עַמּוּד	pillars
צַּר צָּר	adversary
שַׁבָּת	sabbath
לָבַשׁ לָבֵשׁ	"to put on, wear, clothe"
עָפָר	dust
כָּנָף	wings
רַק	but
שְׁמוֹנֶה שְׁמוֹנֶה שְׁמוֹנָה שְׁמוֹנָה	eight
שׁוֹמְרוֹן	Samaria
אָמַן	"to confirm, support"
יִצחָק	Isaac
נָחַם	to be sorry
שְׁלִישִׁי	third
אֱלוּל	nought
יָתַר	to remain over
כֶּבֶשׂ	lambs
מִן	partly
עַמּוֹן	Ammon
גָּאַל	to redeem
חוּקָּה	statutes
יָרָבעָם	Jeroboam
כָּפַר	to appease
מַראֶה	appearance
תָּמִידּ	continually
כּוֹל	all
רַאֲוָה	to behold
רוּץ	to run
שָׁכַח שָׁכֵַח	to forget
בֵּיתּ הַגִּלגָּל	Beth-gilgal
בָּמָה	places
בְּעַד	through
מְעַט מְעָט	little
יֶתֶר	abundant
קָטָן קָטוֹן	least
רוֹחַב	width
רָעָב	famine
אֱדוֹם אֱדוֹם	stuff
קִראָה	seek
יַעַן	because
*** 451 - 500 (/course/1969831/strongs-numbers-biblical-hebrew/10/)	
עוֹר	skin
שָׂבַע שָׂבֵַע	satisfied
גּוּר	abide
רָעַע	afflict
גַּד	Fortune
מִצרִי	Egyptian
עֵשָׂו	Esau
קָצֶה קֵצֶה	after
שְׁבִיעִי שֶׁבִעִי	seventh
שָׁרַת	minister
בֵּיתּ עַשׁתָּרוֹת	Ashtaroth
חֲמוֹר חֲמוֹר	donkey
אֱלָהּ	God
אוֹרֶך	length
בָּעַר	brutish
דַּעַת	knowledge
טָּהֵר	clean
מָלַט	escape
הָפַך	turned
עַל	over
אַחאָב אֶחָב	Ahab
זָנָה	harlot
חָלָל	kill
טָּהוֹר טָּהוֹר	clean
יוֹנַת אֵלֶם רְחוֹקִים	Jonath-elem-rechokim
כְּנַעַן	Canaan
כֶּרֶם	vineyard
פֶּשַׁע	transgressions
שִׂמחָה	joy
גֵּר גֵּיר	alien
חֶלֶב חֵלֶב	fat
עוֹז עוֹז	strength
זְרוַֹע זְרוַֹע זְרוֹעָה זְרוֹעָה	arm
כְּרוּב	cherubim
מַדַּי	sufficiently
סָגַר	shut
שִׁבעִים	seventy
תָּמִים	defect
חָרָה	burned
מַלכּוּת מַלכּוּת מַלכּוּיָה	kingdom
עֵבֶר	beyond
שִׁיר שִׁירָה	musical
שָׁמַד	destroyed
יֶלֶד	child
עֵצָה	counsel
דֶּלֶת	doors
טָּמֵא	unclean
שֶׁקֶל	shekels
אֱמוֹרִי	Amorites
עָנָן	cloud
*** 501 - 550 (/course/1969831/strongs-numbers-biblical-hebrew/11/)	
קֶדֶם קֵדמָה	aforetime
שִׁיר שׁוּר	singers
שֶׁלֶם	offerings
אַשׁדּוֹת הַפִּסגָּה	Ashdoth-pisgah
לָמַד	teach
פֵּאָה	side
שָׁמֵם	desolate
בֵּיתּ עֵדֶן	Beth-eden
קָנָה	buy
רָחוֹק רָחוֹק	far
בַּעַל	owner
יְהוֹשָׁפָט	Jehoshaphat
פָּלַל	pray
הָמוֹן הָמוֹן	multitude
לוּן לִין	lodge
עָנָה	defile
שִׁיתּ	set
אֵיכּ אֵיכָּה אֵיכָּכָה	how
בֵּיתּ מִלּוֹא בֵּיתּ מִלּוֹא	Beth-millo
זָכָר	male
לָא לָה	no
פּוֹה פּוֹא פּוֹ	here
קָלַל	cursed
קָרבָּן קוּרבָּן	oblation
יָרָה יָרָא	teach
מָשַׁל	rule
עָזַר	help
שָׁחַט	slaughtered
בַּעַל	Baal
הֵיכָּל	temple
חוֹשֶׁך	darkness
יְהוֹנָתָן	Jonathan
כַּשׂדִּי כַּשׂדִּימָה	Chaldeans
מָכַר	sold
סָתַר	hide
עוּר	awake
אוֹצָר	treasures
אוֹת	sign
שׁוֹר	ox
אָוֶן	iniquity
אֲרִי אַריֵה	lions
חָנַן	beseech
יָעַץ	counselors
מִשׁמֶרֶת	charge
נֶגַע	mark
רָכַב	ride
גּוֹרָל גּוֹרָל	lot
זוּר	another
יְשׁוּעָה	salvation
עָנִי	afflicted
*** 551 - 600 (/course/1969831/strongs-numbers-biblical-hebrew/12/)	
צּוּר צּוּר	rock
קָרוֹב קָרוֹב	near
תְּפִלָּה	prayer
בַּרזֶל	iron
חָלָה	beseech
יְהוּדִי	Jews
לָאטּ	softly
מִקנֶה	livestock
עָרַך	array
קֶרֶן	horns
קֶשֶׁת	bow
תְּרוּמָה תְּרוּמָה	contribution
חָפֵץ	desire
יָנַח	bestow
מָאַס	abhor
חָרַשׁ	altogether
כְּנַעַנִי	Canaanite
מִזרָח	east
מִקדָּשׁ מִקְּדָשׁ	sanctuary
נָצַב	set
סֶלָה	Selah
עֵז	goat
קִיר קִר קִירָה	wall
גָּד	Gad
הֶבֶל הֲבֵל	vanity
חֶרפָּה	reproach
יָבֵשׁ	dried
צָּרָה	adversary
שָׁלָל	spoil
אֶלעָזָר	Eleazar
בֶּטֶן	womb
בֵּיתּ ־ אֵל	Bethel
בַּל	no
זָעַק	cried
מַדּוַּע מַדּוַּע	why
רְאוּבֵן	Reuben
רָחַץ	bathe
שׁוֹפָר שׁוֹפָר	trumpet
אֵלִיָה אֵלִיָהוּ	Elijah
אֲמַר	said
גִּבעָה	hills
דָּן	Dan
הָוָא הָוָה	kept
חֶברוֹן	Hebron
לְבָנוֹן	Lebanon
עוֹף	birds
פָּלָא	wonders
שָׁבַת	to
שׁוּלחָן	table
אָסַר	bound
*** 601 - 650 (/course/1969831/strongs-numbers-biblical-hebrew/13/)	
אֶרֶז	cedar
כְּסִיל	fool
עֵד	witness
אַלוּף אַלּוּף	captain
בְּרָכָה	blessing
חֵן	favor
יוֹזָכָר	Jozacar
מָשַׁח	anointed
נָבַט	look
עֵמֶק	valley
קָדִים קָדִם	east
אָחַז	seized
כִּכָר	talents
מְיוּסָּדָה	foundation
קֶבֶר קִברָה	grave
תָּקַע	blow
אֲבִימֶלֶך	Abimelech
בּוֹר	cistern
חֵלֶק	portion
כָּתֵף	side
נוַּח	rest
פּוּץ	pieces
פָּרַשׂ	spread
קֵץ	end
רִיבּ רוּב	contend
רָפָא רָפָה	heal
אֲחוּזָּה	possession
שְׁאוֹל שְׁאוֹל	Sheol
שְׁאֵרִיתּ	remnant
אִשָּׁה	fire
בָּרַח	fled
גֶּבֶר	man
חָלַק	deal
יְאוֹר	Nile
מַשָּׂא	burden
צָּלַח צָּלֵַח	out
שָׁכַם	early
תָּפַשׂ	seized
בָּחוּר בָּחוּר	men
חֲלוֹם חֲלוֹם	dream
מָהַר	quickly
מַחֲרָאָה	latrine
נֶסֶך נֵסֶך	cover
נָצַח	oversee
אַבנֵר אֲבִינֵר	Abner
אָרַר	cursed
דָּרַך	tread
יָצַר	formed
כָּשַׁל	stumble
מָגֵן מְגִנָּה	shield
*** 651 - 700 (/course/1969831/strongs-numbers-biblical-hebrew/14/)	
נַעֲרָה	girl
צִּדקִיָה צִּדקִיָהוּ	Zedekiah
קָרַע	tore
שָׂכַל	consider
שְׁכֶם	Shechem
שִׁפחָה	maid
חֶבֶל חֵבֶל	band
חַג חָג	feast
קָנֶה	branches
אֶביוֹן	needy
אַברָם	Abram
אַחֲרִיתּ	end
אֵצֶל	at
בִּלעָם	Balaam
גְּבוּרָה	might
דּוֹד דּוֹד	beloved
כָּלִבּוֹ כָּלֵבִי	Calebite
נָצַר	observe
רִיבּ רִב	strife
שָׁקָה	drink
תָּמַם	finished
אֱלוַֹהּ אֱלוַֹהּ	God
בָּשָׁן	Bashan
גַּיא גַּי	valley
חוּל חִיל	bear
חָמָס	violence
מָרדְּכַי	Mordecai
נֶדֶר נֵדֶר	vow
עֲרָבָה	Arabah
קְטוֹרֶת	incense
שָׁרָה	loose
אוֹרַח	paths
יָכַח	reprove
מִדיָן	Midian
סֶלַע	rock
עֵדוּת	testimony
פָּדָה	redeem
שָׂעִיר שָׂעִר	devil
שִׁשִּׁים	sixty
אִיוֹב	Job
אֱלִישָׁע	Elisha
אָסָא	Asa
בְּלִי	without
דֵּן	this
חָדַל	cease
יֵהוּא	Jehu
יַעַר	comb
לֵוִי	Levi
נְבוּכַדנֶאצַּר נֶבוּכַדרֶאצַּר נֶבוּכַדרֶאצּוֹר	Nebuchadnezzar
נָחַל	inherit
*** 701 - 750 (/course/1969831/strongs-numbers-biblical-hebrew/15/)	
נָטַע	plant
רָחַק	far
רֵיַח	savour
שְׁמָמָה שִׁמָמָה	desolation
תֵּשַׁע תִּשׁעָה	nine
אֱדַיִן	then
אֶדֶן	sockets
הַראֵל	altar
יְרִיחוֹ יְרֵחוֹ יְרִיחוֹה	Jericho
מִזמוֹר	psalm
מַלכּוּ	kingdom
פָּרָשׁ	horseman
רָצָה	accept
שָׁדַד	destroyed
תְּהִלָּה	praise
אָמָה	maidservant
זָרַע	sow
חָזָק	mighty
טֶּרֶם	before
מַחֲשָׁבָה מַחֲשֶׁבֶת	thoughts
פָּעַל	do
רָצוֹן רָצוֹן	favor
אָבָה	willing
אַלמָנָה	widow
אֶסתֵּר	Esther
בָּרָא	choose
גֶּפֶן	vine
חַטָּיָא	offering
יָרֵא	afraid
לָבָן	Laban
מִדָּה	garment
מָלֵא	full
עָמָל	labor
צָּעַק	cried
רְבִיעִי רֶבִעִי	fourth
שֵׁן	teeth
גָּמָל	camels
דָּבַק	cling
דְּבַשׁ	honey
הָמָן	Haman
יְרִיעָה	curtains
מָרוֹם	high
עַמִּי נָדִיבּ	Amminadib
עֶרוָה	nakedness
קָצִיר	bough
רָנַן	joy
שְׂמוֹאל שְׂמאוֹל	left
חָדָשׁ	new
יוֹאשִׁיָה יוֹאשִׁיָהוּ	Josiah
כַּעַס	anger
*** 751 - 800 (/course/1969831/strongs-numbers-biblical-hebrew/16/)	
מְדִינָה	provinces
מַצָּה	bread
סוֹלֶת	flour
עַד	forever
עֶוֶל עָוֶל עַולָה עוֹלָה עוֹלָה	iniquity
עֶליוֹן	Most
צָּדוֹק	Zadok
דָּנִיֵאל	Daniel
חָרַם	accursed
מָדַד	measured
מָחָר	tomorrow
צָּרַר	adversary
קָבָל	before
שָׁוא שַׁו	vain
אַחֲריוֹן אַחֲרוֹן	last
בָּקַע	split
הוֹי	woe
חָזָה	see
חָתַת	dismayed
יְהוֹיָדָע	Jehoiada
יוֹמָם	day
יָצַק	cast
כָּבַס	wash
נָדַח	driven
נַפתָּלִי	Naphtali
קֶרֶשׁ	bench
רֵאשִׁיתּ	beginning
תִּפאָרָה תִּפאֶרֶת	glory
אָזַן	pondered
בְּתוּלָה	virgin
הֵנָּה	here
מוּסָר	instruction
נָחֵת	down
נָשַׂג	overtake
פָּרַר	defeat
רְחַבעָם	Rehoboam
תָּעָה	wander
אֱמוּנָה	faithfulness
אֵפוֹד אֵפוֹד	ephod
בָּלַע	swallowed
גָּאוֹן	arrogancy
דֶּבֶר	pestilence
טַּבַּעַת	rings
יָחִיל	waits
מִגדָּל מִגדָּלָה	tower
מִשׁקָל	weight
נָגַף	defeated
נָכַר	recognized
עָבוּר עָבוּר	sake
פַּחַד	dread
*** 801 - 850 (/course/1969831/strongs-numbers-biblical-hebrew/17/)	
פֶּסַח	Passover
פָּרַץ	down
צֵּל	shadow
קָוָה	wait
קָצַר	down
תְּכֵלֶת	blue
אֵמֶר	words
בָּגַד	treacherous
גִּלּוּל גִּלּוּל	idols
הֵנָּה	these
חִתּתִּי	Hittite
יָהּ	LORD
יְעִישׁ	Jeush
יָצַב	stand
יִשׁמָעֵאל	Ishmael
מַכָּה מַכֶּה	slaughter
נְבֵלָה	body
נִיר נִר נֵיר נֵר נֵרָה	lamps
סָמַך	lay
עֲזַריָה עֲזַריָהוּ	Azariah
צָּפָה	overlaid
שָׁבָה	taken
שַׁדַּי	Almighty
שַׂק	sackcloth
גָּרַשׁ	drive
דִּביוֹן חֶריוֹן	dung
דַּל	lean
חֲנִיתּ	spear
יְדַע	known
יוֹאָשׁ יוֹאָשׁ	Joash
לִשׁכָּה	chambers
מַעֲלָה	step
מוֹתֶן	loins
נְמִבזֶה	vile
נָעוּר נָעוּר נְעוּרָה	youth
סָלַח	forgive
צָּבֶה	swell
רָחֵל	Rachel
רָחַם	compassion
רָצַח	manslayer
שְׁבִי	captive
שֶׂה שֵׂי	sheep
אַיֵה	where
אָסָף	Asaph
אָשָׁם	offering
בְּרִי	fat
זָמַר	praises
חָוָח	thicket
מִשׁכָּב	bed
מִשׁתֶּה	banquet
*** 851 - 900 (/course/1969831/strongs-numbers-biblical-hebrew/18/)	
נוַֹח	Noah
נָכרִי	foreign
עָצַר	shut
פָּגַע	fall
קָשַׁב	listen
רָפָה	fail
אוּלַי אוּלַי	perhaps
אֶשֶׁר	blessed
גִּדיָה גַּדיָה	bank
גִּיל גּוּל	rejoice
דַּמֶּשֶׂק דּוּמֶשֶׂק דַּרמֶשֶׂק	Damascus
זְבוּלוּן זֶבוּלוּן זֶבוּלוּן	Zebulun
חֲמִישִׁי חֲמִשִּׁי	fifth
כָּנַן	vineyard
מָרָה	rebelled
קוֹמָה	height
רוַּע	shout
אוֹכֶל	food
אֶפֶס	ends
בָּזָה	despised
בַּיִת	house
גּוֹלָה גּוֹלָה	exile
חָגַר	girded
חָלָב	milk
חָלַץ	withdraw
חֵץ	arrows
יוֹנָתָן	Jonathan
מוֹשָׁב מוֹשָׁב	dwellings
מֶרכָּבָה	chariot
נָגִידּ נָגִד	leader
נֶצַח נֵצַח	forever
נָקָה	unpunished
עוּד	admonish
עִמָּד	against
קִנאָה	jealousy
קָשַׁר	conspired
רַחַם	compassion
שֶׁבֶר שֵׁבֶר	destruction
שִׁמעוֹן	Simeon
שִׁמעִי	Shimei
אֲבִי גִּבעוֹן	Gibeon
אָשֵׁר	Asher
בָּזַז	plunder
בָּלַה	frightened
בָּלַל	anoint
בָּלָק	Balak
בַּעֲלֵי בָּמוֹת	heights
גִּבעָה	Gibeah
דַּהֲוָא	Dehavites
הָרָה	conceived
*** 901 - 950 (/course/1969831/strongs-numbers-biblical-hebrew/19/)	
הָרַס	down
זְכַריָה זְכַריָהוּ	Zachariah
יָסַר	chasten
יָפֶה	beautiful
יִשָּׂשׂכָּר	Issachar
לוַּח לוַּח	tablets
מָתַי	how
נִיחוַֹח נִיחוַֹח	soothing
נָקִי נָקִיא	blameless
פָּטִיר	free
פָּשַׁט	strip
רְחוֹב רְחוֹב	square
שֵׁרוּת	remnant
תּוֹלָע תּוֹלֵעָה תּוֹלַעַת תּוֹלַעַת	crimson
אָזַן	ear
בָּדַל	separated
בֶּטַח	securely
בְּנָיָה בְּנָיָהוּ	Benaiah
גַּן	garden
זוּב	flowing
חָרַב חָרֵב	decay
חָרבָּה	ruins
טַּף	ones
יִשַׁי אִישַׁי	Jesse
יָתוֹם	orphan
כִּנּוֹר	lyre
מַחֲלוֹקֶת	divisions
מְנוֹרָה מְנוֹרָה	lampstand
נָתָן	Nathan
נָתַץ	down
סָרִיס סָרִס	officials
צּוֹר צּוֹר	Tyre
קֳדָם קְדָם	before
שָׁנִי	scarlet
תְּבוּאָה	produce
תָּבוּן תֶּבוּנָה תּוֹבוּנָה	understanding
תִּרגַּל	go
אָחוֹר אָחוֹר	back
אָחָז	Ahaz
אָמַץ	courageous
אָרַב	ambush
בֵּיתּ לֶחֶם	Bethlehem
בְּרִיַח	bars
גּוֹל	bowl
גִּלגָּל	Gilgal
חָמַל	spare
חָרוֹן חָרוֹן	burning
חָרַף	betroth
יְבוּסִי	Jebusite
יָלַך	again
*** 951 - 1000 (/course/1969831/strongs-numbers-biblical-hebrew/20/)	
יָסַד	founded
יִראָה	fear
כּוּשִׁיתּ	Cushite
מָאֵן	refused
מַעֲלָל	deeds
מַר מָרָה	bitter
פֵּרָה	mole
פָּשַׁע	transgressed
צָּדַק	righteous
צַּוָּאר צַּוָּר צַּוָּרוֹן צַּוָּארָה	neck
צֵּלָע צַּלעָה	side
רָגַז	tremble
שְׁמַעיָה שְׁמַעיָהוּ	Shemaiah
שָׁקַט	quiet
שֵׁשׁ שְׁשִׁי	linen
אַהֲבָה	love
אוֹר	shine
אֵיפָה אֵפָה	ephah
אֲמַציָה אֲמַציָהוּ	Amaziah
אָן אָנָה	where
אֲשֵׁרָה אֲשֵׁירָה	Asherim
גָּנַב	steal
דָּגָן	grain
דַּי	often
יָחַל	hope
נוַּע	wander
נָטַשׁ	abandon
עוֹל עוֹל	yoke
צִּפּוֹר צִּפּוֹר	bird
צְּפִיָה	watching
אָבַל	mourn
אוּרִיָה אוּרִיָהוּ	Uriah
גִּדעוֹן	Gideon
הוֹדַיְוָהוּ	Hodaviah
זָרָה	scatter
חֵפֶץ	desire
חָרַד	tremble
יְשַׁעיָה יְשַׁעיָהוּ	Isaiah
כָּבֵד	heavy
מְעָרָה	cave
מִרמָה	deceit
מְרָרִי	Merari
מָשִׁיַח	anointed
נָחָה	lead
סְדוֹם	Sodom
עֵדֶר	flock
עַי עַיָא עַיָת	Ai
עֲמָלֵק	Amalek
שַׁמָּה	desolation
שֵׂעִיר	Seir
*** 1001 - 1050 (/course/1969831/strongs-numbers-biblical-hebrew/21/)	
תְּאֵן תְּאֵנָה	tree
תּוֹלְדָה תּוֹלְדָה	generations
אַרגָּמָן	purple
בִּינָה	understanding
בָּצַר	fortified
זַיִת	olive
חֶדֶר	bedroom
חֲדַר	Hadar
חֵרֶם חֶרֶם	cursed
חֶשׁבּוֹן	Heshbon
כָּלַם	humiliated
מוֹט	shaken
מָטָר	rain
מְלוֹא מְלוֹא מְלוֹ	full
מִלָּה מִלֶּה	words
מָשָׁל	proverb
נֶבֶל נֵבֶל	bottle
עֵין תַּנִּים	Well
פּוֹעַל	work
קָהַל	assembled
שָׁמַיִן	heaven
שְׁמוֹנִים שְׁמוֹנִים	eighty
שִׁמשׁוֹן	Samson
שָׂרָה	Sarah
תִּירוֹשׁ תִּירוֹשׁ	wine
אֲחַזיָה אֲחַזיָהוּ	Ahaziah
אִמרָה אֶמרָה	commandment
בְּאֵר	well
בָּהַל	dismayed
גָּבוֹהַּ גָּבוֹהַּ	high
גִּבעוֹן	Gibeon
גָּמַל	weaned
גּוֹרֶן	floor
חֵיק חֵק חוֹק	bosom
חִישׁ	haste
חָסָה	refuge
יְהוֹיָקִים	Jehoiakim
כּוֹכָב	stars
כּוּל	provided
כָּכָה	thus
לָקַט	gather
מִבצָּר מִבצָּרָה	fortified
מָררָה	bitterness
נוּף	wave
סִיחוֹן סִיחוֹן	Sihon
עוֹשֶׁר	riches
פִּילֶגֶשׁ פִּלֶגֶשׁ	concubine
קָרָא	meet
קוֹרַח	Korah
שׁוֹעֵר שׁוֹעֵר	gatekeepers
*** 1051 - 1100 (/course/1969831/strongs-numbers-biblical-hebrew/22/)	
אַי	where
אִי	coastlands
אָלָה	oath
חֲמָת	Hamath
טּוּמאָה	filthiness
יִזרְעֵאל	Jezreel
יֶשַׁע יֵשַׁע	salvation
כָּנַע	humbled
כָּרַע	down
לְאוֹם לְאוֹם	peoples
מוּל	circumcised
מוּל מוֹל מוֹאל מוּל	opposite
מוֹפֵת מוֹפֵת	wonders
מָחָה	abolish
מָעוֹז מָעוּז מָעוֹז מָעוּז	stronghold
מָעַל	committed
מִצפָּה	Mizpah
מָשַׁך	draw
נֵכָר	foreign
נָסָה	test
נָסַס	man
סֵתֶר סִתרָה	backbiting
עֳנִי	misery
פָּרַח	abroad
צּוּר	adversary
צָּפָה	watchman
קָשֶׁה	hard
רְאִיתּ	look
רָמָה	Ramah
רַנֵּן	singing
שָׂחַק	laugh
תֵּבֵל	world
תְּהוֹם תְּהוֹם	deep
תְּרוּעָה	shout
אוֹפָן אוֹפָן	wheels
אָשַׁם אָשֵׁם	guilty
גֶּשֶׁם	rain
זָרַק	scatter
חָזוֹן	vision
חָרָשׁ	craftsmen
חַשׁחוּת	needful
יָקָר	precious
כָּלֵב	Caleb
מָבוֹן	taught
מַלכָּה	Queen
מִשׁנֶה	second
נָוֶה נָוָה	comely
נָקַם	avenge
נָשַׁק	kiss
סִינַי	Sinai
*** 1101 - 1150 (/course/1969831/strongs-numbers-biblical-hebrew/23/)	
עֵגֶל	calf
עַד	until
עָרֵל	uncircumcised
עָשַׁק	oppress
פָּכָה	trickling
צָּרַעַת	leprosy
קוּם	set
רָשַׁע	condemn
אוּלָם אוּלָם	porch
אָרַך	prolong
אָתוֹן	donkey
בְּאֵר שֶׁבַע	Beersheba
גָּבַהּ	exalt
גַּל	waves
הָמָה	roar
חֵטא	sin
חִלקִיָה חִלקִיָהוּ	Hilkiah
יָחַר	longer
יַך	side
יָרֵך	thigh
כַּלָּה	bride
לֵאָה	Leah
לִפנַי	before
מִכרֶה	pits
מִתנַשֵּׂא	exalted
סִיר סִירָה סִרָה	caldron
עֶברָה	wrath
עִברִי	Hebrews
קָצָה	ends
קָצַף	angry
שְׁיָא	Sheva
שְׂעוֹרָה שְׂעוֹרָה שְׂעוֹר שְׂעוֹר	barley
שָׁפָן	coney
תִּקוָה	cord
תְּשׁוּעָה תְּשׁוּעָה	salvation
בָּצוֹר	vintage
גְּדוּד	bands
גַּת	Gath
וְדָן	Vedan
חָבָא	hidden
חָבַשׁ	saddled
חוֹמֶר	clay
חָתַן	son-in-law
יָהַב	give
כּוֹס	cup
לְבוּשׁ לְבוּשׁ	clothing
לוֹט	lot
מִיכָּה	Micah
נְבוּכַּדנֶצַּר	Nebuchadnezzar
עִיר הַתּתְּמָרִים	palm
*** 1151 - 1200 (/course/1969831/strongs-numbers-biblical-hebrew/24/)	
עֵלִי	Eli
עֵרֶך	valuation
עוֹרֶף	neck
עֶשֶׂב	grass
עִשָּׂרוֹן עִשָּׂרוֹן	two-tenths
צַּד	side
צָּמַח	grow
צָּרַף	goldsmith
קְלָלָה	curse
רִנָּה	cry
שֶׁרֶשׁ	root
אַרמוֹן	citadels
בָּשָׂם	spice
גְּדַליָה גֶּדַליָהוּ	Gedaliah
חִנָּם	cause
חָסִידּ	ones
טַּבָּח	bodyguard
טּוּב	goodness
יוֹנָה	dove
יָנַק	nurse
יָעוֹר	wood
כָּחַד	hide
כֶּלֶב	dogs
כְּפִיר	lions
מְאוּמָה	anything
מְבוֹאָה	entry
מִזרָק	bowl
מָחֳרָת מָחֳרָתָם	day
מֵעֶה	body
מַעֲשֵׂר מַעֲשַׂר מַעַשׂרָה	tithe
מַצֵּבָה	pillar
נְפִיסִים	Nephisim
סַף	bason
סָפַד	lament
עָב	clouds
עוּמָּה	alongside
פְּנִימִי	inner
צְּבִי	beautiful
קְהָת	Kohath
קָנָא	jealous
רִמּוֹן רִמּוֹן	pomegranates
שִׁילוֹה שִׁלוֹה שִׁילוֹ שִׁלוֹ	Shiloh
תּוֹדָה	thanksgiving
תַּן	jackals
אֲחַשׁוֵרוֹשׁ אַחַשׁרוֹשׁ	Ahasuerus
אָנִיָה	ships
אֶצבַּע	finger
בּוֹשֶׁת	shame
בֶּתֶר	Bether
גָּזַל	robbed
*** 1201 - 1250 (/course/1969831/strongs-numbers-biblical-hebrew/25/)	
חֲזָא חֲזָה	looking
חַלּוֹן	windows
טַּל	dew
טָּמַן	hidden
יְמָנִי	right
יִצרִי	Jezerites
כִּליָה	kidneys
מִין	kind
נָאַף	adultery
נָדַר	vowed
נָהַג	acquaint
נָחָשׁ	serpent
סוּכָּה	Booths
עוּף	brandish
עֲנָה	answered
עָצוּם עָצוּם	mighty
פְּקוּדָּה	punishment
פְּשַׁר	interpretation
צָּפַן	stored
שַׁמלַי	Shalmai
אֶביָתָר	Abiathar
אָמֵן	Amen
בֶּשֶׂם בּוֹשֶׂם	spices
גָּג	roof
דּוּק	pieces
דָּמָה	like
דָּמַם	cease
הָדָר	majesty
חִטָּה	wheat
חָלַם	dream
יָלַל	wail
יִפתָּח	Jephthah
כּוּשׁ	Cush
כְּלִמָּה	disgrace
מוּד	measure
נוּן נוֹן	Nun
פֶּסֶל	image
רָבַץ	down
רִבקָה	Rebekah
רָעַשׁ	shake
רֶשַׁע	wickedness
שְׁבוּעָה	oath
שְׁבוּת שְׁבִיתּ	fortunes
שָׁוֵה קִריָתַיִם	Shaveh-kiriathaim
שָׁטַף	overflow
תְּנוּפָה	offering
תַּקִּיף	stronger
בָּחַן	test
בָּרָד	hail
דָּנִיֵאל דָּנִאֵל	Daniel
*** 1251 - 1300 (/course/1969831/strongs-numbers-biblical-hebrew/26/)	
זִמָּה זַמָּה	lewdness
חֶלקָה	field
חֲנַניָה חֲנַניָהוּ	Hananiah
חֲצוֹצְרָה	trumpets
יְהוֹרָם	Jehoram
יָעַד	meet
יָצַת	set
יֵשׁוַּע	Jeshua
כָּזָב	lies
כְּתוֹנֶת כּוּתּתּוֹנֶת	tunic
לָבָן לָבֵן	white
מַאֲכָל	food
מִטָּה	bed
מָנַע	withheld
נִדָּה	impurity
נָדִיבּ	nobles
עֲשִׂירִי	tenth
עַתּתּוּד עַתּתּוּד	goats
פִּנָּה	corner
פָּרָה	fruitful
קְבֵל קֳבֵל	inasmuch
קֶצֶף	foam
קִריָה	city
שִׂמלָה	clothes
שָׁפֵל	abased
אַמנוֹן אֲמִינוֹן	Amnon
בְּכִי	weeping
בַּעשָׁא	Baasha
בָּשַׁל	boil
זָמִיר	pruning
חָבַר	joined
חָלַף	changed
חָמַד	covet
יְהַב	given
יְרֵכָה	rear
מֶלַח	salt
מָנָה	appointed
מַסֵּכָה	covering
מְעִיל	robe
מַעַל	unfaithfully
נָדַד	fled
סוּף	red
עֲבַד	done
עֵילָם עוֹלָם	Elam
עָלַם	hidden
פֶּחָה	governors
פְּלֵיטָּה פְּלֵטָה	escape
פָּרַס	Persia
פָּתָה	allure
קָשָׁה	stiffened
*** 1301 - 1350 (/course/1969831/strongs-numbers-biblical-hebrew/27/)	
רְכוּשׁ רְכוּשׁ	possessions
שִׁטָּה שִׁטִּים	acacia
שָׂכָר	wages
שָׁלֵם	whole
שְׁמִינִי	eighth
שֵׂעָר שַׂעַר	hair
שִׁקּוּץ שִׁקּוּץ	things
שָׂרִידּ	survivor
שִׁשִּׁי	sixth
תֵּבָה	ark
תּוֹכֵחָה תּוֹכַחַת	among
תָּלָה	hanged
תַּרשִׁישׁ	Tarshish
אַדִּיר	nobles
בְּלִיַעַל	worthless
חָבַל	band
חֵיל חֵל	rampart
חָכַם	wise
חָקַר	search
חָשַׂך	withheld
חָתַם	sealed
יוֹבֵל יוֹבֵל	jubilee
כַּפּוֹרֶת	seat
לוּץ	ambassador
לוּשׁ	Laish
מוֹצָא מוֹצָא	exits
מוֹקֵשׁ מוֹקֵשׁ	snare
מְסִלָּה	highway
נִהיָה	bitter
נְקָמָה	vengeance
נָתַק	away
עוּזִּיָה עוּזִּיָהוּ	Uzziah
פַּח	gin
קָרָה	appoint
רָדָה	reign
שׂוּשׂ שִׂישׂ	rejoice
שָׂטָן	Satan
שַׁלּוּם שַׁלּוּם	Shallum
שְׁמוּעָה	report
שָׂמֵַח	joyful
תַּנִּין תַּנִּים	monster
אֲדוֹנִיָה אֲדוֹנִיָהוּ	Adonijah
בָּרוּך	Baruch
דֶּקֶר	Dekar
הוֹן	wealth
זָקֵן	old
טּוּר	row
יָגַע	weary
יְרוּשָׁלֵם	Jerusalem
יָרֵַח	moon
*** 1351 - 1400 (/course/1969831/strongs-numbers-biblical-hebrew/28/)	
כּוּשִׁי	Cushite
כַּעַס כַּעַשׂ	vexation
לָוָה	with
מַגֵּפָה	plague
מָצוֹר מָצוּר	siege
מִשׁחָה מָשׁחָה	anointed
נְדָבָה	offering
נֶשֶׁר	eagle
נָתִיבּ נְתִיבָּה נְתִבָה	path
עֵדָה	testimony
עִוֵּר	blind
עֶזרָה עֶזרָת	help
פָּרַד	separated
פָּרָה	cows
צּוֹם צּוֹם	fast
צָּפִיתּ	cloth
צְּרוּיָה	Zeruiah
קָדַם	meet
רָגַל	spies
רֶחֶם	womb
שְׁאָר	rest
שׂוּם	issued
אֲבִיָה אֲבִיָהוּ	Abijah
אֲבִישַׁי אַבשַׁי	Abishai
אָוָה	desire
אֱוִיל	fool
אִוֶּלֶת	folly
אֱנָשׁ אֱנַשׁ	man
אָפָה	baked
אַרנוֹן אַרנוֹן	Arnon
בָּבֶל	Babylon
בֶּן ־ הֲדַד	Ben-hadad
בֶּרֶך	knees
גָּבַר	prevailed
דְּמוּת	likeness
הָגָה	meditate
חִוִּי	Hivite
חִיצּוֹן	outer
חִירָם חִירוֹם	Hiram
חָצַב חָצֵב	hewn
חוֹשֶׁן	breastpiece
טּוֹב	well
טָּרַף	tear
יָשַׁר	pleased
מָבוֹא	entrance
מְדָנִי	Midianite
מָסָך	screen
מָצוּד מְצוּדָה מְצוּדָה	castle
מָרַד	rebelled
מְשׁוּלָּם	Meshullam
*** 1401 - 1450 (/course/1969831/strongs-numbers-biblical-hebrew/29/)	
נָאַץ	spurned
נְבָט	Nebat
נָבֵל	disgrace
נֶזֶר נֵזֶר	crown
נָסַך	cover
נָקַב	appoint
עֲגָלָה	cart
עָשָׁן	smoke
פָּחַד	dread
פִּינְחָס	Phinehas
פָּלַט	deliver
פּוֹרֶכֶת	veil
פִּתאוֹם פִּתאוֹם	suddenly
רָחַב	enlarge
רָפָא רָפָה	Rephaim
שׁוֹד שׁוֹד	destruction
שַׁחַר	dawn
שׁוֹטֵר	officers
שָׁלַף	draw
שִׁלשׁוֹם שִׁלשׁוֹם	time
תְּחִנָּה	supplication
אֵבֶל	mourning
אוֹי	woe
אֲחִיָה אֲחִיָהוּ	Ahijah
אֵידּ	calamity
אַרבֶּה	locusts
בַּז	prey
בּוֹעַז	Boaz
בָּשַׂר	news
גָּוַע	perish
דִּין דּוּן	judge
הוֹד	splendor
זִכרוֹן	memorial
חֳלִי	sickness
טְּעֵם	decree
יָבֵשׁ יָבֵישׁ	Jabesh
יוֹתָם	Jotham
יָשֵׁן	sleep
יָתֵד	pegs
כָּבָה	quenched
כַּרמֶל	Carmel
כּוֹתֶרֶת	capitals
לָכִישׁ	Lachish
מְכוֹנָה מְכוֹנָה	stands
מִלָּה	matter
מְלוּכָה	kingdom
נוּד	mourn
נָזָה	sprinkle
סָכַך שָׂכַך	cover
סַעַר סְעָרָה	storm
*** 1451 - 1500 (/course/1969831/strongs-numbers-biblical-hebrew/30/)	
עֲבוֹת עֲבוֹת עֲבוֹתָה	cords
עַז	strong
עֲלִילָה עֲלִלָה	deeds
פָּלִיטּ פָּלֵיטּ פָּלֵט	escaped
פְּסִיל	idols
פִּקּוּד פִּקּוּד	precepts
צּוֹהַר	midday
רוּשׁ	poor
שְׁבָא	Sheba
שַׁד שׁוֹד	breast
תּוֹם	integrity
תָּמָר	Tamar
בַּד	linen
גָּלַח	shave
דְּהַב	gold
דִּמעָה	tears
זֵכֶר זֶכֶר	memory
חוֹל	sand
חוּס	pity
חֲזָאֵל חֲזָהאֵל	Hazael
חָפַשׂ	search
טֶּרֶף	prey
יַעַל	profit
יִצהָר	oil
כָּהַן	priests
מִישׁוֹר מִישׁוֹר	plain
מַס מִס	labor
מַעיָן מַעיְנוֹ מַעיָנָה	springs
מַעֲכָה מַעֲכָת	Maacah
מַעֲשֵׂיָה מַעֲשֵׂיָהוּ	Maaseiah
מִקרָא	convocation
מְרִי	rebellious
נָגַשׂ	taskmasters
נוֹכַח	opposite
נְשָׁמָה	breath
עֲטָרָה	crown
עָרַב	associate
עָשִׁיר	rich
פְּרִזִּי	Perizzite
קוּץ	arise
רֶגַע	moment
שַׁחַד	bribe
שַׁחַת	pit
שָׁכוֹל	bereave
שֵׁכָר	drink
שֵׁנָה שֵׁנָא	sleep
תּוֹצָאָה תּוֹצָאָה	ended
תּוּר	spy
תֵּימָן תֵּמָן	south
תְּמוֹל תְּמוֹל	previously
*** 1501 - 1550 (/course/1969831/strongs-numbers-biblical-hebrew/31/)	
אִיזֶבֶל	Jezebel
אֵפֶר	ashes
בְּנָא בְּנָה	rebuild
בֶּצַע	gain
גָּדַע	down
גָּרַע	withdrawn
הִין	hin
זָהַר	admonish
חֵלֶם	dream
חָפַר	dug
יוֹחָנָן	Johanan
כָּחַשׁ	deny
כִּיוֹר כִּיוֹר	laver
לוּא לוּא לוּ	if
מוֹלֶדֶת	birth
מַחתָּה	firepans
מָכִיר	Machir
מְנוּחָה מְנוּחָה	rest
מִשׁמָר	guard
נָבוֹת	Naboth
נָבָל	Nabal
נַעַל נַעֲלָה	sandals
נָפַץ	sunder
נְקֵבָה	female
סָקַל	stone
סֶרֶן	lord
עוֹג	Og
עֶזרָא	Ezra
עִם	like
עֶקרוֹן	Ekron
פֶּגֶר	corpses
פָּשָׂה	spread
צִּידּוֹן צִּידּוֹן	Sidon
צִּנָּה	buckler
צָּעִיר צָּעוֹר	younger
קֶלַע	hanging
קָסַם	diviners
רֶשֶׁת	net
שָׁנָה	time
שָׁעַן	relied
שָׁקַל	weighed
שָׁקַף	down
שָׂשׂוֹן שָׂשׂוֹן	joy
תְּחִלָּה	beginning
תָּעַב	abhor
אִיתָּמָר	Ithamar
אָכִישׁ	Achish
אֱלִיאָב	Eliab
אֶלקָנָה	Elkanah
אֲרַע	earth
*** 1551 - 1600 (/course/1969831/strongs-numbers-biblical-hebrew/32/)	
אָתָה אָתָא	come
בֵּיתּ שֶׁמֶשׁ	Beth-shemesh
בָּרָק	lightning
גְּבַר	men
דָּת	law
הֲדַדעֶזֶר	Hadadezer
זַעַם	indignation
זְרוּבָּבֶל	Zerubbabel
זֶרַח	Zerah
חוֹזֶה	seer
חָלִילָה חָלִלָה	far
חָסֵר	lacking
חָצִיר	grass
כָּלָה	destruction
לְבוֹנָה לֶבוֹנָה	frankincense
לְחִי	cheek
מאוּם מוּם	defect
מְגִלָּה	scroll
מָסַס	melt
מָעַט	decrease
מַת	men
נֵס	standard
נָעֳמִי	Naomi
נָתַך	poured
נָתַשׁ	uproot
סוֹד	council
סָחַר	merchants
סִיסְרָא	Sisera
עוֹלֵל עוֹלָל	ones
עַזָּה	Azzah
עֵזֶר	help
פַּרסָה	hoof
צּוּם	fasted
צַּעֲקָה	cry
קִישׁ	Kish
רָחָב	broad
רָמוֹת גִּלעָד רָמוֹת גִּלעָד	Ramoth-gilead
שָׁבַר	buy
שָׁגָה	reel
שָׁוָה	avail
שָׁוַע	cry
שׁוּשַׁן	Susa
שָׁזַר	twisted
שָׁחַח	despair
שַׁחַק	skies
שִׂיַח	meditate
שְׁכֶם	shoulder
שָׂכַר סָכַר	hired
שְׁנָא	changed
תַּאֲוָה	desire
*** 1601 - 1650 (/course/1969831/strongs-numbers-biblical-hebrew/33/)	
תָּמַך	uphold
אֲחִיקָם	Ahikam
אֲחִיתּוֹפֶל	Ahithophel
אֱלִיל	idols
בִּקעָה	valley
בְּרוֹשׁ	cypress
דִּין דּוּן	cause
זָנַח	reject
חוּשׁ	haste
חֵיוָא	beasts
חָתָן	bridegroom
יְהוֹאָחָז	Jehoahaz
יוֹרָם	Joram
יְסוֹד	base
מְהֵרָה	quickly
מוּשׁ	depart
מַחֲסֶה מַחסֶה	refuge
מִקלָט	refuge
נָדָב	Nadab
נְתַניָה נְתַניָהוּ	Nethaniah
סָפָה	away
עוֹבֵד אֱדוֹם	Obed-edom
עוֹבַדיָה עוֹבַדיָהוּ	Obadiah
עָלַם	forever
עָנָו עָנָיו	humble
עָצַם	bones
עָרִיצּ	ruthless
עָתַר	supplication
פָּקַח	open
פַּרזֶל	iron
צָּרַע	leper
קַיִץ	fruit
קִריַת יְעָרִים קִריַת עָרִים	Kiriath-jearim
רַעֲנַן	green
שָׁאַג	roar
שָׁבוַּע שָׁבוַּע שֶׁבוּעָה	weeks
שָׂגַב	exalted
שָׁכֵן	neighbors
שְׁפֵלָה	lowland
שְׂרָיָה שְׂרָיָהוּ	Seraiah
תַּבנִיתּ	likeness
תּוֹהוּ	waste
תַּזנוּת תַּזנוּת	harlotries
תִּשׁעִים	ninety
אוּלָם	however
אָפִיק	ravines
אַשׁמָה	guilt
גַּאֲוָה	pride
גְּמוּל	recompense
דָּג דָּאגּ	fish
*** 1651 - 1700 (/course/1969831/strongs-numbers-biblical-hebrew/34/)	
הוּא הִיא	Himself
זַעַק זְעָקָה	outcry
זָקָן	beard
חַטָּא	sinners
חָסֵר	lacks
חָקַק	inscribed
יָאַל	willing
יוֹאֵל	Joel
יוֹנָה	Jonah
יָנָה	oppress
יֳפִי	beauty
לָאָה	weary
לֶהָבָה לַהֶבֶת	flame
לָחַץ	oppressed
לָעַג	mocked
מָאוֹר מָאוֹר מְאוֹרָה מְאוֹרָה	light
מְזוּזָה מְזוּזָה	doorposts
מְזִמָּה	discretion
מַטָּה	downward
מֵישָׁר	equity
מַעֲרָכָה	line
מַשׁקֶה	butler
נוֹגַהּ	brightness
נָקַף	about
עֲלִיָה	chamber
עָלַל	abuse
עֲמוֹרָה	Gomorrah
עֵנָב	grapes
עַשׁתֵּי	eleventh
פֶּרֶץ	breach
פְּרָת	Euphrates
פְּתִי פֶּתִי פְּתָאִי	one
רוּק	arm
רָמַס	trampled
רוַֹע	evil
רָצַץ	crushed
שָׁאַב	draw
שִׁבּוֹל שִׁבּוֹלֶת	ears
שְׁגָגָה	unintentionally
שׁוֹק	thigh
שֵׂיבָּה	hair
שָׁכַר	drunk
שֶׁלֶג	snow
שָׁפָל	lowly
תַּחתִּי	lower
תִּמּוֹר תִּמּוֹרָה	trees
אוֹכלָה	food
אָכֵן	surely
אַנתָּה	thee
בָּאַשׁ	foul
*** 1701 - 1750 (/course/1969831/strongs-numbers-biblical-hebrew/35/)	
בִּכּוּר	fruits
בָּרַר	choice
גֶּבַע	Geba
גֶּחֶל גַּחֶלֶת	coals
גָּלַל	roll
דָּכָא	crush
הֵן	if
זָרַח	rises
חֵך	mouth
חֶמדָּה	pleasant
חָצוֹר	Hazor
חֶצרוֹן	Hezron
חָרוּץ חָרוּץ	decision
חָשַׁך	darkened
טּוֹבִיָה טּוֹבִיָהוּ	Tobiah
יָבַל	bring
יָחַשׂ	genealogy
כַּד	jar
כָּזַב	lie
כָּלָא	shut
כַּפתּוֹר כַּפתּוֹר	bulb
לִבנָה	Libnah
מַהֵר	hasteth
מִיכָּיְהוּ מִכָיְהוּ	Micaiah
מִיכָּל	Michal
מָנוַֹח	Manoah
מָקוֹר מָקוֹר	fountain
מַקֵּל מַקְּלָה	rods
נָבָל	fool
נָדַב	willingly
נָחוֹר	Nahor
נָטַף	speak
סוּת	incited
סוּכּוֹת סוּכּוֹת	Succoth
עָלֶה	leaf
עָמרִי	Omri
עָצָב	idols
עֲשָׂהאֵל	Asahel
צּוּד	hunt
צַּלמָוֶת	darkness
קָדֵשׁ	Kadesh
קַו קָו	line
קַיִן	Cain
קִינָה	lamentation
קְעִילָה	Keilah
רְאוּבֵנִי	Reubenites
שָׁאוֹן	uproar
שְׁכַח	found
שֵׁמַע	report
תַּחֲנוּן תַּחֲנוּנָה	supplications
*** 1751 - 1800 (/course/1969831/strongs-numbers-biblical-hebrew/36/)	
תָּכַן	right
תִּרצָּה	Tirzah
תְּשִׁיעִי	ninth
אֲבִיגַּיִל אֲבִיגַּל	Abigail
אַבִּיר	stallions
אוֹב	mediums
אֶזרָח	native
אֲחִימֶלֶך	Ahimelech
אָחַר	delay
אֵימָה אֵמָה	terror
אִיתַּי	there
אֶליָשִׁיבּ	Eliashib
אֱלִישָׁמָע	Elishama
אָמוֹן	Amon
אַשׁדּוֹד	Ashdod
בָּלָה	wear
בִּלעֲדֵי בַּלעֲדֵי	besides
בָּצַע	greedy
בְּרֵכָה	pool
גּוֹבַהּ	height
גֵּרְשׁוֹן גֵּרְשׁוֹם	Gershon
דָּרוֹם	south
הֵימָן	Heman
חִידָּה	riddle
חָיַי	live
חָפֵר	humiliated
חָפשִׁי	free
חוֹרֵב	Horeb
חֶרֶשׂ	earthenware
יַד	hand
יְדוּתוּן יֶדוּתוּן יֶדִיתּוּן	Jeduthun
יְהוֹאָשׁ	Joash
יְקָר	honor
כּוֹפֶר	bribe
כָּרָה	dig
כָּתַת	crushed
מָדוֹן	strife
מוּג	away
מָטַר	rain
מָכוֹן	place
מִסגֶּרֶת	borders
מָעוֹן מָעִין	habitation
מֶרחָק	afar
מִשׂגָּב	stronghold
מָשׂוֹשׂ	joy
מָשַׁל	like
מַתּתָּנָה	gifts
נוּר	fire
נֶזֶם	ring
נִינְוֵה	Nineveh
*** 1801 - 1850 (/course/1969831/strongs-numbers-biblical-hebrew/37/)	
נָקָם	vengeance
נָתִין נָתוּן	servants
סָגָן	officials
סָרַר	stubborn
עָוָה	amiss
עָטָה	self
עָיֵף	weary
עַמּוֹנִי	Ammonite
עָמוֹק	deeper
עָצַב	displease
עָשַׁר	rich
עֲתַליָה עֲתַליָהוּ	Athaliah
פֶּרַח	flowers
צַּיִד	catch
צֶּלֶם	images
צֶּלֶם צְּלֶם	image
צָּמָא	thirst
קָדַר	mourning
קָלוֹן	dishonor
קְעָרָה	dish
רָכַל	traders
רִמּוֹן רִמּוֹן רִמּוֹנוֹ	Remmon
רָמַשׂ	creeps
רֶמֶשׂ	things
רָעֵב	hungry
רַעַשׁ	earthquake
רָקִיַע	expanse
שָׂכִיר	man
שָׁלִישׁ שָׁלוֹשׁ שָׁלוֹשׁ	captain
שֵׁם	Shem
שָׂרַי	Sarai
תֶּבֶן	straw
תּוֹף	tambourines
אָזַר	gird
אַיִן	where
אֵלָה	Elah
אֲמַריָה אֲמַריָהוּ	Amariah
אֲנָא אֲנָה	myself
אָשַׁר אָשֵׁר	guide
אָתָה אָתָא	brought
בּוֹהֶן	toe
בִּירָה	citadel
בָּעַת	terrify
גְּדִי	goat
גַּנָּב	thief
דְּבִיר דֶּבִר	sanctuary
הוֹשֵַׁע	Hoshea
הָלְאָה	beyond
הָרֶה הָרִי	child
זוּלָה	except
*** 1851 - 1900 (/course/1969831/strongs-numbers-biblical-hebrew/38/)	
חָגַג	celebrate
חָם	Ham
חֲנוֹך	Enoch
חוֹרֶב	desolation
טָּבַל	dip
יְגִיַע	labor
יוֹם	days
יְפוּנֶּה	Jephunneh
יָצַג	set
יֶקֶב	vat
כֵּן	base
כַּר	captain
מָדַי	Media
מוֹאָבִי מוֹאָבִיָה מוֹאָבִיתּ	Moabite
מַחֲצִיתּ	half
מַטָּרָא מַטָּרָה	guardhouse
מַכאוֹב מַכאוֹב מַכאוֹבָה	pain
מִכסֶה	covering
מַלכִּיָה מַלכִּיָהוּ	Malchijah
מַעגָּל מַעגָּלָה	paths
מַרפֵּא	healing
מַשׂאֵת	cloud
מַתּתַּניָה מַתּתַּניָהוּ	Mattaniah
נָזִיר נָזִר	Nazirite
נָזַל	flow
נַעֲמָן	Naaman
נֵר	Ner
נָשַׁך	bite
סוּפָה	Sea
סַם	fragrant
עֵדֶן	Eden
עוּזִּיאֵל	Uzziel
עָטַף	turn
עָלַז	exult
עֲמָשָׂא	Amasa
עָרוֹם עָרוֹם	naked
עֲרוֹעֵר עֲרוֹעֵר עַרעוֹר	Aroer
עָרלָה	foreskin
עָשׂוֹר עָשׂוֹר	tenth
פָּרַע	avenge
פִּשׁתֶּה	linen
צִּיבָּא	Ziba
צִּידּוֹנִי צִּדוֹנִי	Sidonians
צִּיָה	dry
צֶּמֶר	wool
קַשׁ	stubble
קֶשֶׁר	conspiracy
רְבָבָה	thousands
רַבשָׁקֵה	Rabshakeh
רָגַם	stone
*** 1901 - 1950 (/course/1969831/strongs-numbers-biblical-hebrew/39/)	
רֵיקָם	empty-handed
רַך	tender
רָעֵב	hungry
שְׁאֵר	relative
שׁוּר	behold
שֶׂכֶל שֵׂכֶל	insight
שָׁלַל	fall
שַׂלמָה	clothes
שִׂנאָה	hatred
שֶׁפֶט	judgments
אֲהָהּ	alas
אֲחִיטּוּב	Ahitub
אֲחִימַעַץ	Ahimaaz
אֵילָם אֵלָם אֵלַמָּה	porches
אֱלִיפַז	Eliphaz
אַמתַּחַת	sack
אֵפוֹ אֵפוֹא	then
אָרֵך	slow
אַרתַּחשַׁשׁתָּא אַרתַּחשַׁשׁתּא	Artaxerxes
בָּעַל	married
גָּדִי	Gadites
גָּזַז	off
גֶּזֶר	Gezer
גּוּלָּה	bowls
גָּלוּת	exiles
גְּעָרָה	rebuke
גּוֹשֶׁן	Goshen
דָּגָה	fish
דָּמָה	ruined
דַּק	thin
דָּרְיָוֵשׁ	Darius
דֶּשֶׁא	grass
דֶּשֶׁן	ashes
הַוָּה	destruction
זוּ	which
זִמרִי	Zimri
חוּר	Hur
חָצָה	divided
חֲשַׁביָה חֲשַׁביָהוּ	Hashabiah
חָשָׁה	silent
טָּהֳרָה	cleansing
כּוֹרֶשׁ כּוֹרֶשׁ	Cyrus
כָּלִיל	perfect
כַּרמֶל	field
כָּתָב	script
מוֹאזֵן	scales
מִבטָּח	confidence
מוּר	change
מְחִיר	price
מִלּוּא	ordination
*** 1951 - 2000 (/course/1969831/strongs-numbers-biblical-hebrew/40/)	
מַעֲלֶה	ascent
מְפִיבּוֹשֶׁת מֶפִבוֹשֶׁת	Mephibosheth
מִקנָה	purchase
מִריָם	Miriam
נְבוּזַראֲדָן	Nebuzaradan
נָגַן	play
נְהַר	river
נָשָׁא	made
סַל	basket
סָתַם שָׂתַם	stopped
עֵבֶר	Eber
עַם	people
עֲנָתוֹת	Anathoth
עֵקֶב	because
עֵרֶב עֶרֶב	Arabia
עָרָה	bare
עֲרָפֶל	darkness
עָרַץ	tremble
עוֹשֶׁק	oppression
פָּצָה	opened
פֶּרֶץ	Perez
פַּת	piece
צִּיצּ צִּץ	blossom
צֶּמֶד	pair
צָּמַת	destroy
צִּקלַג צִּיקְלַג	Ziklag
קָדַד	bowed
קֳהָתִי	Kohathites
קֶמַח	flour
רַב	great
רַבָּה	Rabbah
רוֹמַח	spears
רְמִיָה	deceit
רִשׁעָה	wickedness
שְׂבָכָה	network
שׁוּשַׁן שׁוֹשָׁן שׁוֹשָׁן שׁוֹשַׁנָּה	lily
שְׂחוֹק שְׂחוֹק	laughter
שָׁעָה	regard
שֶׁרֶץ	things
תּוֹאַר	form
תַּנּוּר	oven
תְּרָפִים	idols
אֵזוֹר	waistband
אֱלִיעֶזֶר	Eliezer
אִלֵּך	these
אָנַף	angry
בֵּיתּ חוֹרוֹן	Beth-horon
בְּכוֹרָה בְּכוֹרָה	birthright
בֶּלַע	Bela
בָּנִי	Bani
*** 2001 - 2050 (/course/1969831/strongs-numbers-biblical-hebrew/41/)	
בָּר בַּר	grain
בָּרִיא	fat
גְּאוּלָּה	redemption
גְּבִיַע	cups
גָּעַר	rebuke
גָּרָה	provoke
גֵּרְשׁוֹם	Gershom
דְּבִיר דְּבִר	Debir
דֶּגֶל	standard
דּוּשׁ דּוֹשׁ דִּישׁ	threshing
דָּת	law
הָמַם	routed
חַד	one
חֲוָא	shew
חוּשַׁי	Hushai
חוֹתָם חוֹתָם	seal
חָכָה	wait
חַכִּים	men
חַלָּה	cake
חוֹם	heat
חֵת	Heth
טּוּל	hurled
יַבָּשָׂה	land
יָגוֹן	sorrow
יְחִיאֵל יְחַואֵל	Jehiel
יְרוּבַּעַל	Jerubbaal
יְרוּשָּׁה	possession
יוֹשֶׁר	uprightness
כָּבֵד	liver
כָּבַשׁ	subdued
כְּהוּנָּה	priesthood
לָבִיא לְבִיָא לְבָאִים לְבָאוֹת	great
לוּלֵא לוּלֵי	except
לַפִּידּ לַפִּד	torches
מָחַץ	shatter
מֵישַׁך	Meshach
מִכשׁוֹל מִכשׁוֹל	block
מֶמשָׁלָה	dominion
מָן	manna
מָנָה	portions
מִספֵּד	mourning
מַעֲרָב מַעֲרָבָה	west
נְתַנאֵל	Nethanel
נֶתֶק	scale
סוּג	turned
עֲבֵד נֶגוֹא	Abed-nego
עֲבַר	beyond
עֶגלָה	heifer
עוּזָּא עוּזָּה	Uzza
עָכַר	trouble
*** 2051 - 2100 (/course/1969831/strongs-numbers-biblical-hebrew/42/)	
עֲלַל	brought
עוֹמֶר	omer
עַמרָם	Amram
עֶפרוֹן	Ephron
עָצֵל	sluggard
פָּאַר	glorified
פָּגַשׁ	met
פּוַּח	utters
פְּעוּלָּה	recompense
פֶּרֶד	mules
פָּרַס	divide
פַּשׁחוּר	Pashhur
צָּבָא	war
צַּעַד	steps
קְבוּרָה קֶבוּרָה	grave
קָצַץ	off
קָרֵַח	Kareah
קֶרֶן	horn
רֵאשׁ	head
רָוָה	fill
רֵיק רֵק	empty
שְׁאֵלָה שֵׁלָה	petition
שָׁאַף	pant
שְׂאֵת	swelling
שַׁדרַך	Shadrach
שְׁלַח	sent
שָׁלטָּן	dominion
שָׁרַץ	swarms
תּוֹר תּוֹר	turtledoves
תּוֹשָׁב תּוֹשָׁב	sojourner
תַּחַשׁ	porpoise
תָּם	blameless
אוֹפִיר אוֹפִיר אוֹפִר	Ophir
אֵיתָּן	enduring
אֵלָה	oak
אָמוֹץ	Amoz
אָמַל	fails
אָנאָ אָנָּה	beseech
אָרַג	weaver's
בָּחִיר	ones
בָּרָק	Barak
בַּת	baths
גַּב	rims
גּוֹדֶל	greatness
גַּו	midst
גְּוִיָה	body
גָּזַר	off
גֵּרְשׁוּנִּי	Gershonites
דָּגוֹן	Dagon
דֵּך דָּך	this
*** 2101 - 2150 (/course/1969831/strongs-numbers-biblical-hebrew/43/)	
הֲדַד	Hadad
הֵיכַּל	temple
הֵן	which
הִנּוֹם	Ben-hinnom
וָו	hooks
זֵד	arrogant
זוֹב	discharge
זָמַם	purposed
חָבַק	embrace
חָזֶה	breast
חֲמוֹר	Hamor
חָמַם	hot
חָמֵץ	leavened
חַנָּה	Hannah
חַנּוּן	gracious
חָנֵף	godless
חִצִּי חֵצִי	arrow
חוֹר חוֹר	nobles
חֶרמוֹן	Hermon
טִּיטּ	mire
טַּעַם	taste
יְבוּל	produce
יָלִידּ	descendants
יַעֲזֵיר יַעזֵר	Jazer
יְעִיאֵל	Jeiel
יֶרַח	month
יְרִימוֹת יְרֵימוֹת יְרֵמוֹת	Jeremoth
יְשִׁימוֹן	desert
כֶּסֶל	loins
כְּסַף	silver
כְּעַן	now
כֶּשֶׂב	sheep
לוּלָאָה	loop
מַבּוּל	flood
מִבחָר	choicest
מָה	what
מַחֲנַיִם	Mahanaim
מַחסוֹר מַחסוֹר	want
מִיכָּאֵל	Michael
מֵצַח	forehead
מְצֵלֶת	cymbals
מִרעֶה	pasture
מָרַר	bitter
מַשׂכִּיל	Maschil
נְבוֹ	Nebo
נְבָלָה	thing
נְגִינָה נְגִינַת	song
נָעִים	pleasant
נָשָׁה	creditor
נֵתַח	pieces
*** 2151 - 2200 (/course/1969831/strongs-numbers-biblical-hebrew/44/)	
סַנחֵרִיבּ	Sennacherib
עֶגלוֹן	Eglon
עֲדִי	ornaments
עִדָּן	time
עַמִּינָדָב	Amminadab
עָקֵב עִקְּבָה	heel
פֶּלֶא	wonders
פְּנִימָה	within
פִּסֵַּח	lame
פָּקִידּ	overseer
צָּחַק	laugh
צְּפַרדֵַּע	frogs
קָבַל	accept
קַדִּישׁ	saints
קֵינִי קִינִי	Kenite
קַל	swift
קֵן	nest
רָבַב	many
רַחוּם	compassionate
רֵכָב	Rechab
רָמָה	beguile
רְמַליָהוּ	Remaliah
רָעַם	roar
שַׂגִּיא	great
שׁוּט	about
שְׁחִין	boils
שִׂיַח	complaint
שִׁכּוֹר שִׁכּוֹר	drunk
שְׁפַטיָה שְׁפַטיָהוּ	Shephatiah
שְׂרֵפָה	burning
תָּא תָּאָה	guardrooms
תַּחתּוֹן תַּחתּוֹן	lower
תַּעַר	sheath
תֶּרַח	Terah
אֲבִיהוּא	Abihu
אֲבִינָדָב	Abinadab
אַדֶּרֶת	mantle
אוֹן	strength
אֶליָקִים	Eliakim
אָנַח	groan
אָסִיר	prisoners
אָרנָן	Ornan
אַשׁקְלוֹן	Ashkelon
בָּדָד	alone
בּוֹהֶרֶת	spot
בּוּז	contempt
בּוּס	squirming
בִּי	alas
בְּעָא בְּעָה	requested
בַּרזִלַּי	Barzillai
*** 2201 - 2250 (/course/1969831/strongs-numbers-biblical-hebrew/45/)	
גְּדוּלָה גְּדוּלָּה גְּדוּלָּה	greatness
גֵּיחֲזִי גֵּחֲזִי	Gehazi
גּוּלגּוֹלֶת	head
גַּנָּה	gardens
דּוֹב דּוֹב	bear
דָּקַק	crushed
הֶאָח	aha
הָגָר	Hagar
הִמּוֹ הִמּוֹן	these
הוֹר	Hor
הָרָר	hill
זֶבַח	Zebah
זוֹה	this
זִכרִי	Zichri
זָעַם	cursed
חָבֵר	companions
חוַֹח	bush
חֵזֶו	visions
חֲלִיפָה	changes
חָנָן	Hanan
חָפָה	covered
חֵקֶר	unsearchable
חָרָן	Haran
חָרַץ	decreed
טּוַּח	over
יָחִידּ	only
יְכֵל יְכִיל	able
כְּפוֹר	bason
כְּתָב	inscription
לַהַב	flame
לַחַץ	oppression
מְגִדּוֹן מֶגִדּוֹ	Megiddo
מְהוּמָה	confusion
מוֹטָה	yoke
מוֹרָא מוֹרָא מוֹרָה	fear
מַחלִי	Mahli
מַחמָד	desire
מַסַּע	journeys
מִצנֶפֶת	turban
מִקוֶה מִקוֵה מִקוֵא	abiding
מַקצּוַֹע מַקצּוַֹע מַקצּוֹעָה	corners
מוֹר מוֹר	myrrh
מָרַט	polished
מְשׁוּבָה מֶשׁוּבָה	faithless
מִשׁעֵנָה מִשׁעֶנֶת	staff
מָתוֹק מָתוּק	sweet
נָאָה	pastures
נָפַח	blow
נְצִיבּ נְצִב	garrisons
נֶשֶׁך	interest
*** 2251 - 2300 (/course/1969831/strongs-numbers-biblical-hebrew/46/)	
נֶשֶׁף	twilight
סְגִד	worship
סָכַן	benefit
סָלַל	build
סָעַד	sustain
עָזַז	prevail
עָמִיתּ	neighbor
עֲמָלֵקִי	Amalekites
עֲנָה	Anah
עָקָר	barren
עָשׁ עֲסַב	moth
עַשׁתָּרוֹת עַשׁתָּרוֹת	Ashtaroth
פֶּטֶר פִּטרָה	firstling
צּוֹבָא צּוֹבָה צּוֹבָה	Zobah
צִּיר	ambassador
צַּלמוּנָּע	Zalmunna
צֶּמַח	Branch
קֵדָר	Kedar
קֶדֶשׁ	Kedesh
קוֹץ קוֹץ	thorns
קָצִין	rulers
רוֹאשׁ רוֹשׁ	poison
רָבַע	square
רַגלִי	foot
רָגַע	break
רוּת	Ruth
רִיק	empty
רְמָה	cast
רִקמָה	embroidered
שְׁאָר	rest
שִׁביָה	captives
שׁוֹא שׁוֹאָה שׁוֹאָה	ravages
שָׁחַר	seek
שׁוּם	name
שָׁקַד	watching
שָׁרַק	hiss
תִּמנָה	Timnah
תָּמָר	trees
אֲבִירָם	Abiram
אֲבָל	truly
אֱדוֹמִי	Edomite
אוֹדוֹת אוֹדוֹת	because
אַיָל	deer
אִישׁ ־ בּוֹשֶׁת	Ish-bosheth
אֱלִיהוּ אֱלִיהוּא	Elihu
אֲנָחָה	sighing
אֱסָר אִסָּר	obligation
אֲרַמִּי	Aramean
אָרַשׂ	engaged
אֶתנַן	earnings
*** 2301 - 2350 (/course/1969831/strongs-numbers-biblical-hebrew/47/)	
בְּהַל	alarmed
בּוּז	despise
בִּלהָה	Bilhah
בֵּן	exiles
בְּרִיעָה	Beriah
בֶּרֶכיָה בֶּרֶכיָהוּ	Berechiah
בַּת ־ שֶׁבַע	Bathsheba
גָּאַל	defiled
גָּדֵר	wall
גָּזִיתּ	stone
גַּלגַּל	wheels
גִּלעָדִי	Gileadite
גֵּרָה	cud
דְּדָן דֶּדָנֶה	Dedan
דָּחָה דָּחַח	down
דִּיבּוֹן דִּיבּוֹן	Dibon
דָּקַר	through
דָּשֵׁן	anointed
הָדַף	driven
הֲלוֹם	here
זָדוֹן	arrogance
זַך	pure
זְמָן	time
זָנָב	tail
זָנוּן	harlotry
חֶבֶר	Heber
חַגַּי	Haggai
חֲמוֹת חֲמוֹת	mother-in-law
חָנוּן	Hanun
חֲנָנִי	Hanani
חָנֵף	polluted
חָפֵץ	delight
חַרטּוֹם	magicians
חָרִם	Harim
חָרַר	burned
חָשַׂף	bared
חָשַׁק	delight
טָּבַח	slaughter
טָּעַם	taste
יְדַעיָה	Jedaiah
יִדְּעוֹנִי	spiritists
יְהוֹחָנָן	Johanan
יוֹאָח	Joah
יוֹזָבָד	Jozabad
יָוָן	Javan
יֶפֶת	Japheth
יָקַר	precious
יוֹתֶרֶת	lobe
כָּנַס	gather
לְבֵנָה	bricks
*** 2351 - 2400 (/course/1969831/strongs-numbers-biblical-hebrew/48/)	
לָהַט	burns
לֶמֶך	Lamech
מָגוּר מָגוּר	sojourning
מַד מֵד	armor
מְדִינָה	province
מוֹסָדָה מוֹסָדָה	foundation
מוֹסֵר מוֹסֵרָה מוֹסְרָה	bonds
מְחִתּתָּה	ruin
מִכמָס מִכמָשׁ מִכמַשׁ	Michmash
מִלכָּה	Milcah
מַעֲבָר מַעֲבָרָה	ford
מְצוֹלָה מְצוֹלָה מְצוּלָה מְצוּלָה	depths
מַראָה	glass
מַשׁחִיתּ	destruction
נָבַע	utter
נָגַח	gores
נָחַשׁ	divination
נָחַת	bend
נְטוֹפָתִי	Netophathite
נָעַר	overthrew
נְפַל	down
נְפַק	taken
נָצָה	waste
סוֹלְלָה סוֹלְלָה	ramp
סַפִּיר	sapphire
עָוַת	pervert
עוּזִּי	Uzzi
עָמַל	labored
עָנַן	bring
עֲצָרָה עֲצֶרֶת	assembly
עִקֵּשׁ	perverse
עָרוּם	man
עָרֵם עֲרֵמָה	heaps
פָּארָן	Paran
פַּדָּן פַּדַּן אֲרָם	Paddan-aram
פֶּקַח	Pekah
פָּתִיל	cord
צֶּאֱצָא	offspring
צּוּק	oppress
צֵּידָּה צֵּדָה	provisions
צְּלָפחָד	Zelophehad
קָדקוֹד	head
קִדרוֹן	Kidron
קְנַז	Kenaz
קֶסֶם	divination
קְרָא	read
קָרחָה קָרחָא	baldness
רִבּוֹ רִבּוֹא	20000
רִבלָה	Riblah
רוַּח	accept
*** 2401 - 2450 (/course/1969831/strongs-numbers-biblical-hebrew/49/)	
רוַּח	spirit
רְעוּאֵל	Reuel
רוֹעִי	shepherd
רְצִין	Rezin
רָקַע	spread
שָׁבַח	commend
שַׁבָּתוֹן	rest
שׁוֹהַם	onyx
שׁוֹט	scourge
שׁוּל	hem
שַׁועָה	cry
שָׁמִיר	briars
שָׁסָה שָׁשָׂה	plundered
שֶׁקֶץ	detestable
תּוּשִׁיָה תּוּשִׁיָה	wisdom
תִּיכּוֹן תִּיכּוֹן	middle
תֵּימָן תֵּמָן	Teman
תְּלָת תְּלָתָה תְּלָתָא	three
תְּעָלָה	conduit
אִגֶּרֶת	letters
אָדַם	red
אָדָם	Adam
אוּץ	hasty
אֵזוֹב	hyssop
אַיָלוֹן	Aijalon
אֵיפוֹה	where
אֵלוֹן	oak
אֱלִיאֵל	Eliel
אִמֵּר	Immer
אֲפֵלָה	gloom
אֶפרָת אֶפרָתָה	Ephrath
אַריֵה	lion
אַתּתּוּן	furnace
בֶּדֶק	damages
בִּזָּה	plunder
בַּלָּהָה	terrors
בְּעוֹר	Beor
בְּתוּאֵל	Bethuel
בְּתוּלִים	virgin
גּוֹב	den
גְּבוּלָה גֶּבוּלָה	borders
גָּדַר	build
גְּדֵרָה	walls
גּוֹג	Gog
גָּלָל	account
גָּעַל	loathed
גְּרָר	Gerar
גִּתּתִּי	Gittite
דְּבוֹרָה דֶּבוֹרָה	Deborah
דְּקַק	crushed
*** 2451 - 2500 (/course/1969831/strongs-numbers-biblical-hebrew/50/)	
דָּרְיָוֵשׁ	Darius
דָּתָן	Dathan
הָתַל	mocked
וַשׁתִּי	Vashti
זוּד זִידּ	arrogantly
זִיף	Ziph
זֵר	molding
חָדַשׁ	renew
חוּרָם	Huram
חָלָץ	loins
חֶמאָה חֵמָה	curds
טֶּבַח	slaughter
טָּבַע	sunk
יְהוּדָאִי	Jews
יְהוֹיָכִין	Jehoiachin
יָחַם	mating
יָעַף	weary
יָצַר	distressed
יָקַץ	awoke
יְרוֹחָם	Jeroham
יִתרוֹ	Jethro
יִתרוֹן	advantage
כַּבִּיר	mighty
כֶּלֶא	prison
מִלּוֹא מִלּוֹא	Millo
מִמכָּר	sale
מַמרֵא	Mamre
מָן	whomever
מִסתָּר	places
מְעוֹנָה מְעוֹנָה	dens
מַצָּב	garrison
מְצַד מֶצָד מֶצָדָה	strongholds
מִצפֶּה	Mizpah
מָקַק	rot
מִקרֶה	fate
מִקשָׁה	work
מִרעִיתּ	pasture
מִשׁלוַֹח מִשׁלוַֹח מִשׁלָח	lay
נָאוֶה	lovely
נָגַר	down
נָהַל	guide
נָזַר	consecrate
נְחוּשָׁה נְחוּשָׁה	bronze
נַחשׁוֹן	Nahshon
נֵרִיָה נֵרִיָהוּ	Neriah
נֶשֶׁק נֵשֶׁק	weapons
סַנבַּלַּט	Sanballat
סָפַק שָׂפַק	clap
עָדָה	adorn
עִדּוֹ עִדּוֹא עִדִּיא	Iddo
*** 2501 - 2550 (/course/1969831/strongs-numbers-biblical-hebrew/51/)	
עָדַר	dig
עוֹבֵד	Obed
עֵירוֹם עֵרוֹם	naked
עִלַּי	high
עָנַג	delight
עַפעַף	eyelids
עֵר	Er
עוֹרֵב עוֹרֵב	raven
עֶרֶשׂ	couch
פָּזַר	scattered
פֶּחָה	governor
פַּחַת	pit
פֶּלֶג	streams
פְּלַח	serve
פֶּלֶך	district
פֶּרֶא פֶּרֶה	donkey
פָּרַק	off
פִּתּתּוַּח פִּתּתּוַּח	engravings
צְּבָא	wished
צָּמֵא	thirst
צִּן	Zin
צּוֹעַר	Zoar
צְּפַניָה צְּפַניָהוּ	Zephaniah
צְּרוֹר צְּרוֹר	bag
צָּרעָה	Zorah
קַדמוֹנִי קַדמוֹנִי	east
קָדֵשׁ בַּרנֵַע	Kadesh-barnea
קָמָה	grain
קִניָן	goods
קֶרֶס	clasps
רְחוֹב רְחוֹב	Rehob
רַעיָה	darling
שַׁאֲנָן	ease
שֶׁבַע	Sheba
שְׁכַניָה שְׁכַניָהוּ	Shecaniah
שַׁלִּיטּ	ruler
שֶׁלֶמיָה שֶׁלֶמיָהוּ	Shelemiah
שָׁמֵן	fat
שְׁפִי	heights
שְׁרִירוּת	stubbornness
שָׁתַל	planted
תָּבוֹר	Tabor
תַּהפּוּכָה	things
תְּמוּנָה תְּמוּנָה	form
אַב	father
אַבנֵט	sash
אֲגַם	pool
אָדוֹם	red
אֵהוּד	Ehud
אֲחַשׁדַּרפַּן	satraps
*** 2551 - 2600 (/course/1969831/strongs-numbers-biblical-hebrew/52/)	
אֵל	these
אֶליְהוֹעֵינַי אֶליוֹעֵינַי	Elihoenai
אֱלִיפֶלֶט אֱלפֶּלֶט	Eliphelet
אָלַם	mute
אָמנָם	truly
אָנַשׁ	incurable
אוֹפֶל	darkness
אֲפֵק אֲפִיק	Aphek
אֲרֻבָּה	windows
אֲרַונָה אוֹרנָה אַנִיָה	Araunah
אַרפַּכשַׁד	Arpachshad
אֶשׁכּוֹל אֶשׁכּוֹל	cluster
אָשׁוּר אַשּׁוּר	step
אִתּתַּי אִיתַּי	Ithai
בֵּיתּ שְׁאָן בֵּיתּ שָׁן	Beth-shean
בֶּן ־ יְמִינִי בֶּן ־ הַ ־ יְמִנִי בֶּן ־ אִישׁ יְמִינִי	Benjamite
בַּעֲנָה	Baanah
בְּצַלאֵל	Bezalel
בָּקַק	luxuriant
גְּבֶרֶת	mistress
גִּיל	exceedingly
גְּלָה גְּלָא	reveals
גַּעַל	Gaal
גָּעַשׁ	shaken
גֵּרָא	Gera
גְּשׁוּר	Geshur
דִּבָּה	report
דָּלַל	low
דָּלַק	burning
דָּעַך	goes
הָלַם	beat
זְבַדיָה זֶבַדיָהוּ	Zebadiah
זַכּוּר	Zaccur
זְנוּת	harlotry
זֶרֶם	storm
חִזָּיוֹן	vision
חָטַב	wood
חֲסַף	clay
חָפַז	alarm
חֵפֶר	Hepher
חֲרָדָה	trembling
חָרמָה	Hormah
חֵרֵשׁ	deaf
טְּרֵפָה	torn
יָאִיר	Jair
יָבֵשׁ	dry
יְדִידּ	beloved
יַהַץ יַהצָּה יַהצָּה	Jahaz
יוֹבָב	Jobab
יֶלֶק	locust
*** 2601 - 2650 (/course/1969831/strongs-numbers-biblical-hebrew/53/)	
יָע	shovels
יְעוּשׁ	Jeush
יִצהָר	Izhar
יֵצֶר	intent
יָקַד	burning
כְּבָר	already
כֵּהֶה	dim
כּוּר	furnace
כִּידּוֹן	javelin
כּוֹר	cor
כָּרָע	legs
כֶּתֶם	gold
לָהֵן	but
לֶקַח	teaching
מָהַהּ	delay
מוֹרָשָׁה	possession
מֵיתָּר	cords
מִכתָּב	writing
מוֹלֶך	Molech
מַמלָכוּת	kingdom
מַעֲרָב	merchandise
מַעֲרֶכֶת	showbread
מַקֵּדָה	Makkedah
מִשׁבְּצָה	filigree
מֶשֶׁך	Meshech
מָשַׁשׁ	grope
נָדַף	driven
נְחָשׁ	bronze
נָחָשׁ	Nahash
נָטַר	angry
נָסַג	away
נָקוֹד	speckled
נָתַח	cut
סְאָה	measures
סָבַל	bear
סוּך	anoint
עֲדָא עֲדָה	away
עֲדָיָה עֲדָיָהוּ	Adaiah
עָדַף	excess
עוֹפֶרֶת עוֹפֶרֶת	lead
עֲזָרָה	ledge
עַיִר	donkeys
עַמִּיהוּד	Ammihud
עָמֵל	labors
עָמַס עָמַשׂ	loaded
עָמַק	deeply
עָנָק	Anak
עֲנָקִי	Anakim
עָנַשׁ	fine
עוֹפֶל	emerod
*** 2651 - 2700 (/course/1969831/strongs-numbers-biblical-hebrew/54/)	
עָרוֹב	swarms
עֲרָבִי עַרבִּי	Arabian
עָשַׂר	tenth
עָתַק	old
פָּז	gold
פְּנוּאֵל פְּנִיאֵל	Penuel
פָּתַר	interpreted
צָּהַל	bellow
צַּו צָּו	order
צּוּץ	bloom
צָּמֵא	thirsty
קוּץ	dread
קְרֵב	approached
קְרָב	war
קִריָא קִריָה	city
קִריַת אַרבַּע קִריַת הָאַרבַּע	Kiriath-arba
רְאֵם רְאֵים רֵים רֵם	ox
רָז	mystery
רָקַד	skip
רָקַם	weaver
שְׁאַלתִּיאֵל שַׁלתִּיאֵל	Shealtiel
שֶׁבנָא שֶׁבנָה	Shebna
שֶׁבֶר	grain
שׁוֹבָל	Shobal
שְׁזַב	deliver
שְׁכָבָה	emission
שֶׁלַח	Shelah
שָׁלַשׁ	old
שְׂמָאלִי	left
שָׁמַט	release
שְׁמַע	heard
שָׁנַן	sharp
שָׁסַע	split
שָׁעַע	stare
שַׁעשׁוַּע	delight
שִׁריוֹן שִׁריָן שִׁריָה שִׁריוֹנָה	armor
שְׁתִי	warp
תְּלוּנָה תְּלוּנָּה	murmuring
תָּמַהּ	amazed
תּוֹפֶת	Topheth
אָבִיבּ	Abib
אָבֵל	mourning
אֶבֶן	stone
אֲגַג	Agag
אֲדָר	Adar
אֶדרֶעִי	Edrei
אָהֳלִיבָּמָה	Oholibamah
אוֹנָן	Onan
אוּרִי	Uri
אָטַם	latticed
*** 2701 - 2750 (/course/1969831/strongs-numbers-biblical-hebrew/55/)	
אַיָלָה	doe
אֵילוֹת אֵילַת	Eloth
אֵיתָּן	Ethan
אַכזָרִי	cruel
אַלּוֹן	oak
אֶלֶף	herd
אוּמָּה	nations
אַרבַּע	four
אֶתמוֹל אִתמוֹל אֶתמוּל	time
אֲתַר	after
בּוּץ	linen
בִּכרִי	Bichri
בֵּלטְּשַׁאצַּר	Belteshazzar
בְּמוֹ	through
בָּצרָה	Bozrah
בַּקָּשָׁה	request
בַּר	son
בַּר	field
גְּאֶה	proud
גֵּאוּת	majesty
גִּבעוֹנִי	Gibeonites
גָּדַד	cut
גִּזרָה	area
גִּלבּוַֹע	Gilboa
גָּנַן	defend
דִּינָה	Dinah
דַּלָּה	hair
דָּלִיָה	branches
דְּרוֹר	release
הֶבֶל	Abel
הָסָה	silent
זָבָד	Zabad
זָכָה	blameless
זָלַל	down
חוֹר חוֹר	hole
חֲטָאָה	sin
חָכמָה	wisdom
חַמָּן	altars
חָמַס	violence
חֲנוּכָּה	dedication
חָרֵב	desolate
חָרָבָה	ground
חֵשֶׁב	band
חָשׁוּק חָשׁוּק	bands
חִתּתִּיתּ	terror
חָתַר	dig
טָּחַן	grind
טָּלָא	spotted
יָבִין	Jabin
יָגָה	grieve
*** 2751 - 2800 (/course/1969831/strongs-numbers-biblical-hebrew/56/)	
יְהוֹנָדָב	Jonadab
יְהוֹצָדָק	Jehozadak
יוֹתֵר	advantage
יִזרְעֵאלִי	Jezreelite
יַחַת	Jahath
יָכִין	Jachin
יַעֲנָה	ostriches
יָפַע	shine
יָצוַּע	bed
יְקַד	blazing
יָקַע	disgusted
יָקוֹשׁ	snared
יְרַחמְאֵל	Jerahmeel
יִשׁמָעֵאלִי	Ishmaelites
יִשׂרָאֵל	Israel
יַתּתִּיר	extraordinary
יֶתֶר	Jether
כָּאַב	pain
כְּבָר	Chebar
כִּבשָׂה כַּבשָׂה	lamb
כָּהָה	darken
כָּהֵן	priests
כּוֹרֶשׁ	Cyrus
כְּמוֹשׁ כְּמִישׁ	Chemosh
כֵּן	follows
כְּסוּת	covering
כַּרמִי	Carmi
כְּרֵתִי	Cherethites
כַּשׂדַּי	Chaldeans
כְּתַב	writing
כִּתּתִּי כִּתּתִּיִי	Kittim
לִבָּה	heart
לָבַן	brick
לוּז	Luz
לַעֲנָה	wormwood
מְאָה	100
מֶגֶד	choice
מָגוֹר מָגוּר	terror
מִדיָנִי	Midianite
מוּשִׁי מוּשִּׁי	Mushi
מַחבֶּרֶת	set
מִחיָה	reviving
מְחוֹלָה	dancing
מְטָא מְטָה	reached
מַטעַם מַטעַמָּה	dish
מְלֵאָה	produce
מַלבּוּשׁ מַלבּוּשׁ	attire
מָלוֹן	place
מַלקוַֹח	booty
מַלקוֹשׁ	rain
*** 2801 - 2850 (/course/1969831/strongs-numbers-biblical-hebrew/57/)	
מָנוֹס	flight
מְנַחֵם	Menahem
מָעוֹן	Maon
מַעֲכָתִי	Maacathite
מַעֲנֶה	answer
מַפֶּלֶת	fall
מִפתָּן	threshold
מוֹץ מוֹץ	chaff
מְצוּרָה מְצוּרָה	fortified
מַראֵשָׁה מַרֵשָׁה	Mareshah
מְרַאֲשָׁה	head
מְרִיא	fatlings
מַתּתִּתיָה מַתּתִּתיָהוּ	Mattithiah
נוּא	forbid
נְחֶמיָה	Nehemiah
נַחַת	down
נָעַל	bolt
נָעֵם	pleasant
נָתַר	asunder
סְגוּלָּה	possession
סוֹהַר	jail
סִיגּ סוּג	dross
סָכַל	foolishly
סָרָה	rebellion
עַבדּוֹן	Abdon
עָדָה	Adah
עֲדוּלָּם	Adullam
עוּץ	Uz
עַזמָוֶת	Azmaveth
עֵיבָּל	Ebal
עַיִט	prey
עָלַץ	exult
עִניָן	task
עָפרָה	Ophrah
עַקּוּב	Akkub
עָרֵב	pleasing
עֲשָׂיָה	Asaiah
פְּדָיָה פְּדָיָהוּ	Pedaiah
פּוּר פּוּרִים פּוּרִים	Purim
פְּלֶשֶׁת	Philistia
פִּסגָּה	Pisgah
פָּסַח	halt
פָּצַח	forth
פֶּצַע	wound
צִּבעוֹן	Zibeon
צָּעַד	marched
קָבַב	curse
קַדמִיאֵל	Kadmiel
קוֹא קָיָה	vomit
קוּן	chant
*** 2851 - 2900 (/course/1969831/strongs-numbers-biblical-hebrew/58/)	
קָרֵב	near
קָרחִי	Korahites
קַרקַע	floor
קַשׂקֶשֶׂת	scales
קָשַׁשׁ	stubble
רֶבַע	sides
רַברַב	great
רַברְבָן	nobles
רְחוּם	Rehum
רָכַך	fainthearted
רָפָה	spirits
רִצפָּה	coal
רָקִיק	wafers
שָׂבָע	abundance
שׂוֹבַע	full
שָׂבֵַע	full
שָׂבַר שָׁבַר	hope
שׂוֹכוֹה שׂוֹכוֹה שׂוֹכוֹ	Socoh
שׁוּנַמִּיתּ	Shunammite
שֵׁלָה	Shelah
שָׁלֵו שָׁלֵיו שְׁלֵוָה	ease
שַׁלוָה	ease
שֶׁלַח	weapon
שָׁלַט	empowered
שִׁנעָר	Shinar
שָׂעַר	afraid
שָׁפָט	Shaphat
שֵׁרֵביָה	Sherebiah
שָׁרַשׁ	root
שֵׁת	Seth
תּוּב	returned
תּוּבַל תּוּבַל	Tubal
תֵּימָנִי	Temanite
תְּנוּך	lobe
תְּשׁוּבָה תֶּשׁוּבָה	turn
אֲבַד	destroy
אֲבִיעֶזֶר	Abiezer
אַגָּף	troops
אַוָּה	desire
אוּרִים	Urim
אַזכָּרָה	memorial
אֲזַל	went
אֲחִינוֹעַם	Ahinoam
אֲחוֹרַנִּיתּ	backward
אַט	gently
אֲכַל	devour
אִכָּר	farmer
אֶלנָתָן	Elnathan
אֱנוֹשׁ	Enosh
אָנִי	ships
*** 2901 - 2950 (/course/1969831/strongs-numbers-biblical-hebrew/59/)	
אָספַּרנָא	diligence
אֱסָר	injunction
אָפַק	controlled
אַצֵל	Azal
אֲריוֹך	Arioch
אַשׁמוּרָה אַשׁמוּרָה אַשׁמוֹרֶת	watch
אַשׁפּוֹת אַשׁפּוֹת שְׁפוֹת	refuse
אֶשׁתָּאוֹל אֶשׁתָּאוֹל	Eshtaol
בֵּיתּ אָוֶן	Beth-aven
בֵּלשַׁאצַּר	Belshazzar
בִּנּוּי	Binnui
בִּניָן	building
בָּצִיר	gathering
בָּקַר	seek
בַּר	pure
בָּשׂמַת	Basemath
גָּאָה	exalted
גָּדַף	blasphemed
גְּדוֹר גְּדוֹר	Gedor
גֵּו	among
גּוּר גּוּר	cubs
גָּזַּה	fleece
גִּידּ	sinews
גָּפרִיתּ	brimstone
גִּרגָּשִׁי	Girgashite
גָּרוֹן גָּרוֹן	throat
דָּאַג	anxious
דּוּד	basket
דּוּדַי	mandrakes
דּוּר	dwelt
דּוֹר דּוֹאר	Dor
דִּישׁוֹן דִּישׁוֹן דִּשׁוֹן דִּשׁוֹן	Dishon
דְּלָיָה דְּלָיָהוּ	Delaiah
הָדַר	honor
הֵידָּד	shouting
הַלָּז	this
הָרָן	Haran
זְאֵב	wolf
זִיקָה זִק זֵק	firebrands
זִלפָּה	Zilpah
זָמִיר זָמִר זְמִרָה	songs
זָקַק	refined
זֶרֶת	span
חַבּוּרָה חַבּוּרָה חֲבוּרָה	bruise
חֶבֶר	spells
חֲגוֹר חֲגוֹר חֲגוֹרָה חֲגוֹרָה	apron
חוּט	thread
חֲוִילָה	Havilah
חוֹף	seacoast
חֲזִיר	swine's
*** 2951 - 3000 (/course/1969831/strongs-numbers-biblical-hebrew/60/)	
חָח חָחִי	hooks
חַי	living
חִיל חִילָה	agony
חַיִל	aloud
חוֹל	profane
חוֹרֶף	winter
חוֹרֶשׁ	Horesh
טִּירָה	camps
יַבּוֹק	Jabbok
יְהוּד	Judah
יוֹנָדָב	Jonadab
יְכָניָה יְכָניָהוּ יְכוֹנְיָה	Jeconiah
יָפָה	beautiful
יְקָר	glory
יֶרֶד	Jared
יַרמוּת	Jarmuth
יִשִּׁיָה יִשִּׁיָהוּ	Isshiah
כְּלַל	finished
כִּנְּרוֹת כִּנֶּרֶת	Chinnereth
כְּנָת	colleagues
לְבַב	mind
לוֹטָן	Lotan
לָט	arts
לַיִשׁ	Laish
לַעדָּן	Ladan
לָקַק	lapped
לִשָּׁן	language
מָאן	utensils
מַהֲלַלאֵל	Mahalalel
מוֹעֵצָה	devices
מַזלֵג מִזלָגָה	fleshhook
מַחשָׁך	places
מִישָׁאֵל	Mishael
מַלּוּך מַלוּכִי	Malluch
מְנָת	portion
מַסגֵּר	smiths
מִסכְּנָה	storage
מָצָה	drained
מְצוּקָה מְצוּקָה	distresses
מְרִיבָּה	strife
מְרָיוֹת	Meraioth
מִרמָס	trample
מֵרֵַע	companion
מְשַׁמָּה	waste
מַשׁמָן	one
נֶגֶף	plague
נְהִי	wailing
נוֹעַם	favor
נוֹף	Memphis
נָשַׁל	remove
*** 3001 - 3050 (/course/1969831/strongs-numbers-biblical-hebrew/61/)	
נְתַן	bestows
סָכָל	fool
סִכלוּת שִׂכלוּת	folly
סָלַף	overthrows
סָעַר	away
סָרַח	lap
עֲבַד	servants
עָגַב	lusted
עוּגָּה	cake
עִזָּבוֹן	wares
עֲזֵקָה	Azekah
עָטַר	compass
עַכבּוֹר	Achbor
עַלִּיז	exultant
עַלמָה	maidens
עָמוֹס	Amos
עָנָף	boughs
עֶצֶב	idol
עֶציוֹן גֶּבֶר עֶציוֹן גֶּבֶר	Ezion-geber
עָקוֹד	striped
עָקַר	uproot
עוֹרֵב עוֹרֵב	Oreb
עָתנִיאֵל	Othniel
פְּאֵר	beauty
פְּאוֹרָה פּוֹרָאה פּוּארָה	branches
פּוּט	put
פּוּק	obtains
פֶּלֶג	Peleg
פָּלָה	apart
פְּלֵתִי	Pelethites
פַּעֲמוֹן	bell
פָּצַר	urged
פֶּרֶשׁ	refuse
פֶּתַע	suddenly
צָּבַר	piled
צָּמִידּ צָּמִד	bracelet
צּוֹעַן	Zoan
צִּפּוֹר	Zippor
צַּפַּחַת	jar
קוֹהֶלֶת	Preacher
קְטַל	slain
קָל	sound
קָלַע	carve
קָפַץ	shut
קֶרַח קוֹרַח	ice
קְרִי	hostility
קִריָתַיִם	Kiriathaim
רוֹגֶז	turmoil
רְגַל	feet
רָדַם	asleep
*** 3051 - 3100 (/course/1969831/strongs-numbers-biblical-hebrew/62/)	
רֵישׁ רֵאשׁ רִישׁ	poverty
רָם	ram
רִמָּה	worm
רָמַם	exalt
רְעוּת	striving
רָקַח	perfumer
רְשַׁם	signed
רֶשֶׁף	flashes
שְׁאָגָה	roaring
שְׁבַניָה שֶׁבַניָהוּ	Shebaniah
שָׁגַע	madman
שׁוּעָל שׁוּעָל	foxes
שַׁחַל	lion
שִׁישַׁק שׁוּשַׁק	Shishak
שַׁיִת	thorns
שְׁלֵט	authority
שֶׁלֶט	shields
שַׁמָּה	Shammah
שְׁנָה	year
שַׂעֲרָה	hair
שָׁקָם שִׁקמָה	trees
שָׁקַץ	detest
שָׁרוֹן	Sharon
שָׂרָף	serpent
שְׁרֵקָה	hissing
שַׁרשְׁרָה	chains
תָּאַר	Taanath-shiloh
תּוֹר	cattle
תַּחפַּנחֵס תְּחַפנְחֵס תַּחפְּנֵס	Tahpanhes
תַּעֲנָך תַּענָך	Taanach
תָּפֵל	things
תְּקוַֹע	Tekoa
תְּקוֹעִי תְּקוֹעִי	Tekoite
תַּרדֵּמָה	sleep
תַּרשִׁישׁ	beryl
אֲבִיהַיִל אֲבִיחַיִל	Abihail
אָבִיר	One
אָבָק	dust
אֲדַמדָּם	reddish-white
אָהֳלִיבָּה אָהֳלִיבָּהּ	Oholibah
אוּר	fire
אָזַל	gone
אַחיוֹ	Ahio
אֲחִיעֶזֶר	Ahiezer
אָחֳרִי	other
אָטָד	bramble
אַיָה	Aiah
אֵילוֹן אֵלוֹן אֵילוֹן	Elon
אֵילִם	Elim
אִילָן	tree
*** 3101 - 3150 (/course/1969831/strongs-numbers-biblical-hebrew/63/)	
אָלָה	take
אֱלִימֶלֶך	Elimelech
אֶליָסָף	Eliasaph
אֱלִיצָּפָן אֶלצָּפָן	Elizaphan
אִלֵּם	mute
אֶלעָשָׂה	Eleasah
אַמִּיצּ אַמִּץ	mighty
אוֹמֶר	promise
אָנָה	befall
אֲרוּכָה אֲרוּכָה	health
אֲרוּחָה	allowance
אֲרִיאֵל	Ariel
אַרכִּי	Archite
אַרפָּד	Arpad
אֲשֵׁדָה	slopes
אֶשׁכּוֹל	Eshcol
אַשָּׁף	conjurers
אַשׁפָּה	quiver
אֶשׁתְּמוַֹע אֶשׁתְּמוַֹע אֶשׁתְּמוֹה	Eshtemoa
בֵּבַי	Bebai
בִּגוַי	Bigvai
בְּדִיל	tin
בְּטֵל	stop
בֵּיצָּה	eggs
בְּכִירָה	firstborn
בְּעִיר	beasts
בַּעַל פְּעוֹר	Baal-peor
בּוֹר	cleanness
בָּרָה	eat
בְּשׂוֹרָה בְּשׂוֹרָה	news
גְּבִירָה	mother
גִּבְּתוֹן	Gibbethon
גְּזַר	diviners
גִּיַח גּוַֹח	broke
גִּיחוֹן גִּחוֹן	Gihon
גָּלִיל גָּלִילָה	Galilee
גָּליַת	Goliath
גּוֹמֶר	Gomer
גְּשׁוּרִי	Geshurites
דָּא	this
דּוֹאֵג דּוֹאֵג	Doeg
דְּאָגָה	anxiety
דְּבֵלָה	cake
דְּחַל	dreadful
דָּיֵק	wall
דְּלִילָה	Delilah
דּוֹמֶן	dung
דֵּעָה	knowledge
הַגרִי הַגרִיא	Hagrites
הֲדוֹם	footstool
*** 3151 - 3200 (/course/1969831/strongs-numbers-biblical-hebrew/64/)	
הֲדַס	myrtle
הָוָא הָוָה	breathe
הֲלִיכָּה	procession
זְאֵב	Zeeb
זַבדִּי	Zabdi
זְבוּל	Zebul
זְוָעָה	terror
זִיו	face
זַעַף	enraged
זִקנָה	age
זַרחִי	Zerahites
חֲבַל	destroyed
חֶברוֹנִי חֶברוֹנִי	Hebronites
חָדַד	sharpened
חָוָה	show
חָזקָה	force
חֲיָא חֲיָה	live
חָלִיל	flute
חֶמֶד	desirable
חַמָּה	sun
חָמֵץ	leavened
חוֹמֶץ	vinegar
חָמַר	daub
חֲמַר	wine
חֲסִידָּה	stork
חָסִיל	grasshopper
חוֹפֶן	fists
חָצַר חֲצוֹצֵר חֲצוֹרֵר	blew
חֲצֵרוֹת	Hazeroth
חָרֵד	afraid
חֳרִי	fierce
חוֹרִי	Horites
יָאַשׁ	hopeless
יְדִיעֲאֵל	Jediael
יְהוּדִיתּ	Judean
יוֹנֶקֶת	shoots
יַחֲזִיאֵל	Jahaziel
יָמִין	Jamin
יָעֵל	Jael
יָקטָּן	Joktan
יֶרֶק	green
יֵרָקוֹן	mildew
יָשָׁן	old
כְּאֵב	pain
כּוֹבַע	helmet
כַּחַשׁ	lies
כִּיס	bag
כֵּן	gnats
כָּסַף	eager
כִּפּוּר	atonement
*** 3201 - 3250 (/course/1969831/strongs-numbers-biblical-hebrew/65/)	
כָּשַׁף	sorcerers
כֶּשֶׁף	sorceries
כָּתַר	surround
לוּז	devious
לִויָתָן	Leviathan
לַח	fresh
לָחַך	lick
לְמוֹ	at
לִמּוּד לִמּוּד	accustomed
לַעַג	derision
מִגדּוֹל מִגדּוֹל	Migdol
מַדָּע מַדַּע	knowledge
מַהפֵּכָה	overthrew
מוֹט	bars
מָחוֹל	dancing
מַחֲלֶה מַחֲלָה	disease
מַטָּע	planting
מֵיטָּב	best
מַכבֵּר	cover
מֶכֶס	levy
מַכפֵּלָה	Machpelah
מִכתָּם	Michtam
מֶלקָח מַלקָח	snuffers
מִמשָׁל	authority
מָנוַֹח	rest
מַנעוּל מַנעוּל	bolts
מָעַד	slip
מַצֶּבֶת	pillar
מָצוֹק	distress
מֶרחָב	place
מְרִיבָּה	Meribah
מְרֵמוֹת	Meremoth
מִשׁכַּב	bed
מַשׂכִּיתּ	images
מְתוּשֶׁלַח	Methuselah
מַתּתָּת	gift
נוֹאדּ נוֹאדּ נוֹאדָּה	bottle
נוֹב	Nob
נְבִיאָה	prophetess
נָגַהּ	illumines
נֵד	heap
נָהַר	stream
נָוִיתּ	Naioth
נוּם	slumber
נָזִידּ	stew
נְחַת	deposed
נָמֵר	leopard
נְסִיכּ	offering
נָקַר	dug
נָשָׁה	forget
*** 3251 - 3300 (/course/1969831/strongs-numbers-biblical-hebrew/66/)	
סְבָלָה	burdens
סִין	Sin
סַלוּ סַלוּא סָלוּא סַלַּי	Sallai
סְנֶה	bush
סָעִיף	branches
סָפַח שָׂפַח	assign
סָפַן	paneled
סָפֵר	scribe
סְפַרוַיִם סְפָרִים	Sepharvaim
עֶבֶד	Ebed
עֶבֶד מֶלֶך	Ebed-melech
עָבַט	borrow
עֲבִידָּה	work
עָגוֹל עָגוֹל	circular
עֲזַראֵל	Azarel
עַזרִיקָם	Azrikam
עֵין גֶּדִי	Engedi
עִירָא	Ira
עַכבָּר	mice
עָכָן	Achan
עוֹלֵלָה	gleanings
עַמִּיאֵל	Ammiel
עַקרָב	scorpions
עָר	Ar
עֲרָב עֲרַב	Arabia
עֶריָה	bare
עָרַף	neck
עָשַׁן	smoke
עֲשַׂר עֲשׂרָה	ten
פְּדָהצּוּר	Pedahzur
פַּחַת מוֹאָב	Pahath-moab
פֶּלַח	slice
פָּלַס	level
פּוּם	mouth
פָּנִין פָּנִי	jewels
פָּסַל	cut
פְּרִיצּ	violent
פֶּרֶך	severity
פָּרַס	Persians
פַּרעוֹשׁ	Parosh
פַּתבַּג	food
פִּתגָּם	answer
פֶּתֶן	cobra
צִּיִי	desert
צְּלָצַל	cymbal
צָּפִיר	male
צְּרִי צֳּרִי	balm
קָבַע	rob
קַדמָה	state
קָדֵשׁ	prostitute
*** 3301 - 3350 (/course/1969831/strongs-numbers-biblical-hebrew/67/)	
קוּט	grieved
קוֹץ	Hakkoz
קוּר	dug
קֵינָן	Kenan
קִישׁוֹן	Kishon
קָלָה	degraded
קָלִי קָלִיא	grain
קַנָּא	jealous
רוֹאֶה	vision
רְבָה	great
רָבִיבּ	showers
רְבִיעַי	fourth
רָזַן	rulers
רָטַשׁ	pieces
רָכִיל	slanderer
רְעוּת	neighbor
רַעיוֹן	thoughts
רַעַם	thunder
רֶקֶם	Rekem
שָׁאָה	devastated
שְׁאֵל	asked
שְׁבוּאֵל שׁוּבָאֵל	Shebuel
שְׂבָם שִׂבמָה	Sibmah
שִׁבעָה	seven
שִׁבעָתַיִם	sevenfold
שְׁדֵפָה שִׁדָּפוֹן	blasted
שׁוּר	Shur
שָׁחוֹר שָׁחוֹר	black
שָׂטָה	astray
שָׁטַח	spread
שָׂטַם	against
שָׂטַן	accusers
שֶׁטֶף שֵׁטֶף	flood
שִׁילוֹנִי שִׁילוֹנִי שִׁלוֹנִי	Shilonite
שַׁכּוּל שַׁכּוּל	barren
שְׁלוֹמִיתּ שְׁלוֹמִיתּ	Shelomith
שַׁמַּי	Shammai
שָׁמֵם	desolate
שִׁפעָה	abundance
שָׁקַד	almond
שָׁקַע	died
שָׁקַק	quenched
שָׁקַר	falsely
שְׁרֵא	began
שָׂרַר	rule
שָׁתַן	male
תִּגלַת פִּלאֶסֶר תִּלגַּת פִּלנֶאֶסֶר	Tiglath-pileser
תּוֹחֶלֶת	hope
תּוֹלָע	crimson
תַּחבּוּלָה תַּחבּוּלָה	guidance
*** 3351 - 3400 (/course/1969831/strongs-numbers-biblical-hebrew/68/)	
תַּחַת	Tahath
תַּלמַי	Talmai
תְּמוּרָה	substitute
תִּמנָע	Timna
תַּפּוַּח	tree
תַּפּוַּח	Tappuah
תָּרמָה תַּרמוּת תַּרמִיתּ	deceit
תִּשׁבִּי	Tishbite
אֲבַדּוֹן	Abaddon
אֲבִידָּן	Abidan
אֲבִיָם	Abijam
אֲבִישַׁג	Abishag
אֲבִישׁוַּע	Abishua
אֲגָגִי	Agagite
אַגמוֹן	bulrush
אַדמָה	Admah
אָהֳלָה אָהֳלָהּ	Oholah
אָהֳלִיאָב	Oholiab
אוֹנוֹ אוֹנוֹ	Ono
אוּר	Ur
אוֹרָה	herb
אֲחוֹחִי	Ahohite
אֲחִילוּד	Ahilud
אֲחִירַע	Ahira
אָחֳרָן	another
אָטֵר	Ater
אֵיבָּה	enmity
אִישׁוֹן	apple
אֲלוּ	behold
אַליָה	tail
אִלֵּין אִלֵּן	these
אֱלִיצּוּר	Elizur
אֲלוּמָּה אָלוּם	sheaves
אֶלעָלֵא אֶלעָלֵה	Elealeh
אֵמוּן	faithful
אוּמנָם	indeed
אֶמֶשׁ	yesterday
אָסוֹן	harm
אַסִּיר	Assir
אָע	wood
אָפֵס	cease
אָפַף	encompassed
אֶפרָתִי	Ephraimite
אָצַל	refuse
אָצַר	store
אֶצֶר	Ezer
אַרגּוֹב	Argob
אֲרוּ	behold
אָרַח	goes
אֲרָמִיתּ	Aramaic
*** 3401 - 3450 (/course/1969831/strongs-numbers-biblical-hebrew/69/)	
אֲרַם נַהֲרַיִם	Mesopotamia
אַשׁדּוֹדִי	Ashdodites
אֵת	coulter
אַתּתּוּק אַתּתִּיק	gallery
בְּאֵרוֹת	Beeroth
בְּאֵרוֹתִי	Beerothite
בַּד	boasts
בַּחוּרִים בַּחוּרִים	Bahurim
בֶּכֶר	Becher
בִּלדַּד	Bildad
בָּלֶה	worn-out
בָּעָה	inquire
בַּעֲלָה	Baalah
בַּעַל חָנָן	Baal-hanan
בָּצֵק	dough
בֶּצֶר	Bezer
בּוּקִּי	Bukki
בְּקַר	inquire
בְּרַך	blessed
בְּרַם	however
גָּבַל	bounds
גִּדעוֹנִי	Gideoni
גּוֹזָן	Gozan
גְּזֵלָה	robbery
גְּלִילָה	region
גַּמלִיאֵל	Gamaliel
גָּמַר	end
גְּמַריָה גְּמַריָהוּ	Gemariah
גֵּרָה	gerahs
גֶּרֶם	bare
גָּרַר	away
גֶּשֶׁם	body
גַּת	press
דִּברָה	cause
דּוֹדוֹ	Dodo
דָּוֶה	faint
דִּין	court
דִּישָׁן	Dishan
דָּכָה	crushed
דָּלַג	leap
דָּלָה	draw
דָּנִי	Danites
דֵַּע	knowledge
הָבַל	foolishly
הֲדָרָה	beauty
הוּם	noisy
הֶרֶג	slaughter
הֲרֵגָה	slaughter
הֲרָרִי הָרָרִי הָארָרִי	Hararite
זְבוּל זֶבוּל	habitation
*** 3451 - 3500 (/course/1969831/strongs-numbers-biblical-hebrew/70/)	
זְמוֹרָה זְמוֹרָה זְמוֹר	branch
זָנוַֹח	Zanoah
זְעֵיר	little
זָעַף	enraged
זְרַחיָה	Zerahiah
חָבָה	hide
חָבַט	beat
חוֹבֵל	pilots
חָגָב	grasshopper
חַגִּיתּ	Haggith
חָזוּת	conspicuous
חוֹזֶק	powerful
חַטּוּשׁ	Hattush
חָכמוֹת חַכמוֹת	wisdom
חֶלאָה	rust
חֶלֶד	world
חַלָּמִישׁ	flint
חֵלוֹן	Helon
חֶלֶץ חֵלֶץ	Helez
חֵמֶת	skin
חָנַט	embalmed
חָנַך	dedicated
חוֹסָה	Hosah
חוֹסֶן	wealth
חָפנִי	Hophni
חַרטּוֹם	magicians
חָרַק	gnash
חַשּׁוּב	Hasshub
חֲשֵׁכָה חֲשֵׁיכָּה	darkness
חָשׁוּם	Hashum
חוּשָׁתִי	Hushathite
חַת	broken
טַּל	dew
טַּלמוֹן	Talmon
טַּעַם	account
טּוֹפַח	handbreadth
יְבֵמֶת	wife
יָגוֹר	afraid
יוֹיָדָע	Jehoiada
יוֹיָרִיבּ	Joiarib
יוֹצָדָק	Jozadak
יִזרְעֵאלִיתּ	Jezreelitess
יָחֵף	barefoot
יְלָלָה	wail
יְמִינִי	right
יִמנָה	Imnah
יָפִיַע	Japhia
יַצִּיבּ	certain
יָרַע	trembles
יָרָק	green
*** 3501 - 3550 (/course/1969831/strongs-numbers-biblical-hebrew/71/)	
יָשֵׁן	asleep
יִשׁעִי	Ishi
יְתִב	live
יִתרִי	Ithrite
כְּדָרלָעוֹמֶר	Chedorlaomer
כְּנֵמָא	thus
כְּנַעֲנָה	Chenaanah
כָּפַל	double
כָּפַף	down
כּוֹרֵם	vinedressers
כַּרמְלִי	Carmelite
כָּתִיתּ	beaten
לָבַב	cakes
לִבנִי	Libni
לוֹג	log
לוּד	Lud
לוּשׁ	knead
לַחַשׁ	amulets
לָטַשׁ	sharpen
לֵילְיָא	night
מַאֲרָב	ambush
מְאֵרָה	curse
מָדַי	Medes
מְדָתָא	Hammedatha
מוּך	poor
מוֹצָא	Moza
מוֹרָד	descent
מְזַמְּרָה	snuffers
מַחֲבַת	griddle
מַחלָה	Mahlah
מַטמוֹן מַטמוֹן מַטמוּן	treasures
מֵידֶּבָא	Medeba
מִכוָה	burn
מִכנָס	undergarments
מָלַח	salt
מַלכִּישׁוַּע	Malchi-shua
מַלכָּם מִלכּוֹם	Malcham
מְלֶכֶת	queen
מָלַל	say
מְלַל	uttering
מְנָא מְנָה	appointed
מָנֶה	minas
מֵסַב מֶסִבִּים מֶסִבּוֹת	direction
מַסָּה	temptation
מָסַך	mixed
מִספּוֹא	fodder
מַעֲמָד	attendance
מַעֲמָק	depths
מִצעָר	small
מַרבִּיתּ	gain
*** 3551 - 3600 (/course/1969831/strongs-numbers-biblical-hebrew/72/)	
מַרגְּלָה	feet
מָרָה	Marah
מִשׁבָּר	breakers
מְשִׁסָּה	plunder
מִשׁעֵן מִשׁעָן	stay
מַתכּוֹנֶת מַתכּוּנֶת	proportions
מַתּתָּן	gift
מָתַק	sweet
נוֹא	Thebes
נְאָצָה נֶאָצָה	blasphemy
נְבָיוֹת נֶבָיוֹת	Nebaioth
נָהַם	groan
נַחנוּ	ourselves
נַחַת	Nahath
נָכֵא נָכָא	broken
נֶכֶס	wealth
נָמַל	circumcise
נִמשִׁי	Nimshi
נַעֲמָה	Naamah
נוֹפֶת	honey
נִקָּיוֹן נִקָּיוֹן	innocence
נָקַשׁ	ensnared
נָשָׁא	deceive
סָבָא	drunkard
סַבָּל	bearers
סָגַד	down
סְגַן	prefects
סוּף	end
סוֹף	end
סוֹף	end
סָחַב	drag
סְלִק	ascend
סֶמֶל סֵמֶל	idol
סְנַפִּיר	fins
סָפִיַח	outpouring
סְפַר	books
סָרֵך	commissioners
עֲבָרִים	Abarim
עֵדֶן עֶדנָה	delicate
עוּל	nursing
עַוָּל	unjust
עָוַר	blinded
עֲזוּבָה	places
עֵיטָּם	Etam
עַיִן	eye
עַיִן	Ain
עֵינָן	Enan
עֵיפָה	ephah
עָכוֹר	Achor
עַכסָה	Achsah
*** 3601 - 3650 (/course/1969831/strongs-numbers-biblical-hebrew/73/)	
עָכרָן	Ochran
עָלַף	faint
עַמִּישַׁדַּי	Ammishaddai
עֲמָשַׂי	Amasai
עַנתּוֹתִי עַנְּתוֹתִי	Anathothite
עָסִיס	wine
עוֹפֶל	Ophel
עוֹפֶר	young
עַצֶּבֶת	pains
עָקַב	craftily
עָקַשׁ	crooked
עָרָב	willows
עֲרָד	Arad
עָרמָה	prudence
עָשׁוּק עָשׁוּק	oppressions
עַשׁתְּרָה	young
עָתִידּ	ready
פַּגעִיאֵל	Pagiel
פָּטוּר	open
פַּלּוּא	Pallu
פָּלַח	forth
פְּלַטיָה פְּלַטיָהוּ	Pelatiah
פַּס	varicolored
פְּעוֹר	Peor
פָּעַם	troubled
פַּרעוֹה נְכוֹה פַּרעוֹה נְכוֹ	Neco
פִּרעָתוֹנִי פִּרעָתוֹנִי	Pirathonite
פָּרָשׁ	scatter
פָּתַל	astute
פִּתרוֹן פִּתרוֹן	interpretation
פַּתרוֹס	Pathros
צְּבוֹאִים צֶּבִיִים צֶּבִיִם	Zeboiim
צְּבַע	drenched
צּוּעָר	Zuar
צּוּר	Zur
צּוּרִישַׁדַּי	Zurishaddai
צָּמַד	joined
צַּמֶּרֶת	top
צָּנִיף צָּנוֹף צָּנִיפָה	turban
צָּעָה	exile
צִּפּוּי	overlaying
צֶּפַע צִּפעוֹנִי	adder
צּוֹרִי	Tyrians
קָאַת	pelican
קִברוֹת הַתּתַּאֲוָה	Kibroth-hattaavah
קָדַח	kindled
קְדֵשָׁה	harlot
קוֹרָה קוֹרָה	beam
קָטַף	pluck
קִיקָיוֹן	plant
*** 3651 - 3700 (/course/1969831/strongs-numbers-biblical-hebrew/74/)	
קִיר	Kir
קִיר חֶרֶשׂ קִיר חֲרֶשֶׂת	Kir-hareseth
קָנַן	nested
קָצָה	off
קָצֵר	quick-tempered
קְצָת	end
קְצָת	end
קַרדּוֹם	axe
קָרָה	cold
קָרַח	make
קִריַת סַנָּה קִריַת סֵפֶר	Kiriath-sepher
קָרַץ	winks
קֶרֶת	city
קַשָּׁב קַשּׁוּב	attent
רֳאִי	appearance
רְבוּ	grandeur
רוּם רוּם	haughtiness
רוּם	height
רָחָב	Rahab
רְחַביָה רֶחַביָהוּ	Rehabiah
רֵחֶה	millstones
רֵכָה	Rechah
רָכַשׁ	acquired
רָמָה	place
רַעַד רֶעָדָה	trembling
רְעוּ	Reu
רַעמָה	Raamah
רַעמְסֵס רַעַמסֵס	Rameses
רָעַף	drip
רְפִידִּים	Rephidim
רְפָיָה	Rephaiah
רָקָב	rottenness
רַקָּה	temple
שָׁאַן	ease
שְׂאוֹר	leaven
שְׁבַח	praised
שָׂבעָה	satisfied
שְׁבַק	leave
שֶׁבֶת	place
שֶׁגֶר	increase
שְׁדֵיאוּר	Shedeur
שְׁדֵמָה	fields
שׁוּחִי	Shuhite
שָׁחַט	beat
שִׁטִּים	Shittim
שִׂיבּ	elders
שָׁכַך	subsided
שָׁלָה שָׁלַו	prosper
שְׁלוֹמוֹת	Shelomoth
שְׁלוּמִיאֵל	Shelumiel
*** 3701 - 3750 (/course/1969831/strongs-numbers-biblical-hebrew/75/)	
שִׁלֵּשׁ	third
שָׂמַאל	left
שַׁמּוַּע	Shammua
שְׁמִטָּה	remission
שָׁמַן	fat
שֶׁמַע	Shema
שִׁמעָא	Shimea
שֶׁמֶר	wine
שֶׁמֶר	Shemer
שִׁמרוֹן	Shimron
שָׁסַס	plundered
שָׁעָה	immediately
שָׂפָם	mustache
שָׁפַת	put
שָׂרָה	princesses
שְׂרוּג	Serug
שָׁרַר	enemy
שֵׁשָׁן	Sheshan
שְׁתָה	drank
תָּאַם	twins
תַּחֲלוּא תַּחֲלוּא	diseases
תֵּימָא תֵּמָא	Tema
תַּכלִיתּ	boundary
תֵּל	heap
תֶּלֶם	furrows
תּוּמָּה	integrity
תּוּמִּים	Thummim
תְּנוּבָה	fruit
תְּנוּמָה	slumber
תַּנחוּם תַּנחוּם תַּנחוּמָה	consolation
תּוֹעוּ תּוֹעִי	Toi
תַּעֲנוּג תַּעֲנוּג תַּעֲנוּגָה	charms
תַּקִּיף	strong
תְּקֵף	proud
תַּרבִּיתּ	increase
תִּרשָׁתָא	governor
אֲבֵדָה	lost
אֲבִינוֹעַם	Abinoam
אָבֵל	Abel
אֶברָה	pinions
אוֹבוֹת	Oboth
אֲגֻדָּה	band
אֲהָלִים אֲהָלוֹת	aloes
אוּלָם	Ulam
אוֹנָם	Onam
אוּרִיאֵל	Uriel
אוּת	consent
אֲחִימַן אֲחִימָן	Ahiman
אֲחַשׁדַּרפַּן	satraps
אַיָה	falcon
*** 3751 - 3800 (/course/1969831/strongs-numbers-biblical-hebrew/76/)	
אַכזִיבּ	Achzib
אַכזָר	cruel
אַל	not
אֶלחָנָן	Elhanan
אֶליָדָע	Eliada
אַלמָנוּת	widow's
אָלַף	teaches
אֲלַף אֶלֶף	thousand
אַל תַּשׁחֵת	Al-taschith
אַמָּה	cubits
אוּמלַל	away
אִנּוּן אִנִּין	those
אֲנַחנָא אֲנַחנָה	we
אֲנָך	line
אָנַק	groan
אֲנָקָה	groaning
אֵסוּר	bonds
אַסִּיר	prisoners
אַף	also
אֶפרוַֹח	young
אָרַז	cedar
אָרַח	Arah
אֲרָרַט	Ararat
אֲשִׁישָׁה	cakes
אֵתָם	Etham
בּוֹאר	cisterns
בָּדַד	shoots
בֶּהָלָה	terror
בּוּשָׁה	shame
בָּטָא בָּטָה	thoughtlessly
בֵּיתּ הַיְשִׁימוֹת	Beth-jeshimoth
בֵּיתּ הַלַּחמִי	Bethlehemite
בֵּיתּ פְּעוֹר	Beth-peor
בֵּיתּ צּוּר	Beth-zur
בָּכָא	trees
בָּלַג	cheerful
בִּלהָן	Bilhan
בְּלוֹא בְּלוֹי	worn-out
בָּמוֹת בָּמוֹת בַּעַל	Bamoth
בּוֹסֶר	grapes
בַּעֲלָה	medium
בַּעַל זְבוּב	Baal-zebub
בַּעַל פְּרָצִים	Baal-perazim
בַּעַר	senseless
בַּר	son
בָּרוֹד	mottled
בֶּתֶר	parts
גֵּב	beam
גָּבָהּ	high
גַּבַּחַת	forehead
*** 3801 - 3850 (/course/1969831/strongs-numbers-biblical-hebrew/77/)	
גָּדָה	banks
גָּדִישׁ	stack
גִּדֵּל	Giddel
גּוֹלָן	Golan
גּוּנִי	Guni
גֵּז	fleece
גָּזֵל	robbery
גָּלוּת	exiles
גָּלִיל	pivots
גֵּלֶל	dung
גַּלמוּד	barren
גּוֹמֶא	papyrus
גִּנָּה	garden
גַּעַשׁ	Gaash
גַּף	alone
גַּרגְּרוֹת	neck
גְּרִזִים	Gerizim
גַּרזֶן	axe
גֶּשֶׁם גַּשׁמוּ	Geshem
גַּת ־ רִמּוֹן	Gath-rimmon
דָּאָה	swiftly
דְּבוֹרָה דֶּבוֹרָה	bees
דָּגַל	up
דַּד	bosom
דּוַּח	rinse
דּוּמָה	Dumah
דּוּמִיָה	silence
דּוֹנַג	wax
דָּחַף	impelled
דַּך	oppressed
דְּמִי דֳּמִי	rest
דְּעוּאֵל	Deuel
דָּר	generation
דַּרכְּמוֹן	drachmas
הֵגֵא הֵגַי	Hegai
הִגָּיוֹן	Higgaion
הַדָּבָר	officials
הֲדוֹרָם הֲדוֹרָם	Hadoram
הוֹדִיָה	Hodiah
הוּך	again
הוֹלֵלָה	madness
הֲתָך	Hathach
זָכוּר	males
זָכַך	pure
זְמָן	time
זְמָר	music
זִמרָה	song
זַן	kinds
זָקוּן	age
זֶרֶד	Zered
*** 3851 - 3900 (/course/1969831/strongs-numbers-biblical-hebrew/78/)	
זֶרֶשׁ	Zeresh
זַתּתּוּא	Zattu
חֲבוֹל חֲבוֹלָה	pledge
חוֹבֶרֶת	set
חָגלָה	Hoglah
חַד	sharp
חוּד	propound
חַוָּה	towns
חוּם	black
חוּשִׁים חוּשִׁים חוּשִׁם	Hushim
חוּשָׁם חוּשָׁם	Husham
חֶזקָה	strong
חַלחָלָה	anguish
חֲלַף	pass
חָלָק	flattering
חֲלַקלַקָּה	hypocrisy
חָם	father-in-law
חוֹמֶשׁ	belly
חָמוּשׁ	array
חֵנָדָד	Henadad
חֲנוּכָּא	dedication
חֲנַמאֵל	Hanamel
חֲנַנאֵל	Hananel
חֲצַר שׁוּעָל	Hazar-shual
חָקָה	carved
חוֹרִי חוֹרִי	Hori
חוֹרוֹנַיִם	Horonaim
חֶרֶס חַרסָה	itch
חֲרוֹשֶׁת	carving
חֵשֶׁק	pleased
חָתָה	take
טּוֹב	Tob
טֶּנֶא	basket
טְּעַם	eat
טֵּפַח	handbreadth
טְּרַד	away
יַאֲזַניָה יַאֲזַניָהוּ	Jaazaniah
יָאַל	foolishly
יְבוּס	Jebus
יְהוּדִי	Jehudi
יְהוֹזָבָד	Jehozabad
יוֹאָחָז	Joahaz
יוֹיָקִים	Joiakim
יִלּוֹד	born
יִמלָא יִמלָה	Imlah
יָמַן	right
יַעבֵּץ	Jabez
יַעלָם	Jalam
יָפוֹ יָפוֹא	Joppa
יִצהָרִי	Izharites
*** 3901 - 3950 (/course/1969831/strongs-numbers-biblical-hebrew/79/)	
יַצַע	lay
יָקשָׁן	Jokshan
יִשׁוִי	Ishvi
יִשׂחָק	Isaac
יָשִׁישׁ	aged
יָשַׁם	appalled
יְשׁוּרוּן	Jeshurun
יַתּתִּיר	Jattir
כּוֹבֶד	dense
כִּבשָׁן	furnace
כְּהַל	able
כּוּשַׁן רִשׁעָתַיִם	Cushan-rishathaim
כִּלאַיִם	kinds
כָּמַר	stirred
כָּנָה	flatter
כְּסִיל	Orion
כְּעֶנֶת כְּעֶת	now
כְּפִירָה	Chephirah
כְּפַת	tied
כָּרִי	Carites
כְּרִיתּוּת	divorce
לוֹד	Lod
לוּבִי לוּבִּי	Lubim
לֵוִי	Levites
מַאֲכֶלֶת	knife
מָאֵן	refuse
מָאַר	malignancy
מִגבָּעָה	caps
מִגדָּנָה	things
מָגוֹג	Magog
מְגֵרָה	saws
מִדָּה מִנדָּה	tribute
מְדוֹר מְדוֹר מְדָר	place
מָהִיר מָהִר	skilled
מַהֲלָך	walk
מַהפֶּכֶת	stocks
מוֹלָדָה	Moladah
מוּסַבָּה מוּסַבָּה	changed
מוֹפַעַת מֵיפַעַת מֵפַעַת	Mephaath
מַזמֵרָה	hooks
מִזעָר	very
מְחָא	struck
מַחֲזֶה	vision
מֶחֱזָה	window
מַחלוֹן	Mahlon
מִיכָּא	Mica
מִיכָּיָה	Micaiah
מִיָמִן	Mijamin
מְכַסֶּה	covering
מַלָּח	sailors
*** 3951 - 4000 (/course/1969831/strongs-numbers-biblical-hebrew/80/)	
מֶלֶך	Melech
מְמוּכָן מוֹמוּכָן	Memucan
מַנדַּע	knowledge
מָנוֹר	beam
מְנַקִּיתּ	bowls
מְנַשִּׁי	Manassites
מָסָה	consume
מַסָּה	Massah
מִסכֵּן	poor
מַסמֵר מִסמֵר מַסמְרָה מִסמְרָה	nails
מַעֲדָן מַעֲדַנָּה	dainties
מְעוּנִי מְעִינִי	Meunites
מָעַך	bruised
מִפלֶצֶת	image
מִפקָד	place
מָצוֹד מְצוֹדָה מְצוֹדָה	bulwark
מָצוֹר	Egypt
מִקלוֹת	Mikloth
מִקלַעַת	carved
מָרֵא	Lord
מַרבֵּק	fattened
מְרוּצָה מְרוּצָה	course
מָרַץ	painful
מָרַק	polish
מִרקַחַת	mixing
מְרוֹרָה מְרוֹרָה	bitter
מִשׁאֶרֶת	bowl
מְשׂוּרָה	measure
מַשׂכּוֹרֶת	wages
מְשֶׁלֶמיָה מְשֶׁלֶמיָהוּ	Meshelemiah
מִשׁמָע	Mishma
מַשׁרוֹקִי	flute
מֶתֶג	bridle
מְתוֹם	soundness
נְאָקָה	groaning
נָבַב	hollow
נְדַב	offered
נוּב	flourish
נוֹצָה נוֹצָה	plumage
נְזַק	damage
נָטַל	laid
נֶטַע	plant
נִיר נִר	ground
נָכוַֹח	right
נְכוֹחָה	equity
נָכַל	craftily
נִמרוֹד נִמרוֹד	Nimrod
נָסַח	away
נוֹעָה	Noah
נַעֲמָתִי	Naamathite
*** 4001 - 4050 (/course/1969831/strongs-numbers-biblical-hebrew/81/)	
נוֹעַר	youth
נַעֲרָה	Naarah
נֶפֶג	Nepheg
נָפָה	border
נוֹפֶך	turquoise
נָפַשׁ	refreshed
נֵץ	blossom
נֵצֶר	branch
נְקוֹדָא	Nekoda
נִרגָּן	talebearer
סְבָא	Seba
סוֹבֶא	drink
סְבָך	thickets
סַבְּכָא שַׂבְּכָא	trigon
סִבְּכַי	Sibbecai
סָדִין	wraps
סַחַר	gain
סוֹך	tabernacle
סָלָה	reject
סַלכָּה	Salecah
עֲבוֹט עֲבוֹט	pledge
עֲבִי עֳבִי	thick
עָבוֹת עָבוֹת	leafy
עָדִין	Adin
עָדָשׁ	lentils
עוּגָב עוּגָּב	flute
עִוָּה עַוָּא	Ivvah
עוּז	bring
עֲזָאזֵל	scapegoat
עַזגָּד	Azgad
עֲזוּבָה	Azubah
עֵזֶר	Ezer
עֵט	pen
עֲטָרוֹת עֲטָרוֹת	Ataroth
עִי	ruins
עֵין רוֹגֵל	En-rogel
עַל	high
עָלוּם	youth
עֲלָטָה	dark
עֶליוֹן	One
עָלֶמֶת	Alemeth
עוֹמֶד	place
עַמּוֹנִיתּ	Ammonitess
עָמִיר	sheaves
עָמֵק	unintelligible
עֲנָוָה	humility
עֲנַף עֶנֶף	branches
עֵפֶר	Epher
עֲרַב	combine
עֲרוּגָה עֲרוּגָה	beds
*** 4051 - 4100 (/course/1969831/strongs-numbers-biblical-hebrew/82/)	
עֲרִיסָה	dough
עֲרִירִי	childless
עָרַם	shrewd
עָרַר	razed
עָשָׁן	Ashan
עַתּתַּי	Attai
עָתָק	arrogantly
פִּגּוּל פִּגּוּל	offense
פָּדוּי	redeemed
פְּדוּת פְּדוּת	redemption
פּוּאָה פּוּוָּה	Puah
פּוּג	benumbed
פּוּך	antimony
פּוּל	Pul
פּוּשׁ	up
פִּטדָּה	topaz
פָּטַר	open
פִּי הַחִרוֹת	Pi-hahiroth
פָּלַג	divided
פַּלָּצוּת	horror
פָּלַשׁ	roll
פָּסֵַח	Paseah
פְּסַנטֵּרִין פְּסַנתֵּרִין	psaltery
פָּעַר	opened
פִּקָּדוֹן	deposit
פַּרשֶׁגֶן פַּתשֶׁגֶן	copy
פִּשׁתָּה	flax
פְּתַחיָה	Pethahiah
צַּוַּאר	neck
צְּוָחָה	cry
צּוּף צּוֹפַי צִּיף	Zuph
צּוֹפַר	Zophar
צּוֹק צּוּקָה	anguish
צּוּרָה	design
צַּח	dazzling
צְּחִיַח	bare
צּוֹחַר	Zohar
צִּי	ship
צִּיצִּת	tassel
צְּלַח	success
צָּלַל	tingle
צֵּלֶל	shadow
צָּלַע	lame
צַּמָּה	veil
צַּמּוּק	raisins
צָּפַף	whisper
צְּפַר	birds
צְּרִיַח	chamber
קֵא קִיא	vomit
קִדמָה	east
*** 4101 - 4150 (/course/1969831/strongs-numbers-biblical-hebrew/83/)	
קְדֵמוֹת	Kedemoth
קָהָה	edge
קְטוּרָה	Keturah
קָטוֹן	insignificant
קִיטּוֹר קִיטּוֹר	smoke
קִיצּוֹן	outermost
קִיתָּרוֹס	lyre
קָלָה	roasted
קָלַס	mock
קוֹמֶץ	handful
קְנִזִּי	Kenizzite
קָפָא	congealed
קֶצֶו קִצוָה	ends
קַר	cold
קָרַחַת	head
קְרִיוֹת	Kerioth
קָרַן	shone
קֶרַע	pieces
קֶשֶׁב	close
קָשָׂה קַשׂוָה	jars
רְאָיָה	Reaiah
רָאמוֹת רָאמוֹת	Ramoth
רִבֵַּע	fourth
רֵבֶץ	place
רָדַד	gone
רָהַב	confused
רַהַט	gallery
רוּד	restless
רוּם	elevated
רְחוֹבוֹת רֶחוֹבוֹת	Rehoboth
רָחֵל	ewes
רְכוּלָּה	trade
רֶכֶשׁ	steeds
רְנָנָה	joyful
רֶסֶן	bridle
רָעַד	trembling
רֵעֶה	friend
רָפֶה	weak
רִצפָּה	Rizpah
רֶתֶם רוֹתֶם	tree
שֶׁבֶת	exterminated
שָׁגַג	also
שָׂגָה	grow
שָׁגַל	ravished
שְׂדֵרָה	ranks
שׁוֹבָב	faithless
שׁוֹבָב	Shobab
שׁוּחָה	pit
שׁוּף	bruise
שׁוּק	street
*** 4151 - 4200 (/course/1969831/strongs-numbers-biblical-hebrew/84/)	
שׁוּר	wall
שׁוּתֶלַח	Shuthelah
שָׁחַק	beat
שִׂידּ	coat
שִׂיַח	bushes
שִׁיחוֹר שִׁחוֹר שִׁחוֹר	Nile
שֶׁכוֹבֶת	intercourse
שֶׁל	which
שְׂלָו שְׂלָיו	quail
שַׁלִּיטּ	ruler
שְׁלָם	peace
שַׂלמָא	Salma
שְׁמִירָמוֹת שְׁמָרִימוֹת	Shemiramoth
שַׂמלָה	Samlah
שׁוֹמַע	fame
שִׁמעוֹנִי	Simeonites
שִׁמרִי	Shimri
שְׁמַריָה שְׁמַריָהוּ	Shemariah
שִׁמשַׁי	Shimshai
שְׁנִינָה	byword
שְׁנִיר שְׂנִיר	Senir
שֶׁסַע	hoof
שַׂעַר	affrighted
שַׁעֲרוּרָה שַׁעֲרִירִיָה שַׁעֲרוּרִת	thing
שְׁפַל	humbled
שָׁקֵד	tree
שַׁרבִּיטּ	scepter
שְׂרָד	woven
שִׁתּתִּין	60
שָׁתַק	calm
שְׁתַר בּוֹזְנַי	Shethar-bozenai
תָּאוֹם תָּאוֹם	twins
תּוּגָה	grief
תּוֹגַרמָה תּוֹגַרמָה	Beth-togarmah
תּוֹעָפָה	horns
תּוֹר תּוֹר	ornaments
תְּחוֹת תְּחוֹת	under
תַּיִשׁ	goats
תְּלָאָה	hardship
תָּם	there
תָּפַר	sew
תְּקוּפָה תְּקוּפָה	turn
תָּקַף	overpower
תְּרֵין תַּרתֵּין	12
תְּשׁוּאָה	noise
תַּתּתְּנַי	Tattenai
אֵב	fruit
אֵבוּס	manger
אֲבִיאֵל	Abiel
אֲבִי הָעֶזרִי	Abiezrites
*** 4201 - 4250 (/course/1969831/strongs-numbers-biblical-hebrew/85/)	
אֶביָסָף	Ebiasaph
אָבֵל מְחוֹלָה	Abel-meholah
אֶבֶן הָעֵזֶר	Ebenezer
אֵבֶר	wings
אַגָּן	basins
אָגַר	gathers
אִגְּרָא	letter
אוֹדֶם	ruby
אַדמוֹנִי אַדמוֹנִי	ruddy
אֲדוֹנִי ־ בֶּזֶק	Adoni-bezek
אֲדוֹנִיקָם	Adonikam
אָדַר	majestic
אַדרַמֶּלֶך	Adrammelech
אַהֲוָא	Ahava
אֱהִי	where
אָהַל	moved
אוּבָל אוּבָל	canal
אוּד	brand
אוֹמָר	Omar
אוֹן אוֹן	On
אֲזָא אֲזָה	heat
אֲזַי	then
אֶזרָחִי	Ezrahite
אָח	brazier
אָחוּ	grass
אֲחִיסָמָך	Ahisamach
אַחַר	future
אִי	Hyenas
אַיֱלֱת	hind
אָיוֹם	awesome
אֵימִים	Emims
אִיתִּיאֵל	this
אַכשָׁף	Achshaph
אֶלגָּבִישׁ	hailstones
אַלגּוּמִּים	algum
אָלַח	corrupt
אֱלִישָׁה	Elishah
אַלמֻגִּים	almug
אַלמוֹנִי	certain
אֶלפַּעַל	Elpaal
אוּמַּה	people
אֲמַן	faithful
אִמַּר	lambs
אֱסוּר	band
אָסנַת	Asenath
אָסוּף	storehouse
אוֹסֶף	gathering
אֵסַר ־ חַדּוֹן	Esarhaddon
אֵפוּדָּה	plated
אֶפעֶה	snake
*** 4251 - 4300 (/course/1969831/strongs-numbers-biblical-hebrew/86/)	
אֲפַרסְכַי אֲפַרסַתכַּי	Apharsachites
אֶצבַּע	toes
אַצִּיל	armpits
אַראֵלִי	Areli
אַרגְּוָן	purple
אַרגָּז	box
אוּרוָה אֲרָיָה	stall
אֲרִאֵיל	hearth
אָרוֹך	long
אוֹשׁ	foundations
אַשׁבֵּל	Ashbel
אַשׁכְּנַז	Ashkenaz
אֵשֶׁל	tree
אָשֵׁם	guilty
אַשׂרִיאֵל	Asriel
אָת	signs
בָּאַר	distinctly
בְּאֵר לַחַי רוֹאִי	Beer-lahai-roi
בְּאוֹשׁ	stench
בָּגוֹד	treacherous
בּוֹהוּ	void
בּוּז	Buz
בּוּך	confusion
בֶּזֶק	Bezek
בְּחוּרוֹת בְּחוּרוֹת בְּחוּרִים	youth
בִּטָּחוֹן	confidence
בֵּיתּ הָעֲרָבָה	Beth-arabah
בֵּיתּ חָגלָה	Beth-hoglah
בֵּיתּ עֲנָת	Beth-anath
בִּיתָּן	palace
בָּכַר	firstborn
בֵּל	Bel
בִּלגָּה	Bilgah
בְּלוֹ	custom
בְּלִיל	fodder
בּוּנִּי בּוּנִי	Bunni
בְּעֵל	commander
בַּעַל גָּד	Baal-gad
בַּעַל מְעוֹן	Baal-meon
בַּעַל צְּפוֹן	Baal-zephon
בַּעֲלָת	Baalath
בַּעֲנָא	Baana
בִּצָּה	marsh
בֵּצַי	Bezai
בַּקבּוּק	jar
בַּקבּוּקיָה	Bakbukiah
בִּריָה	food
בָּרִיַח בָּרִַח	fleeing
בְּרָכָה	Berachah
בָּרְקַת בָּרְקַת	carbuncle
*** 4301 - 4350 (/course/1969831/strongs-numbers-biblical-hebrew/87/)	
בְּשׂוֹר	Besor
בְּשַׂר	flesh
גִּדּוּף גִּדּוּף גִּדּוּפָה גִּדּוּפָה	revilings
גָּדֵל	greater
גָּהַר	stretched
גַּו	back
גּוֹב	grasshoppers
גּוּד	raid
גֵּוָה	pride
גָּזָם	locust
גֶּזַע	stem
גָּלָל	Galal
גָּלַע	breaks
גְּמוּלָה	deeds
גֶּנֶז	treasuries
גְּנַז	treasure
גִּנְּתוֹן גִּנְּתוֹ	Ginnethon
גַּעתָּם	Gatam
גַּף	wings
גָּרָב	eczema
גָּרֵב	Gareb
גָּרַם	bones
גִּתּתִּיתּ	Gittith
דָּאַב	languish
דֶּבֶק	joint
דָּבֵק	attached
דּוֹבֶר דִּבֵּר	fold
דָּבְרַת	Daberath
דּוֹדָה	aunt
דַּוָּי	faint
דּוּמָם	silently
דּוּר	ball
דַּכָּא	contrite
דִּכֵּן	same
דְּכַר	rams
דִּכרוֹן דָּכרָן	record
דָּלַח	muddy
דָּלַף	weeps
דְּמָמָה	blowing
דָּפַק	hard
דָּשֵׁן	sap
דּוֹתָן דּוֹתַיִן	Dothan
הָגָה	away
הֶגֶה	mourning
הֲדַר	glorified
הֲדַר	majesty
הוֹדַויָה	Hodaviah
הוֹוָה	disaster
הוֹשַׁעיָה	Hoshaiah
הֲלַך	go
*** 4351 - 4400 (/course/1969831/strongs-numbers-biblical-hebrew/88/)	
הֲלָך	toll
הַמנִיכּ הֲמוּנֵך	necklace
הֵנַע	Hena
הֵרוֹן הֵרָיוֹן	childbirth
זְבוּלוֹנִי	Zebulunite
זוַּע	tremble
זוּר	crush
זָחַל	afraid
זִיז	abundance
זִיפִי	Ziphites
זַלעָפָה זִלעָפָה	burning
זִמָּה	Zimmah
זָמַן	appointed
זָמַר	prune
זִמרָת	song
זַן	kind
זֶפֶת	pitch
חָבוֹר	Habor
חֲבַל	damage
חֲבַר	friends
חֲגָו	clefts
חַגִּי	Haggi
חָדָה	glad
חָדִידּ	Hadid
חָדֵל	forsaken
חוּג	circle
חַוּוֹת יָעִיר	Havvoth-jair
חֲזִיז	thunderbolt
חָטַף	catch
חַכָּה	fishhook
חֲכִילָה	Hachilah
חוֹלוֹן חוֹלוֹן	Holon
חֲלַח	Halah
חֵלְכָא חֵלְכָה	unfortunate
חֲלָק	share
חָלַשׁ	prostrate
חֲמוּטַל חֲמִיטַּל	Hamutal
חָמוּל	Hamul
חֵמָר	tar
חָסַד	merciful
חוֹסֶר	lack
חוּפָּה	chamber
חִפָּזוֹן	haste
חוּפִּים	Huppim
חָצוֹת	midnight
חָצַץ	archer
חָצָץ	gravel
חֲצַר עֵינָן	Hazar-enan
חָרוּל חָרוּל	nettles
חָרִיצּ חָרִץ	cuts
*** 4401 - 4450 (/course/1969831/strongs-numbers-biblical-hebrew/89/)	
חָרִישׁ	plowing
חוֹרוֹנִי	Horonite
חֲרוֹשֶׁת	Harosheth-hagoyim
חֶשׁבּוֹן	explanation
חֲשַׁח	need
חַשׁמַל	metal
טֶּבַח	Tebah
טִּבחָה	meat
טּוֹפָפָה	frontals
טָּפַל	forged
יִבחַר	Ibhar
יְבַל	brought
יִבלְעָם	Ibleam
יָבַם	brother
יִגאָל	Igal
יָגֵַע	weary
יָדַד	cast
יַדּוַּע	Jaddua
יַהֲלוֹם	diamond
יוֹרֶה	rain
יִזרַחיָה	Izrahiah
יָחַד	united
יְחֶזקֵאל	Ezekiel
יַחַשׂ	genealogy
יָטבָּתָה	Jotbathah
יְטוּר	Jetur
יַלדָּה	girl
יַלדּוּת	childhood
יָנוַֹח יָנוֹחָה	Janoah
יַנשׁוּף יַנשׁוֹף	owl
יְעַט	counsellor
יָעֵל	goats
יָעֵף	weary
יַפלֵט	Japhlet
יֵצֶר	Jezer
יְקוּם	thing
יָקוּשׁ	fowler
יְקַמיָה	Jekamiah
יָקנְעָם	Jokneam
יָרִיבּ	contend
יָרִיבּ	Jarib
יְרִיָה יְרִיָהוּ	Jeriah
יָרַק	spit
יְרַקרַק	greenish
יָשָׁבעָם	Jashobeam
יָשׁוּב יָשִׁיבּ	Jashub
יָשַׁט	extended
יָשׁפֵה	jasper
יִשׂרְאֵלִיתּ	Israelite
יִתרָן	Ithran
*** 4451 - 4500 (/course/1969831/strongs-numbers-biblical-hebrew/90/)	
כְּבוּדָּה	valuables
כִּברָה	distance
כּוֹנַניָהוּ	Conaniah
כִּימָה	Pleiades
כְּלוּב	basket
כִּליוֹן	Chilion
כַּלנֶה כַּלנֵה כַּלנוֹ	Calneh
כִּמהָם	Chimham
כַּמּוֹן	cummin
כָּמָר	priests
כָּניָהוּ	Coniah
כְּנַניָה כְּנַניָהוּ	Chenaniah
כָּנַשׁ	assemble
כּוּסֶּמֶת	spelt
כִּפָּה	branch
כֶּפֶל	double
כַּפתּוֹר כַּפתּוֹר	Caphtor
כַּפתּוֹרִי	Caphtorim
כָּרָה	bargain
כַּרכְּמִישׁ	Carchemish
כַּרמִיל	crimson
כָּרסֵא	throne
כָּרוּתָה	beam
כָּשֵׁר	success
כִּשׁרוֹן	skill
כֶּתֶר	crown
לוֹא דְּבַר לוֹ דְּבַר לִדבִּר לוֹדְבַר	Lo-debar
לָבַט	ruined
לָבִיבָּה לְבִבָה	cakes
לְבָנָה	moon
לְבַשׁ	clothed
לוּדִי לוּדִיִי	Ludim
לוּט	wrapped
לֶחִי	Lehi
לְחֵנָה	concubines
לָחַשׁ	charmers
לוֹיָה	wreaths
לַיִשׁ	lion
לָפַת	forward
לָצוֹן	scoffers
מַאֲמַר	command
מְבוּסָה	oppressive
מַבּוַּע	springs
מַבָּט מֶבָּט	hope
מִבשָׂם	Mibsam
מְגוּרָה	barn
מָגַן	delivered
מִדיָן	brawling
מְהֵיטַּבאֵל	Mehetabel
מוֹהַר	dowry
*** 4501 - 4550 (/course/1969831/strongs-numbers-biblical-hebrew/91/)	
מַהֲרַי	Maharai
מוֹסֵרָה מוֹסְרוֹת	Moseroth
מוּצַק מוּצָק	anguish
מוּצָק	casting
מוֹקֵד	burning
מוֹרַג מוֹרַג	sledges
מוֹרֶה	rain
מוֹרֶה מוֹרֶה	Moreh
מוֹרָה	razor
מוֹרָשׁ	possession
מוֹתָר	advantage
מִזָּה	Mizzah
מָזוֹר מָזוֹר	wound
מָזִיַח מֵזַח	girdle
מָחָא	clap
מַחצֵּב	hewn
מַחַת	Mahath
מִיצּ	churning
מְכוּרָה מְכוֹרָה	origin
מָכַך	low
מִכלָאָה מִכלָה	fold
מִכמֶרֶת מִכמוֹרֶת	drag
מֶכֶּר	merchandise
מִלּוּאָה	filigree
מַלבֵּן	brick
מְלַח	salt
מְלֵחָה	salt
מַלכִּיאֵל	Malchiel
מְנֵא	MENE
מָנַחַת	Manahath
מִניָמִין	Miniamin
מַסוֶה	veil
מִספַּחַת	scab
מַעֲלֵה עַקרַבִּים	Akrabbim
מַפָּלָה מַפֵּלָה	ruin
מִפעָל מִפעָלָה	work
מַצָּה	strife
מִצעָד	steps
מֵצַר	distress
מַקָּבָה	hammer
מֵרָב	Merab
מָרוּד	homeless
מְרִיבּ בַּעַל	Merib-baal
מֶרכָּב	chariots
מְרוֹר מְרוֹר	herbs
מִשׁבֵּר	birth
מָשָׁה	drew
מְשׁוֹאָה מְשׁוֹאָה	desolation
מִשׁטּוַֹח מִשׁטַּח	forth
מְשֵׁיזַבאֵל	Meshezabel
*** 4551 - 4600 (/course/1969831/strongs-numbers-biblical-hebrew/92/)	
מוֹשֶׁל	dominion
מִשׁמַעַת	guard
מַשׁקוֹף	lintel
מְתַלְּעָה	fangs
מַתּתָּן	Mattan
מַתּתְּנָא	gifts
מַתּתְּנַי	Mattenai
נָאָה	lovely
נְבָא	prophesy
נְבוּאָה	prophecy
נוֹבַח	Nobah
נָדָה נָדָא	exclude
נָהָה	lamented
נְהִיר נְהִירוּ	light
נַהֲלָל נַהֲלוֹל	Nahalal
נְוָלוּ נְוָלִי	heap
נוּץ	away
נִחוּם נִחוּם	comfort
נֶחֱלָמִי	Nehelamite
נְטִישָׁה	branches
נִין	offspring
נֶכֶד	posterity
נָכֶה	crippled
נְכוֹ	Neco
נְמוּאֵל	Nemuel
נְסַק	up
נְעַריָה	Neariah
נְפִיל נְפִל	Nephilim
נָפִישׁ	Naphish
נֶפֶל נֵפֶל	miscarriage
נְצַל	deliver
נִקּוּד	crumbled
נָקִיק	clefts
נָקַע	alienated
נֵרגַּל שַׁראֶצֶר	Nergal-sar-ezer
נֵרדּ	nard
נְשָׂא	carried
נָשַׁב	blow
נִשׁכָּה	chambers
נָשַׂק	burn
נָשַׁת	dry
נִשׁתְּוָן	document
סֵבֶל	burden
סוֹבֶל סוּבָּל	burden
סוּמפּוֹנְיָה סוּמפּוֹנְיָה סִיפוֹנְיָא	bagpipe
סָחַר	mart
סָכַר	stop
סְלִיחָה	forgiveness
סֶלַע	Sela
סְמָדַר	blossom
*** 4601 - 4650 (/course/1969831/strongs-numbers-biblical-hebrew/93/)	
סְנָאָה	Senaah
סַנוֵר	blindness
סָעִף שָׂעִף	opinion
סַר	sullen
עָב עוֹב	threshold
עַבדּוּת	bondage
עַבדִּי	Abdi
עָבָה	thicker
עַד	prey
עֲדִיאֵל	Adiel
עֲדוּלָּמִי	Adullamite
עֶדֶן	Eden
עֵדֶר	Edar
עוֹדֵד עוֹדֵד	Oded
עַוָּה	ruin
עַוִּי	Avvites
עוּל	infant
עִוָּרוֹן עַוֶּרֶת	blind
עֱזוּז	fierceness
עַזּוּר עַזּוּר	Azzur
עֲזַזיָהוּ	Azaziah
עֶזרָא	Ezra
עַזרִיאֵל	Azriel
עֲטַלֵּף	bat
עִיוֹן	Ijon
עֵין גַּנִּים	En-gannim
עֵין ־ דּאוֹר עֵין דּוֹר עֵין ־ דּוֹר	En-dor
עִיר	watcher
עִלָּה	accusation
עָלַס	delight
עָמַם	match
עָמַר	sheaves
עָנוֹג	delicate
עוּנִּי	Unni
עָנַק	liberally
עָנָק	bands
עָנֵר	Aner
עֳפִי	leaves
עוֹצֶב	idol
עִצָּבוֹן	toil
עֶצֶם	Ezem
עוֹצֶם	frame
עָצמָה	power
עַצמוֹן עַצמוֹן	Azmon
עוֹצֶר	oppression
עָקוֹב	crooked
עִקַּר	stump
עִקֵּשׁ	Ikkesh
עָרַב	close
עֲרָבוֹן	pledge
*** 4651 - 4700 (/course/1969831/strongs-numbers-biblical-hebrew/94/)	
עָרַג	pants
עַרמוֹן	trees
עָשֵׁשׁ	away
עַשׁתּוֹרֶת	Ashtoreth
עַתּתִּיק	ancient
פִּדיוֹם פִּדיוֹם פִּדיוֹן פִּדיוֹן	ransom
פֶּדֶר	suet
פּוֹטִי פֶרַע	Potiphera
פּוּר	break
פֶּחָם	coals
פַּטִּישׁ	hammer
פִּידּ	calamity
פִּיכּוֹל	Phicol
פַּך	flask
פְּלוּגָּה	sections
פְּלוֹנִי	Pelonite
פְּלָיָה פְּלָאיָה	Pelaiah
פָּלִיל	judges
פְּלוֹנִי	certain
פְּנִנָּה	Peninnah
פָּצַע	emasculated
פְּקַחיָה	Pekahiah
פֶּקַע	gourds
פַּרבָּר פַּרוָר	Parbar
פִּרדָּה	mule
פַּרדֵּס	forest
פָּרוּר	pot
פְּרָזָה	rural
פְּרָזִי פְּרוֹזִי	country
פָּרַם	tear
פְּרַס	divide
פַּרשֶׁגֶן	copy
פַּרתַּם	nobles
צָּב	covered
צָּבָה	swell
צֶּבַע	work
צָּדָה	destroy
צָּהוֹב	yellowish
צּוֹאָה צּוֹאָה	filth
צּוּף	engulf
צּוּק	poured
צִּיוּן	marker
צִּיחָא צִּחָא	Ziha
צָּלָה	roast
צִּלָּה	Zillah
צַּלַּחַת	dish
צָּלִי	roasted
צַּלמוֹן	Zalmon
צֶּלַע	fall
צִּמָּאוֹן	ground
*** 4701 - 4750 (/course/1969831/strongs-numbers-biblical-hebrew/95/)	
צָּנַח	alighted
צָּנַף	attired
צְּעָדָה	going
צָּעִיף	veil
צָּעַר	insignificant
צְּפוֹ צְּפִי	Zepho
צְּפִירָה	doom
צִּפּוֹרָה	Zipporah
צָּרֶבֶת	scar
צִּרעָה	hornet
צָּרעִי צָּרעָתִי	Zorathites
צָּרְפַת	Zarephath
צָּרְתָן	Zarethan
קְבַל	receive
קַבצְּאֵל	Kabzeel
קַדמַי	first
קָוֶה	line
קוֹרֵא קוֹרֵא	Kore
קֶטֶב	destruction
קָטַל	slay
קְטַר	problems
קְלִיטָּא	Kelita
קֶלֶס	derision
קְמוּאֵל	Kemuel
קָמַץ	take
קָנָה	Kanah
קִנָּמוֹן	cinnamon
קֶסֶת	case
קִפּוֹד קִפּוֹד	hedgehog
קֶצֶב	form
קֶצַח	dill
קֵרֵַח	baldhead
קָרִיא	call
קְשִׂיטָּה	money
רָבַך	stirred
רַב ־ סָרִיס	Rab-saris
רָבַע	mate
רָגַן	whisperer
רְגַשׁ	agreement
רַהַב	Rahab
רַהַב	Rahab
רָוֶה	watered
רָוַח	relief
רָזוֹן	disease
רָחַף	relax
רַכָּב	chariot
רֵַע	loudly
רְעָבוֹן	famine
רַעיוֹן	striving
רְפוּאָה	healing
*** 4751 - 4800 (/course/1969831/strongs-numbers-biblical-hebrew/96/)	
רָפַד	make
רָפַשׂ	foul
רַק	only
רוֹק	spitting
רָתַח	boil
שְׁאָט	scorn
שָׁאטּ	despised
שַׁבְּתַי	Shabbethai
שְׂגָא	abound
שְׂגוּב	Segub
שָׁגַח	gaze
שֵׁגָל	wives
שִׁגָּעוֹן	madness
שָׂדַד	harrow
שִׂדִּים	Siddim
שָׁדַף	scorched
שַׂהֲרוֹן	ornaments
שׁוֹבֵב	apostate
שׁוַּח	down
שׁוֹלָל שֵׁילָל	barefoot
שׁוּנֵם	Shunem
שׁוַֹע	bountiful
שׁוּק	overflow
שׁוּר	walls
שָׁזַף	burned
שָׂחָה	swim
שְׁחַת	corruption
שַׁי	gifts
שִׂיחָה	meditation
שִׁיחָה	pit
שְׁכוֹל	children
שָׂכלְתָנוּ	insight
שֶׁכֶם	Shechem
שִׁכָּרוֹן	drunkenness
שָׁלָב	frames
שַׁלהֶבֶת	flame
שָׁלוּ שָׁלוּת	fail
שִׁלּוַּח שִׁלּוַּח	dowry
שִׁלּוּם שִׁלּוּם	bribe
שְׁלַם	completed
שְׁמִידָּע	Shemida
שְׁמִינִיתּ	Sheminith
שָׁמִיר	Shamir
שֵׁן	teeth
שָׁנָא	changed
שׁוֹעַל	handfuls
שַׁעַלבִּים שַׁעֲלַבִּין	Shaalbim
שְׂעַר	hair
שַׁעֲרַיִם	Shaaraim
שׁוּפִּים	Shuppim
*** 4801 - 4850 (/course/1969831/strongs-numbers-biblical-hebrew/97/)	
שְׁפַר	good
שַׁראֶצֶר	Sharezer
שֶׂרַח	Serah
שָׂרַט	cuts
שָׂרִיגּ	branches
שָׂרַע	deformed
שׂוֹרֵק שׂוֹרֵק שׂוֹרֵקָה	choicest
שׁוֹרֶשׁ	roots
שֵׁשַׁי	Sheshai
תִּבנִי	Tibni
תֵּבֵץ	Thebez
תָּו	frowardness
תַּחפְּנֵיס	Tahpenes
תּוֹך תּוֹך	oppression
תְּמַהּ	wonders
תִּמנַת חֶרֶס תִּמנַת סֶרַח	Timnath-heres
תַּמרוּק תַּמרוּק תַּמרִיק	cosmetics
תַּמרוּר	bitter
תַּנשֶׁמֶת	owl
תְּעוּדָה	testimony
תַּעֲלוּמָּה	secrets
תִּפלָה	blame
תְּקַל	Tekel
תָּקַן	arranged
תּוֹקֶף	authority
תּוֹרֶן	mast
תַּרעֵלָה	reeling
תְּשׁוּקָה	desire
אֵב	blossoms
אוֹבֵד	destruction
אֲבִידָּע	Abida
אֲבִיטַּל	Abital
אֲבִימָאֵל	Abimael
אֲבִישׁוּר	Abishur
אָבֵל בֵּיתּ מֲעַכָה	Abel-beth-maacah
אוֹבֶן	birthstool
אָבַס	fattened
אֲבַעבּוּעָה	sores
אִבצָּן	Ibzan
אָבַק	wrestled
אֲגַרטָּל	dishes
אֶגרוֹף	fist
אֵד	mist
אַדבְּאֵל	Adbeel
אִדּוֹ	Iddo
אֲדוּמִּים	Adummim
אֲדוֹנִי ־ צֶּדֶק	Adoni-zedek
אֲדוֹנִירָם	Adoniram
אֶדֶר	magnificent
אַדָּר	Addar
*** 4851 - 4900 (/course/1969831/strongs-numbers-biblical-hebrew/98/)	
אֲדַרגָּזֵר	counselors
אֲדַרכּוֹן	darics
אֲדוֹרָם	Adoram
אַהַב	lovers
אוֹהַד	Ohad
אוּזָל	Uzal
אֱוִי	Evi
אֱוִיל מְרוֹדַך	Evil-merodach
אוּל	mighty
אוּלַי	Ulai
אֱוִלִי	foolish
אָוֶן	Aven
אוּפָז	Uphaz
אֲזָד	firm
אָזנִי	Ozni
אֲזִקִּים	chains
אֶזרוַֹע	arm
אָח	Ah
אֲחִי	Ahi
אֲחִיאָם	Ahiam
אַחלַי	Ahlai
אַחֲלַי אַחֲלֵי	Oh
אַחלָמָה	amethyst
אֲחַשׁתָּרָן	royal
אִטֵּר	left-handed
אִי	woe
אִי ־ כָּבוֹד	Ichabod
אַכזָב	deception
אֶלדָּד	Eldad
אֶלדָּעָה	Eldaah
אִלּוּ	if
אַלּוֹן	Allon
אָלוּשׁ	Alush
אֶלזָבָד	Elzabad
אֱלִיאָתָה אֱלִיָתָה	Eliathah
אֶליַחבָּא	Eliahba
אֱלִיעָם	Eliam
אֱלִיפְלֵהוּ	Eliphelehu
אֱלִישׁוַּע	Elishua
אַלְלַי	woe
אֵלֶם	congregation
אַלמוֹדָד	Almodad
אֶלָּסָר	Ellasar
אֶלתּוֹלַד	Eltolad
אֶלתְּקֵא אֶלתְּקֵה	Elteke
אָמוֹן	multitude
אָמִיר	bough
אָמנָה	actually
אֲמָנָה	agreement
אָמוֹץ	strong
*** 4901 - 4950 (/course/1969831/strongs-numbers-biblical-hebrew/99/)	
אַמצִּי	Amzi
אִמרִי	Imri
אַמרָפֶל	Amraphel
אֲמִתּתַּי	Amittai
אָנָה	lament
אֲנִיָה	mourning
אָנַן	complain
אֲנַף	face
אֲנָפָה	heron
אָסִיף אָסִף	ingathering
אָסָם	barns
אָפַד	gird
אַפַּיִם	Appaim
אֶפלָל	Ephlal
אֲפֵר	bandage
אֶצבּוֹן אֶצבּוֹן	Ezbon
אָצִיל	nobles
אֲצַליָהוּ	Azaliah
אוֹצֶם	Ozem
אֶצעָדָה	armlets
אֶרֶב	lair
אֶרֶג	loom
אַרדּ	Ard
אָרָה	gathered
אַרוַד	Arvad
אַרוָדִי	Arvadite
אֲרוֹדִי	Arodi
אוֹרַח	ways
אוֹרחָה	caravan
אֲרִיאֵל אֲרִאֵל	Ariel
אֲרִידָּתָא	Aridatha
אַרכָּא אַרכָּה	extension
אֲרָן	Aran
אַרנֶבֶת	rabbit
אֶשׁבָּן	Eshban
אֶשׁבַּעַל	Eshbaal
אֲשׁוּרִי אַשּׁוּרִי	Asshurim
אַשׁחוּר	Ashur
אֶשׁכָּר	gifts
אֶשׁנָב	lattice
אַשׁנָה	Ashnah
אַשָּׁף	conjurers
אֶשׁפָּר	dates
אוּשַּׁרנָא	structure
אֶשׁתַּדּוּר	revolt
אֶשׁתּוֹן	Eshton
בְּאֵר	Beer
בְּאֵרִי	Beeri
בְּאוּשִׁים	ones
בִּגתָּן בִּגתָּנָא	Bigthan
*** 4951 - 5000 (/course/1969831/strongs-numbers-biblical-hebrew/100/)	
בָּדָא	devised
בְּדַד	Bedad
בְּדוֹלַח	bdellium
בְּדָן	Bedan
בּוֹהַן	Bohan
בּוּזִי	Buzite
בּוּל	block
בָּזָא	divide
בָּזַר	distribute
בָּחַל	abhor
בֵּין	among
בִּירָנִיתּ	castle
בֵּיתּ בַּעַל מְעוֹן בֵּיתּ מְעוֹן	Beth-baal-meon
בֵּיתּ בָּרָה	Beth-barah
בֵּיתּ ־ דָּגוֹן	Beth-dagon
בֵּיתּ הַך ־ כֶּרֶם	Beth-haccerem
בֵּיתּ הַמַּרכָּבוֹת בֵּיתּ מַרכָּבוֹת	Beth-marcaboth
בֵּיתּ הַשִּׁמשִׁי	Beth-shemite
בֵּיתּ מַעֲכָה	Beth-maacah
בֵּיתּ נִמרָה	Beth-nimrah
בֵּיתּ פֶּלֶט	Beth-pelet
בֵּיתּ רְחוֹב	Beth-rehob
בִּכּוּרָה	fig
בּוֹכִּים	Bochim
בּוֹכְרוּ	Bocheru
בַּלאֲדָן	Baladan
בֵּלטְּשַׁאצַּר	Belteshazzar
בֶּלַע	devour
בָּלַק	devastates
בִּלשָׁן	Bilshan
בְּנֵי יַעֲקָן	Bene-jaakan
בֵּנַיִם	champion
בִּנעָא בִּנעָה	Binea
בְּסַי	Besai
בָּעוּ	petition
בִּעוּתִים	terrors
בָּעַט	kick
בַּעַל בְּרִיתּ	Baal-berith
בְּעָלוֹת	Bealoth
בַּעַל חֶרמוֹן	Baal-hermon
בְּעָתָה	terror
בַּצלוּת בַּצלִיתּ	Bazlith
בָּצֵק	swell
בָּצקַת	Bozkath
בֶּצֶר	gold
בַּצּוֹרֶת	drought
בַּקבּוּק	Bakbuk
בּוּקִּיָה	Bukkiah
בְּקִיַע	breaches
בֶּקַע	beka
*** 5001 - 5050 (/course/1969831/strongs-numbers-biblical-hebrew/101/)	
בֶּרֶד	Bered
בֵּרוֹתָה בֵּרוֹתַי	Berothah
בּוֹרִיתּ	soap
בָּרַכאֵל	Barachel
בַּרקוֹס	Barkos
בַּרקָן	briers
בָּשֵׁל	boiled
בַּת	baths
בָּתַר	cut
גּוֹב גּוֹב	Gob
גֶּבֶא	cistern
גַּבהוּת	pride
גְּבוּרָה	power
גְּבִיר	master
גִּבלִי	Gebalite
גַּבלוּת	twisted
גַּבנוֹן	peaks
גַּברִיאֵל	Gabriel
גַּד	coriander
גָּד	fortunate
גְּדָבָר	treasurers
גּוּדגּוֹדָה	Gudgodah
גְּדַד	down
גְּדוּד גֶּדוּדָה	gashes
גָּדִי	Gadi
גְּדִל	tassels
גִּדַּלתִּי	Giddalti
גֶּדֶר	wall
גְּדֵרָה	Gederah
גְּדֵרוֹת	Gederoth
גּוּז	brought
גּוֹזָל גּוֹזָל	young
גּוּפָה	bodies
גּוֹר גּוֹרָה	cubs
גָּזֵז	Gazez
גֵּזֶל	violence
גַּזָּם	Gazzam
גֶּזֶר	asunder
גְּזֵרָה	decree
גָּחוֹן	belly
גַּחַר	Gahar
גִּילָה גִּילַת	rejoicing
גִּילוֹנִי	Gilonite
גִּינַת	Ginath
גִּלוֹה גִּילוֹה	Giloh
גִּלָּיוֹן גִּליוֹן	mirrors
גַּלִּים	Gallim
גְּלָל	huge
גַּליֵד	Galeed
גָּלַשׁ	descended
*** 5051 - 5100 (/course/1969831/strongs-numbers-biblical-hebrew/102/)	
גָּמָא	drink
גְּנֵבָה	theft
גְּנוּבַת	Genubath
גָּעָה	low
גָּרוֹל	harsh
גָּרַס	broken
גֶּרֶשׂ	grits
גָּשַׁשׁ	grope
גַּת ־ הַחֵפֶר גִּתּתָּה ־ חֵפֶר	Gath-hepher
גִּתּתַּיִם	Gittaim
גֶּתֶר	Gether
דִּברָה	order
דָּגַר	gather
דָּדָה	procession
דּוֹדָנִים רוֹדָנִים	Dodanim
דַּהֲהַר	dashing
דְּוַי	loathsome
דּוּכִיפַת	hoopoe
דּוּמָה	silence
דְּחִי	stumbling
דָּחַק	afflicted
דַּיָג	fisherman
דַּיָה	hawks
דִּימוֹן	Dimon
דַּיָן	judge
דְּלִי דֳּלִי	bucket
דֶּלֶף	dripping
דְּמָה	like
דָּמַע	weep
דִּנהָבָה	Dinhabah
דָּפקָה	Dophkah
דִּקלָה	Diklah
דְּרָאוֹן דֵּרָאוֹן	abhorrence
דָּרבּוֹן	goad
דַּרדַּר	thistle
דְּרוֹר	swallow
דַּרקוֹן	Darkon
דָּשָׁא	sprout
דֶּתֶא	grass
דְּתָבָר	judges
הֵא	behold
הֵא הָא	even
הָגִיגּ	groaning
הוֹדוּ	India
הַדָּם	limb
הוֹ	alas
הוֹדְוָה	Hodevah
הוֹדִיָה	Hodiah
הוֹתִיר	Hothir
הֵיכּ	how
*** 5101 - 5150 (/course/1969831/strongs-numbers-biblical-hebrew/103/)	
הִלּוּל	festival
הַלָּזֶה	this
הֵלֶך	flow
הִלֵּל	Hillel
הֲמוֹן גּוֹג	Hamon-gog
הֲמוּלָה הֲמוּלָּה	tumult
הֶפֶך הֵפֶך	different
זַבדִּיאֵל	Zabdiel
זְבוּב	flies
זַבַּי	Zabbai
זוֹהַר	brightness
זִו	Ziv
זָוִיתּ	corner
זוּל	lavish
זוַּע	tremble
זָחַח	loose
זִיזָא	Ziza
זַכַּי	Zaccai
זִמרָן	Zimran
זָנַב	rear
זוֹנוֹת	armour
זַעֲוָה	removed
זַעֲוָן	Zaavan
זָעֵף	vexed
זָקַף	raises
זֵרוַּע	sowing
זָרַם	like
זִרמָה	issue
זֵרוַֹע זֵרָעוֹן	pulse
זֵתָם	Zetham
חוֹבָב	Hobab
חֲבַיָּה חֲבָיָה	Habaiah
חֲבַצֶּלֶת	crocus
חִבּוּק	folding
חֲבַקּוּק	Habakkuk
חֲגָבָא חֲגָבָה	Hagaba
חֲגוֹר	girded
חֲדַד	Hadad
חֶדוָה	joy
חֵדֶק	briar
חִדֶּקֶל	Tigris
חַוָּה	Eve
חוּל	Hul
חוּר	white
חַורָן	Hauran
חוֹתָם	Hotham
חֲזוֹת	visible
חֵזִיר	Hezir
חָזֵק	louder
חֲטִיטָּא	Hatita
*** 5151 - 5200 (/course/1969831/strongs-numbers-biblical-hebrew/104/)	
חַטִּיל	Hattil
חֲטִיפָא	Hatipha
חוֹטֵר	rod
חֵילָם חֵלאָם	Helam
חִירָה	Hirah
חֲכַליָה	Hacaliah
חַכמוֹנִי	Hachmoni
חֶלאָה	Helah
חוּלדָּה	Huldah
חֶלדַּי	Heldai
חֲלִי	jewels
חֲלִיצָּה	spoil
חֵלֶף	return
חֵלֶק	Helek
חָלָק	Halak
חֶלקַת	Helkath
חָם	hot
חֱמָא חֲמָה	anger
חַמּוֹן	Hammon
חֶמלָה	compassion
חָמַק	here
חַמַּת	Hammath
חֲמָתִי	Hamathite
חִנטָּא	wheat
חַנִּיאֵל	Hanniel
חֲנַן	mercy
חָנַק	killed
חָסַם	off
חֲסַן	possess
חֵסֶן	power
חָסוֹן	strong
חֶסֶר	want
חֶפצִּי בָּהּ	Hephzibah
חֲפוֹר חַפַרפֵּרָה	mole
חָפשׁוּת חָפשִׁיתּ	separate
חוֹצֶן	bosom
חֲצַף	urgent
חַצּוֹן תָּמָר חַצֲצוֹן תָּמָר	Hazazon-tamar
חֶצרוֹ	Hezro
חֶצרוֹנִי	Hezronites
חֲצַרמָוֶת	Hazarmaveth
חֲקוּפָא	Hakupha
חֵקֶק	decree
חוּקּוֹק חוּקוֹק	Hukkok
חַרבּוֹנָא חַרבּוֹנָה	Harbona
חֲרָדָה	Haradah
חֲרוֹדִי	Harodite
חוֹר הַגִּדגָּד	Hor-haggidgad
חַרחוּר	Harhur
חֶרֶט	tool
*** 5201 - 5250 (/course/1969831/strongs-numbers-biblical-hebrew/105/)	
חָרִיטּ חָרִט	bags
חֲרֵי ־ יוֹנִים חֲרָאיוֹן	dung
חָרִיף	Hariph
חֶרמֵשׁ	sickle
חַרצּוּבָּה	bonds
חֶרֶשׁ	cunning
חוֹרֵשׁ	artificer
חַרשָׁא	Harsha
חֲרָשִׁים	Ge-harashim
חִשָּׁבוֹן	devices
חֲשַׁבנְיָה	Hashabneiah
חֲשׂוּפָא חֲשׂוּפָא	Hasupha
חַשׁמוֹנָה	Hashmonah
חָשַׁשׁ	chaff
חָתַל	cloths
חֶתלוֹן	Hethlon
טָּב	fine
טָּבאֵל	Tabeal
טַּבּוּר	center
טַּבָּעוֹת	Tabbaoth
טְּהוֹר	pureness
טּוֹהַר	clearness
טָּוָה	spun
טּוּר	mountain
טּוּחָה	being
טְּחוֹר	tumors
טִּין	common
טָּלֶה	lamb
טֶּלֶם	Telem
טָּמָה	stupid
טָּפַח	bore
טִּפסַר	marshal
טְּפַר	claws
טָּרַד	constant
טּוֹרַח	burden
טָּרִי	fresh
יָבָל	running
יָבָם	brother
יַבנְאֵל	Jabneel
יַבֶּשֶׁת	ground
יָגבְּהָה	Jogbehah
יָגוֹר	dread
יְדָא	thanks
יִדּוֹ	Iddo
יְדָיָה	Jedaiah
יָדָע	Jada
יְהוֹיָרִיבּ	Joiarib
יְהוֹעַדָּה	Jehoaddah
יְהוֹעַדִּין יְהוֹעַדָּן	Jehoaddan
יְהוֹשַׁבעַת	Jehoshabeath
*** 5251 - 5300 (/course/1969831/strongs-numbers-biblical-hebrew/106/)	
יָהִיר	haughty
יְהַלֶּלאֵל	Jehallelel
יוֹחָא	Joha
יוֹכֶבֶד	Jochebed
יָוֵן	mire
יוֹעָשׁ	Joash
יוֹשָׁפָט	Joshaphat
יְזַניָה יְזַניָהוּ	Jezaniah
יֶחדִּיָהוּ	Jehdeiah
יְחִיאֵלִי	Jehieli
יַחלְאֵל	Jahleel
יַחמוּר	roebuck
יַחצְּאֵל	Jahzeel
יוּטָּה יוּטָה	Juttah
יְכָליָה יְכָליָהוּ יְכִילְיָה	Jechiliah
יַלֶּפֶת	scabs
יָם	sea
יְמוּאֵל	Jemuel
יְמִינִי	Benjamite
יְסוּדָה	foundation
יַעֲזִיָהוּ	Jaaziah
יַעֲלָא יַעֲלָה	Jaala
יָעֵן	ostriches
יַערָה	Jarah
יַעֲרָה	honeycomb
יַעֲשִׂיאֵל	Jaasiel
יִפעָה	splendor
יִפתַּח ־ אֵל	Iphtahel
יְצוּקָה	rest
יִצרִי	Izri
יִקָּהָה	obedience
יְקוֹד	burning
יָקִים	Jakim
יַקִּיר	difficult
יְקַמעָם	Jekameam
יָקמְעָם	Jokmeam
יָקתְּאֵל	Joktheel
יִראִיָיה	Irijah
יָרֵב	Jareb
יְרוּשָׁא יְרוּשָׁה	Jerusha
יֶרַח	Jerah
יְרַח	month
יְרַחמְאֵלִי	Jerahmeelites
יַרחָע	Jarha
יָרַט	contrary
יְרֵשָׁה	possession
יִשׁבָּק	Ishbak
יָשׁבְּקָשָׁה	Joshbekashah
יִשׁוָה	Ishvah
יָשַׂם	put
*** 5301 - 5350 (/course/1969831/strongs-numbers-biblical-hebrew/107/)	
יִשׁמַעיָה יִשׁמַעיָהוּ	Ishmaiah
יְשָׁנָה	Jeshanah
יִשׂרְאֵלִי	Israel
יִתרָה	abundance
יִתרְעָם	Ithream
יְתֵת	Jetheth
כָּאָה	broken
כָּבוּל	Cabul
כְּבִיר	quilt
כֶּבֶל	fetters
כַּדכּוֹד	rubies
כָּוָה	scorched
כְּוִיָה	burn
כּוּמָז	bracelets
כַּוָּן	cakes
כּוּת כּוּתָה	Cuth
כָּזבִּי	Cozbi
כִּילַי כֵּלַי	rogue
כְּלוּב	Chelub
כֶּלַח	vigor
כֶּלַח	Calah
כָּל ־ חוֹזֶה	Col-hozeh
כְּלִיא כְּלוּא	prison
כִּלָּיוֹן	destruction
כַּלכּוֹל	Calcol
כָּלַל	perfected
כֶּסֶא כֶּסֶה	moon
כָּסוּי	cover
כָּסַח	cut
כִּסלָה	confidence
כִּסלֵו	Chislev
כַּסלוּחִים	Casluh
כָּסַם	trim
כָּסִפיָא	Casiphia
כֶּסֶת	bands
כֵּף	rocks
כָּפָן	famine
כָּפָר	villages
כְּרוּב	Cherub
כְּרִיתּ	Cherith
כַּרכּוֹב	ledge
כַּרמְלִיתּ	Carmelitess
כְּרָן	Cheran
כָּרַר	dancing
כְּתַל	wall
לוֹא רוּחָמָה	Lo-ruhamah
לְבוּשׁ	clothes
לְבָנָא לֶבָנָה	Lebana
לִבנֶה	poplar
לִבנִי	Libnites
*** 5351 - 5400 (/course/1969831/strongs-numbers-biblical-hebrew/108/)	
לְהָבִים	Lehab
לָהַהּ	languished
לַהַט	flaming
לָהַם	morsels
לָהֵן	therefore
לוּחִיתּ לוּחוֹת	Luhith
לוֹחֵשׁ	Hallohesh
לִויָה	garland
לוַּע	swallow
לָחוּם לָחוּם	eating
לוֹט	myrrh
לְמוּאֵל לְמוֹאֵל	Lemuel
לָעֵג	jesters
לֶקֶט	gleaning
לֶקֶשׁ	crop
לְשַׁד	baked
לֶשֶׁם	jacinth
לֶשֶׁם	Leshem
לָשַׁן	slander
מָא	what
מֵאָה	hundred
מָאוֹס	refuse
מַאֲכוֹלֶת	fuel
מֵאמַר	command
מְבוּכָה	confusion
מִבטָּא	statement
מִבצָּר	Mibzar
מַגדִּיאֵל	Magdiel
מַגָּל	sickle
מָגַר	cast
מִגרוֹן	Migron
מֶדֶו	garments
מַדוֶה	diseases
מָדוֹן	Madon
מְדוּרָה מֶדוּרָה	pile
מַדמַנָּה	Madmannah
מְדָן	strife
מְדָן	Medan
מַדרֵגָה	pathway
מִדרָשׁ	treatise
מַהֲלוּמָּה	blows
מָהַר	bartered
מַהֵר שָׁלָל חָשׁ בַּז	Maher-shalal-hash-baz
מוּסָד	foundation
מוֹסָד	foundations
מוֹצָאָה	forth
מוּצָקָה מוּצָקָה	piece
מוֹרָט	peeled
מוֹרִיָה מוֹרִיָה	Moriah
מוֹרַשׁתִּי	Moresheth
*** 5401 - 5450 (/course/1969831/strongs-numbers-biblical-hebrew/109/)	
מוּשׁ	feel
מוּשִׁי	Mushites
מוּת מוּת לַבֵּן	death
מָזוֹן	food
מָזוֹן	food
מִזרֶה	fork
מֵַח	beasts
מַחֲבֵא מַחֲבוֹא	place
מְחַבְּרָה	clamps
מְחוּיָאֵל מְחִיָּאֵל	Mehujael
מַחֲזִיאוֹת	Mahazioth
מְחִידָּא	Mehida
מַחלִי	Mahlites
מַחלָפָה	locks
מַחֲלָצָה	robes
מַחֲלַת	Mahalath
מַחֲלַת	Mahalath
מְחוֹלָתִי	Meholathite
מַחמוּד מַחמוּד	things
מַחסֵיָה	Mahseiah
מֶחֱצָה	half
מַחֲרֵשָׁה	hoe
מַחתֶּרֶת	breaking
מִטפַּחַת	cloak
מַטרֵד	Matred
מֵידָּד	Medad
מֵי זָהָב	Mezahab
מִיכָּהוּ	Micaiah
מִיכָּיָהוּ	Micaiah
מִכלוֹל	magnificently
מַכמָר מִכמוֹר	net
מִכמְתָת	Michmethath
מִכסָה	amount
מַכָּר	acquaintance
מַכשֵׁלָה	ruins
מַכתֵּשׁ	hollow
מְלָא	filled
מַלאַך	angel
מְלוּנָה	shack
מַלּוֹתִי	Mallothi
מָלָח	rags
מְלִיצָּה	figure
מַלכָּא	queen
מַלכִּי ־ צֶּדֶק	Melchizedek
מֶלצָּר	overseer
מָלַק	nip
מָמוֹת	deadly
מַמזֵר	birth
מַמסָך	wine
מַמתַּק	sweet
*** 5451 - 5500 (/course/1969831/strongs-numbers-biblical-hebrew/110/)	
מֵן	instrument
מוֹנֶה	times
מִנהָג	driving
מְנוּסָה מְנוּסָה	fugitives
מִנחָה	offering
מִנִּיתּ	Minnith
מַסֶּכֶת	web
מַסָּע	brought
מִספָּחָה	veils
מָסַר	furnished
מָעוֹג	bread
מַעַזיָה מַעַזיָהוּ	Maaziah
מַעֲנָה	furrow
מַעֲצָד	tool
מַעַר	space
מַעֲשַׁקָּה	oppressor
מַפָּל	folds
מִפרָשׂ	sail
מַפתֵַּח	key
מִפתָּח	opening
מַצָּבָה מִצָּבָה	army
מַצהָלָה	neighing
מָצוּק מָצוּק	pillars
מִצפֶּה	lookout
מִצרֵף	crucible
מַק	putrefaction
מַקֶּבֶת	quarry
מַקהֵל מַקהֵלָה	congregations
מַקהֵלוֹת	Makheloth
מִקטֶּרֶת	censer
מִקנֵיָהוּ	Mikneiah
מִקסָם	divination
מְקוּצעָה	corner
מְקֵרָה	cool
מָרָא	lifts
מַרבַּד	coverings
מַרבֶּה	abundant
מַרבֵּץ	place
מֶרֶד	Mered
מָרָד	rebellious
מֵרוֹם	Merom
מַרחֶשֶׁת	pan
מֵרוֹנוֹתִי	Meronothite
מַרצֵַּע	awl
מָרָק	broth
מֶרקָחָה	ointment
מַשָּׂא	Massa
מַשָּׁא	usury
מַשָּׁאָה	debts
מִשׁאָל	Mishal
*** 5501 - 5550 (/course/1969831/strongs-numbers-biblical-hebrew/111/)	
מִשׁאָלָה	desires
מַשּׁוּאָה מַשּׁוּאָה	ruins
מָשׁוֹט מִשּׁוֹט	oar
מְשׂוּכָה מְשׂוּכָה	hedge
מְשַׁח	oil
מִשׁחָת מָשׁחָת	corruption
מַשׂטֵּמָה	hostility
מֶשִׁי	silk
מֶשֶׁך	acquisition
מִשׁלַחַת	band
מְשִׁלֵּמוֹת	Meshillemoth
מִשׁפָּת	sheepfolds
מִשׁקֶלֶת מִשׁקוֹלֶת	level
מִשׂרָה	government
מִשׂרָפָה	burned
מִשׂרְפוֹת מַיִם	Misrephoth-maim
מַשׂרֵקָה	Masrekah
מְתוּשָׁאֵל	Methushael
מַתּתָּנָה	Mattanah
מֶתֶק	sweet
מִתקָה	Mithkah
מִתרְדָת	Mithredath
נִאוּף	adulteries
נָאַק	groan
נָאַר	abandoned
נְבִזבָּה	reward
נְבִיא	prophet
נוֹגַהּ	Nogah
נַגָּח	goring
נִדבָּך	layer
נַהַם	growling
נְהָמָה	agitation
נָהַק	bray
נוֹב נֵיבּ	praise
נָוָה	home
נוַּח נוַֹח	rested
נוֹעַדיָה	Noadiah
נַחֲלִיאֵל	Nahaliel
נֶחָמָה	comfort
נַחַר נַחֲרָה	nostrils
נַחֲרַי נַחרַי	Naharai
נַחַשׁ	omen
נְטִיפָה	earrings
נְטַל	lifted
נָטָף	drop
נְטוֹפָה	Netophah
נִיחוַֹח נִיחוַֹח	sacrifices
נִיסָן	Nisan
נִיר	break
נְכאוֹת	gum
*** 5551 - 5600 (/course/1969831/strongs-numbers-biblical-hebrew/112/)	
נֵכַח	before
נְכַס	goods
נְכוֹת	treasure
נְמָלָה	ant
נִמרִים	Nimrim
נָסַס	displayed
נִסרוֹך	Nisroch
נַעֲצוּץ	bush
נְעוֹרֶת	tinder
נְפוּשׁסִים	nephishesim
נִפקָא	cost
נֶפתּוַֹח	Nephtoah
נַפתּוּחִים	Naphtuh
נִצָּה	flower
נֵצַח	lifeblood
נְצִיַח	Neziah
נוֹקֵד	breeder
נוֹקֶף	shaking
נְקָרָה	caverns
נָשֶׁה	hip
נְשִׁיקָה	kisses
נָשַׁף	blew
נְשַׁר	eagle
נִשׁתְּוָן	decree
נֶתֶר	lye
סָבַך	tangled
סַבתָּא סַבתָּה	Sabta
סַבתְּכָא	Sabteca
סְגוֹר	chests
סַד	stocks
סוֹטַי	Sotai
סְוֵנֵה סְוֵנָה סְוֵן	Syene
סוּף	fulfilled
סְחָבָה	clothes
סָחַף	prostrate
סִינִי	Sinite
סִיעָא סִיעֲהָא	Sia
סָכַן	endangered
סֶלֶד	Seled
סִלּוֹן סַלּוֹן	brier
סֶלֶף	crookedness
סָמַר	bristled
סְנוּאָה סְנוּאָה	Hassenuah
סִסמַי	Sismai
סְעַפָּה	bough
סַפַּחַת	scab
סֵפֶל	bowl
סֵפֶק שֶׂפֶק	scoffing
סוֹפֶרֶת	Hassophereth
סַרבַּל	trousers
*** 5601 - 5650 (/course/1969831/strongs-numbers-biblical-hebrew/113/)	
סֶרֶד	Sered
סִריוֹן	scale-armor
סְתַר	destroy
עַבדָּא	Abda
עֲבוּדָּה	household
עָבוּר	produce
עֲבָרָה	ford
עֶברוֹנָה	Abronah
עֶגֶב	desires
עָגוּר	crane
עָגִיל	earrings
עֶגלָה	Eglah
עֲדֶן עֲדֶנָּה	still
עַדנָא	Adna
עַדנָה	Adnah
עַדרִיאֵל	Adriel
עוֹד	while
עֲוִיל	ones
עֲוִיתּ עַיּוֹת עַיוּת	Avith
עָוַל	unjustly
עוֹף	bird
עוּץ	devise
עוּק	down
עוּתַי	Uthai
עִזּוּז	man
עָזִּיאֵלִי	Uzzielites
עָזנִיָה	buzzard
עִזקָא	ring
עַזָּתִי	Gazite
עַטרוֹת אַדָּר	Ataroth-addar
עִיטּ	fly
עִיֵי הָעֲבָרִים	Iye-abarim
עִיִים	Iim
עֲיָם	scorching
עֵינַיִם עֵינָם	Enaim
עֵין שֶׁמֶשׁ	En-shemesh
עֵיפָה	darkness
עִירָד	Irad
עִירָם	Iram
עַיִשׁ עָשׁ	bear
עַכָּבִישׁ	spider's
עֶכֶס	anklets
עַלוָה עַליָה	Aliah
עַלוָן עַליָן	Alian
עִלִּי	upper
עֶלֶם	youth
עֲלָמוֹת	alamoth
עַלמוֹן דִּבלָתָימָה	Almon-diblathaim
עָמַד	stand
עָמוֹק	Amok
*** 5651 - 5700 (/course/1969831/strongs-numbers-biblical-hebrew/114/)	
עִמָּנוּאֵל	Immanuel
עַמרָמִי	Amramites
עֲנָב	Anab
עוֹנֶג	delight
עָנַד	bind
עַנוָה	gentleness
עֲנָיָה	Anaiah
עֲנָמִים	Anam
עֲנַניָה	Ananiah
עוֹנֶשׁ	fine
עֲנָת	Anath
עָפַל	up
עָצָה	winks
עַצלָה	indolence
עֲקַלקַל	ways
עֶקרוֹנִי עֶקרוֹנִי	Ekronite
עִקְּשׁוּת	deceitful
עָר	adversary
עֲרוּבָּה	guarantor
עַרבָּתִי	Arbathite
עֲרוֹעֵר עַרעָר	bush
עֵרִי	Eri
עָרֵל	count
עָרַף	drop
עָרפָּה	Orpah
עָרַק	gnaw
עַרקִי	Arkite
עָשֵׁן	smoking
עָשַׁת	shine
עָתַד	destined
עַתּתִּיק	ancient
עָתַר	deceitful
עֶתֶר	Ether
עָתָר	suppliant
פָּארוּר	pale
פֶּגַע	chance
פָּגַר	exhausted
פָּדוֹן	Padon
פּוֹטִיפַר	Potiphar
פּוֹל	beans
פּוּנוֹן	Punon
פּוּק	totter
פּוּרָה	winepress
פָּזַז	agile
פָּחַז	reckless
פַּחַז	uncontrolled
פִּיַח	soot
פִּינוֹן	Pinon
פִּיפִיָה	tooth
פִּיתּוֹן	Pithon
*** 5701 - 5750 (/course/1969831/strongs-numbers-biblical-hebrew/115/)	
פּוֹכֶרֶת צְּבָיִים	Pochereth-hazzebaim
פִּלאִי פָּלִיא	wonderful
פֶּלֶט	Pelet
פַּלֵּט	forth
פַּלטִּי	Palti
פַּלטִּיאֵל	Paltiel
פֶּלֶס	balance
פֶּלֶת	Peleth
פַּס	back
פָּעוּ פָּעִי	Pai
פָּצַל	peeled
פְּקוֹד	Pekod
פִּקֵַּח	clear-sighted
פּוּרָה	Purah
פְּרוּדָא פְּרִידָּא	Perida
פְּרָזוֹן	peasantry
פֶּרֶס	vulture
פֶּרַע	locks
פַּרעָה	leaders
פַּרעוֹשׁ	flea
פֶּרֶץ עוּזָּא	Perez-uzza
פֶּרֶק	road
פָּרָשָׁה	amount
פָּשַׂק	wide
פְּשַׁר	interpretations
פּוֹת פּוֹתָה	foreheads
פִּתגָּם	edict
פְּתוֹר	Pethor
פְּתַח	open
פִּתחוֹן	open
פְּתַי	width
פַּתרוּסִי	Pathrus
צָּאָה	dung
צֶּאֶל	plants
צִּביָה	Zibiah
צְּבִיָה	gazelle
צְּבוֹעִים	Zeboim
צַּד	against
צְּדָד	Zedad
צְּדִיָה	wait
צּוֹא צּוֹא	filthy
צּוּף	honeycomb
צּוֹפַח	Zophah
צְּחוֹק	laughed
צִּיוֹן	drought
צִּיר	form
צְּלָא	pray
צָּלַל	dark
צַּלמוֹנָה	Zalmonah
צֶּלַע	Zela
*** 5751 - 5800 (/course/1969831/strongs-numbers-biblical-hebrew/116/)	
צֶּלֶק	Zelek
צִּלְּתַי	Zillethai
צַּמִּים	schemer
צְּמִיתּוּת צְּמִתוּת	permanently
צְּמָרִי	Zemarite
צְּמָרַיִם	Zemaraim
צֵּן	thorns
צּוֹנֵא צּוֹנֶה	sheep
צִּנּוּר	gutter
צָּנִין צָּנִן	thorns
צָּנַע	humbly
צַּעֲנַנִּים צַּעֲנַיִם	Zaanannim
צִּפּוֹרֶן	nails
צּוֹר	flint
צְּרֵדָה צְּרֵדָתָה	Zereda
צָּרַח	cries
קוֹבֶל	rams
קוּבַּעַת	chalice
קִדָּה	cassia
קַדַּחַת	fever
קַדמָה	ago
קֵדְמָה	Kedemah
קְהִלָּה	assembly
קְהֵלָתָה	Kehelathah
קוֹבַע	helmet
קוֹלָיָה	Kolaiah
קוֹף קוֹף	apes
קְווּצָּה	locks
קַו ־ קַו	powerful
קוּר	web
קוֹטֶן	finger
קְיָם	statute
קַיָם	assured
קֵירוֹס קֵרוֹס	Keros
קַלַּחַת	caldron
קָלָל	burnished
קִמּוֹשׁ קִימוֹשׁ	nettles
קָמַט	shriveled
קָמַל	away
קַנּוֹא	jealous
קְנָת	Kenath
קָצַב	off
קָצַע	scrape
קוֹרֵא	partridge
קְרָבָה	nearness
קִריַת בַּעַל	Kiriath-baal
קָרַם	cover
קָרַס	over
קַרסוֹל	feet
קְרַץ	charges
*** 5801 - 5850 (/course/1969831/strongs-numbers-biblical-hebrew/117/)	
קְשׁוֹט קְשׁוֹט	surely
קָשַׁח	harden
קָשֶׁט קָשׁטּ	truth
קִשׁיוֹן	Kishion
קִשּׁוּר	attire
רָאמָה	coral
רַב	archer
רָבַב	shoot
רִבּוֹ	myriads
רָבִידּ	necklace
רַב ־ מָג	Rab-mag
רֶבַע	Reba
רוֹבַע	fourth
רֶגֶב	clods
רוֹגְלִים	Rogelim
רֶגֶשׁ רִגשָׁה	company
רָדִידּ	shawl
רֵו	appearance
רֶוַח	relief
רְוָחָה	relief
רְוָיָה	abundance
רוֹמַמתִּי עֶזֶר רוֹמַמתִּי עֶזֶר	ezer
רָזָה	lean
רָזֶה	lean
רָזִי	woe
רַחַב	place
רָחָם רָחָמָה	vulture
רַחַץ	washbowl
רַחצָּה	washing
רִיבַּי	Ribai
רִיפָה רִפָה	grain
רִיפַת	Riphath
רִיר	spittle
רָכַס	bind
רִמּוֹן פֶּרֶץ	Rimmon-perez
רִסָּה	Rissah
רָסִיס	breach
רֵַע	thought
רֵעָה	companions
רְעוּת	pleasure
רְעַע	pieces
רָעַץ	afflicted
רָפָא רָפָה	Rapha
רָפַס	foul
רְפַס	down
רֶצַח	shattering
רֶצֶף	Rezeph
רָקַב	rot
רוֹקַח	perfume
רָשַׁשׁ	down
*** 5851 - 5900 (/course/1969831/strongs-numbers-biblical-hebrew/118/)	
רִתמָה	Rithmah
שְׁבוּ	agate
שׁוֹבַי	Shobai
שְׂבִיבּ	flames
שָׁבִיל	paths
שָׁבַץ	set
שֵׂבֶר	hope
שִׁברוֹן	breaking
שָׂגָא	exalt
שַׂגִּיא	exalted
שִׁגָּיוֹן שִׁגָּיוֹנָה	Shigionoth
שֵׁגָל	queen
שֵׁד	demons
שִׁדָּה	concubines
שְׁוָא	Sheva
שׁוֹבָך	Shobach
שְׁוָה	like
שָׁוֵה	Shaveh
שׁוַּח	Shuah
שׁוּחָמִי	Shuhamites
שׂוּט סוּט	lapse
שׂוּך	hedge
שׂוֹך שׂוֹכָה	bough
שׁוּלַמִּיתּ	Shulammite
שׁוֹמֵר שׁוֹמֵר	Shomer
שׁוּנִי	Shuni
שׁוַּע	help
שׁוַּע	Shua
שׁוּעָא	Shuah
שׁוּעָל	Shual
שׁוֹפָך	Shophach
שׂוּר	princes
שׁוּר	carriers
שׁוּשַׁן עֵדוּת שׁוֹשַׁנִּים עֵדוּת	Shoshannim-Eduth
שָׁחַד	bribe
שָׁחִיס סָחִישׁ	same
שְׁחִיתּ	destructions
שַׁחַף	gull
שַׁחֶפֶת	consumption
שַׁחַץ	pride
שִׂיבּ	gray
שִׂידּ	lime
שַׁיִט	oars
שַׁיִן	urine
שִׁיתּ	dressed
שְׁכַן	dwell
שֶׂכֶר	hired
שָׂכָר	Sacar
שָׁלַב	fitted
שָׁלָה	deceive
*** 5901 - 5950 (/course/1969831/strongs-numbers-biblical-hebrew/119/)	
שִׁלּוַֹח שֶׁלַח	Shiloah
שִׁלחִי	Shilhi
שִׁלטּוֹן	authoritative
שִׁלטּוֹן שִׁלטּוֹן	rulers
שָׁלָך	cormorant
שָׁלֵם	Salem
שִׁלֵּם	Shillem
שַׂלמַי	Shalmai
שַׁלמַנאֶסֶר	Shalmaneser
שֶׁלֶף	Sheleph
שַׁמָּא	Shamma
שַׁמגַּר	Shamgar
שִׁמָּמוֹן	horror
שִׁמעָה	Shimeah
שִׁמעִי	Shimeites
שִׁמעָת	Shimeath
שֶׁמֶץ	faint
שִׁמּוּר	observed
שָׁמרַיִן	Samaria
שֶׁנהַבִּים	ivory
שַׁעַטנֵז	mixed
שְׂעִירָה	goat
שַׁעַלבּוֹנִי	Shaalbonite
שַׁעַף	Shaaph
שְׂעָרָה	storm
שְׁעַריָה	Sheariah
שְׁפוֹ שְׁפִי	Shephi
שְׁפוֹט שְׁפוּט	judgment
שְׁפוּפָם שְׁפוּפָן	Shephuphan
שַׁפִּיר	beautiful
שֶׁפֶך	poured
שֵׁפֶל	places
שְׁפָם	Shepham
שֶׁפֶר	Shepher
שָׁפָת	hook
שִׁקּוּי	drink
שָׁקוּף	frames
שׁוֹקֶת	trough
שׁוֹר	body
שָׁרָב	land
שָׂרַג	together
שָׂרָה	contended
שְׂרוֹך	strap
שְׁרוּקָה שְׁרִיקָה	hissing
שֶׂרֶט שָׂרֶטֶת	cutting
שָׂרִידּ	Sarid
שִׁריוֹן שִׂריוֹן	Sirion
שַׂרעַף	thoughts
שָׁרָר	Sharar
שָׁרֵת	service
*** 5951 - 6000 (/course/1969831/strongs-numbers-biblical-hebrew/120/)	
שֵׁשׁבַּצַּר	Sheshbazzar
שֵׁשׁבַּצַּר	Sheshbazzar
שֵׁשַׁך	Sheshach
שָׁשַׁק	Shashak
שָׁשַׁר	red
שֵׁת שִׁת	six
שָׁתָה	foundations
שֵׁתָה	buttocks
שָׁתַם	open
שָׁתַת	appointed
תָּאַב	long
תָּאָה	line
תְּאוֹ תּוֹא	antelope
תַּאֲנָה תּוֹאֲנָה	tree
תַּאֲנִיָה	lamenting
תְּאַשּׁוּר	cypress
תֶּבֶל	incest
תַּבעֵרָה	Taberah
תִּדהָר	box
תְּדִירָא	constantly
תַּדמוֹר תַּמּוֹר	Tadmor
תִּדעָל	Tidal
תּוּבַל קַיִן	Tubal-cain
תָּוָה	put
תּוֹעָה	disturbance
תַּחמָס	owl
תַּחַן	Tahan
תַּחֲרָא	mail
תַּחָרָה	habergeon
תִּימָרָה תִּמָרָה	columns
תִּירָס	Tiras
תְּכוּנָה	fashion
תּוּכִּי תּוּכִּי	peacocks
תּוֹכֶן	quantity
תָּכנִיתּ	perfection
תָּלָא	bent
תְּלַאשַּׂר תְּלַשַּׂר	Telassar
תֵּל חַרשָׁא	Tel-harsha
תְּלִיתַּי תַּלתִּי	third
תֵּל מֶלַח	Tel-melah
תְּלַת	third
תְּלָתִין	thirty
תִּמָּהוֹן	bewilderment
תְּמוּתָה	death
תֶּמַח	Temah
תּוֹמֶר	tree
תָּנָה	hire
תָּנָה	commemorate
תַּנָּה	dragon
תְּנוּאָה	opposition
*** 6001 - 6050 (/course/1969831/strongs-numbers-biblical-hebrew/121/)	
תַּנחוּמֶת	Tanhumeth
תַּעֲלוּל	children
תָּעַע	deceive
תַּעֲרוּבָה	hostages
תַּעתּוַּע	mockery
תִּפסַח	Tiphsah
תָּפַף	beating
תִּפתַּי	magistrates
תִּקוָה	Tikvah
תְּקוֹף	might
תַּרבּוּת	brood
תִּרהָקָה	Tirhakah
תְּרַע	court
תֶּרֶשׁ	Teresh
תַּרתָּן	commander
אֲבַגתָּא	Abagtha
אֲבַדּוֹה	destruction
אַבדָּן	destroying
אָבדָּן	destruction
אָבֶה	desire
אֵבֶה	reed
אֲבוֹי	sorrow
אִבחָה	glittering
אֲבַטִּיַח	melons
אֲבִי	Abi
אֲבִיאָסָף	Abiasaph
אֲבִיהוּד	Abihud
אֲבִיוֹנָה	caperberry
אֲבִיטּוּב	Abitub
אֲבִי ־ עַלבּוֹן	Abi-albon
אָבַך	upward
אָבֵל	plain
אָבֵל הַשִּׁטִּים	Abel-shittim
אַבֵל מַיִם	Abel-maim
אָבֵל מִצרַיִם	Abel-mizraim
אֲבָנָה	Abanah
אֶבֶץ	Ebez
אֲבָקָה	powders
אָבַר	soars
אַברֵך	kneel
אָגֵא	Agee
אֱגוֹז	nut
אָגוּר	Agur
אֲגוֹרָה	piece
אֶגֶל	drops
אֶגלַיִם	Eglaim
אָגֵם	grieved
אָדַב	grieve
אַדּוֹן	Addon
אֲדוֹרַיִם	Adoraim
*** 6051 - 6100 (/course/1969831/strongs-numbers-biblical-hebrew/122/)	
אֲדַליָא	Adalia
אֲדָמָה	Adamah
אֲדָמִי	Adami-nekeb
אַדמָתָא	Admatha
אַדָּן	Addan
אֲדָר	Adar
אִדַּר	floors
אַדרַזדָּא	zeal
אֶדרָע	force
אָדַשׁ	thresh
אוֹהַב	caresses
אָהַל	bright
אוֹהֶל	Ohel
אוּאֵל	Uel
אוֹבִיל	Obil
אָוָה	draw
אוּזַי	Uzai
אוֹיָה	woe
אוֹן	On
אֲוֵרָה	stall
אֶזבַּי	Ezbai
אֶזֶל	Ezel
אָזֵן	tools
אוּזֵּן שֶׁאֱרָה	Uzzen-sheerah
אַזנוֹת תָּבוֹר	Aznoth-tabor
אֲזַניָה	Azaniah
אַח	brothers
אוַֹח	owls
אַחבָּן	Ahban
אָחַד	collect
אֵחוּד	Ehud
אַחוָה	declaration
אַחֲוָה	explanation
אַחֲוָה	brotherhood
אֲחוַֹח	Ahoah
אֲחוּמַי	Ahumai
אַחזַי	Ahzai
אֲחוּזָּם	Ahuzzam
אֲחוּזַּת	Ahuzzath
אֵחִי	Ehi
אֲחִידָּה	enigmas
אֲחִיהוּד	Ahihud
אֲחִיחוּד	Ahihud
אֲחִימוֹת	Ahimoth
אַחיָן	Ahian
אֲחִינָדָב	Ahinadab
אֲחִירָם	Ahiram
אֲחִירָמִי	Ahiramites
אֲחִישַׁחַר	Ahishahar
אֲחִישָׁר	Ahishar
זֶּ֖ה	"typographical error for seh, q.v."
*** 6101 - 6150 (/course/1969831/strongs-numbers-biblical-hebrew/123/)	
אַחלָב	Ahlab
אַחמְתָא	Ecbatana
אֲחַסבַּי	Ahasbai
אַחֵר	Aher
אַחרַח	Aharah
אֲחַרחֵל	Aharhel
אָחֳרֵין אָחֳרֵן	last
אַחֲרִיתּ	latter
אֲחַשׁתָּרִי	Haahashtari
אֵטוּן	linen
אָטַר	shut
אִי	not
אָיַב	enemies
אֵיכּוֹה	where
אֱיָל	strength
אֵילוֹן בֵּיתּ חָנָן	Elonbeth-hanan
אֱיָלוּת	help
אֵיל פָּארָן	El-paran
אִין	not
אִיעֶזֵר	Iezer
אִיעֶזרִי	Iezerites
אִישׁ	man
אִישׁהוֹד	Ishhod
אֵיתָּנִים	Ethanim
אַכַּד	Accad
אַכזְרִיוּת	fierce
אֲכִילָה	food
אוּכָל אוּכָּל	Ucal
אָכַף	urges
אֶכֶף	pressure
אֵל	these
אֵלָא	Ela
אָלָה	wail
אַלָּה	oak
אֵלֶּה	these
אֱלוּל	Elul
אַלּוֹן בָּכוּת	Allon-bacuth
אֵלוֹנִי אֵלוֹנִי	Elonites
אֱלִידָּד	Elidad
אֱלִיחוֹרֶף	Elihoreph
אֱלִיעֵינַי	Elienai
אֱלִיפָל	Eliphal
אֱלִיקָא	Elika
אֱלִישֶׁבַע	Elisheba
אֱלִישָׁפָט	Elishaphat
אַלַּמֶּלֶך	Allammelech
אַלמָן	forsaken
אַלמוֹן	widowhood
אֶלנַעַם	Elnaam
אֶלעָד	Elead
*** 6151 - 6200 (/course/1969831/strongs-numbers-biblical-hebrew/124/)	
אֶלעָדָה	Eleadah
אֶלעוּזַי	Eluzai
אָלַף	produce
אֶלֶף	Haeleph
אָלַץ	urged
אַלקוּם	army
אֶלקוֹשִׁי	Elkoshite
אֶלתְּקוֹן	Eltekon
אַמָּה	Ammah
אָמוֹן	artisans
אָמוֹן	Amon
אָמִי	Ami
אֲמֵלָל	feeble
אֲמָם	Amam
אָמַן	turn
אָמָן	artist
אוֹמֶן	faithfulness
אָמנָה	care
אוֹמְנָה	pillar
אֲמָנָה	Amana
אוֹמֶץ	stronger
אַמצָּה	strength
אֵמתָּנִי	terrible
אֲנוּ	we
אֲנָחֲרָת	Anaharath
אֲנִיעָם	Aniam
אָנַס	compulsion
אֲנַס	baffles
אֲנָקָה	gecko
אַנתּוּן	you
אָסוּך	jar
אַסנָה	Asnah
אוֹסנַפַּר	Osnappar
אֲסֵפָה	together
אֲסוּפָּה	collections
אַספְּסוּף	rabble
אַספָּתָא	Aspatha
אֵפוֹד	ephod
אַפֶּדֶן	pavilion
אֲפִיַח	Aphiah
אָפִיל	late
אַפֵל	gloom
אוֹפֶן	circumstances
אֶפֶס דַּמִּים	dammim
אֵפַע	nought
אֲפֵקָה	Aphekah
אַפִּריוֹן	chair
אֲפָרְסַי	secretaries
אַפְּתוֹם	revenue
אֶקדָּח	crystal
*** 6201 - 6250 (/course/1969831/strongs-numbers-biblical-hebrew/125/)	
אַקּוֹ	goat
אֲרָא	Ara
אֶראֵל	brave
אֲרָב	Arab
אוֹרֶב	ambush
אָרֳבָה	trickery
אֲרֻבּוֹת	Arubboth
אַרבִּי	Arbite
אַרבַּעתַּיִם	fourfold
אַרגְּוָן	purple
אַרדּוֹן	Ardon
אַרדִּי	Ardites
אֲרוֹד	Arod
אֲרוּמָה	Arumah
אֲרוֹמִי	Syrian
אַרזָה	work
אֲרִידַּי	Aridai
אַריֵה	Arieh
אֲרִיסַי	Arisai
אֲרַך	fitting
אֶרֶך	Erech
אַרכּוּבָה	knee
אַרכְּוַי	Erech
אֲרַם צּוֹבָה	Aram-zobah
אַרמוֹנִי	Armoni
אוֹרֶן	fir
אוֹרֶן	Oren
אַרנָן	Arnan
אַרעִיתּ	bottom
אַרצָּא	Arza
אֲרַק	earth
אֲרֶשֶׁת	request
אֵשׁ	fire
אִשׁ	there
אַשׁבֵּלִי	Ashbelites
אַשׁבֵַּע	Beth-ashbea
אֶשֶׁד	slope
אַשׁדּוֹדִיתּ	Ashdod
אֶשׁדָּת	lightning
אֶשָּׁה	fire
אֲשׁוּיָה	foundation
אֲשִׁימָא	Ashima
אָשִׁישׁ	foundation
אֶשֶׁך	testicles
אַשׁמָן	vigorous
אֶשׁעָן	Eshan
אַשׁפְּנַז	Ashpenaz
אֶשׁקְלוֹנִי	Ashkelonite
אוֹשֶׁר	happy
אֲשׁוּר	boxwood
*** 6251 - 6300 (/course/1969831/strongs-numbers-biblical-hebrew/126/)	
אֲשַׂראֵל	Asarel
אֲשַׂראֵלָה	Asharelah
אָשֵׁרִי	Asherites
אַשׂרִאֵלִי	Asrielites
אֶשׁתָּאוּלִי	Eshtaolites
אֶתבַּעַל	Ethbaal
אֶתנָה	wages
אֶתנִי	Ethni
אֶתנַן	Ethnan
אֲתָרִים	Atharim
בְּאָה	entrance
בִּאוּשׁ	evil
בְּאֵרָא	Beera
בְּאֵר אֵלִים	Beer-elim
בְּאֵרָה	Beerah
בְּאֵרוֹת בְּנֵי ־ יַעֲקַן	Bene-jaakan
בְּאֵשׁ	distressed
בָּאשָׁה	stinkweed
בָּבָה	apple
בַּבלִי	Babylonians
בַּג	spoil
בּוֹגְדוֹת	treacherous
בִּגתָּא	Bigtha
בֵּדְיָה	Bedeiah
בָּדָל	piece
בָּדַק	restore
בִּדקַר	Bidkar
בְּדַר	scatter
בַּהַט	porphyry
בְּהִילוּ	haste
בָּהִיר	bright
בְּהֵמוֹת	Behemoth
בּוֹהַק	eczema
בּוּזָה	despised
בּוּזִי	Buzi
בַּוַּי	Bavvai
בּוּל	Bul
בּוּנָה	Bunah
בּוֹצֵץ	Bozez
בּוּקָה	emptied
בּוֹקֵר	herdsman
בּוּר	explain
בּוּת	night
בָּזוֹה	despised
בִּזָּיוֹן	contempt
בִּזיוֹתיָה	Biziothiah
בָּזָק	lightning
בִּזתָּא	Biztha
בָּחוֹן	tower
בַּחִין	tower
*** 6301 - 6350 (/course/1969831/strongs-numbers-biblical-hebrew/127/)	
בַּחַן	watch-tower
בּוֹחַן	tested
בַּחֲרוּמִי	Baharumite
בֶּטַח	Betah
בִּטחָה	trust
בַּטּוּחוֹת	secure
בָּטֵל	idle
בֶּטֶן	Beten
בּוֹטֶן	nuts
בְּטוֹנִים	Betonim
בִּינָה	understanding
בִּירָא	palace
בֵּיתּ אַרבֵּאל	Beth-arbel
בֵּיתּ בִּראִי	Beth-biri
בֵּיתּ ־ גָּדֵר	Beth-gader
בֵּיתּ גָּמוּל	Beth-gamul
בֵּיתּ דִּבלָתַיִם	Beth-diblathaim
בֵּיתּ הָאֱלִי	Bethelite
בֵּיתּ הָאֵצֶל	Beth-ezel
בֵּיתּ הַמֶּרחָק	far
בֵּיתּ הָעֵמֶק	Beth-emek
בֵּיתּ הָרָם	Beth-haram
בֵּיתּ הָרָן	Beth-haran
בֵּיתּ הַשִּׁטָּה	Beth-shittah
בֵּיתּ כַּר	Beth-car
בֵּיתּ לְבָאוֹת	Beth-lebaoth
בֵּיתּ לְעַפרָה	Beth-le-aphrah
בֵּיתּ עַזמָוֶת	Beth-azmaveth
בֵּיתּ עֲנוֹת	Beth-anoth
בֵּיתּ עֵקֶד	Beth-eked
בֵּיתּ פַּצֵּץ	Beth-pazzez
בֵּיתּ רָפָא	Bethrapha
בַּיתּ תַּפּוַּח	Beth-tappuah
בָּכָא	Baca
בֶּכֶה	bitterly
בְּכוֹרַת	Becorath
בְּכִיתּ	mourning
בֶּכֶר	camel
בִּכרָה	camel
בַּכּוּרָה	firstripe
בַּכרִי	Becherites
בָּל	mind
בְּלָא	down
בִּלגַּי	Bilgai
בָּלָה	Balah
בְּלִימָה	nothing
בָּלַם	check
בָּלַס	figs
בַּלעִי	Belaites
בֵּלשַׁאצַּר בֵּלאשַׁצַר	Belshazzar
*** 6351 - 6400 (/course/1969831/strongs-numbers-biblical-hebrew/128/)	
בָּמָה	Bamah
בִּמהָל	Bimhal
בֵּן	Ben
בֶּן ־ אֲבִינָדָב	Ben-abinadab
בֶּן ־ אוֹנִי	Ben-oni
בֶּן ־ גֶּבֶר	Ben-geber
בֶּן ־ דֶּקֶר	Ben-deker
בֶּן ־ זוֹחֵת	Ben-zoheth
בֶּן ־ חוּר	Ben-hur
בֶּן ־ חַיִל	Benhail
בֶּן ־ חָנָן	Benhanan
בֶּן ־ חֶסֶד	Ben-hesed
בְּנֵי ־ בְּרַק	Bene-berak
בִּניָה	building
בִּניָן	building
בְּנִינוּ	Beninu
בְּנַס	indignant
בֶּן ־ עַמִּי	Ben-ammi
בְּסוֹדְיָה	Besodeiah
בֶּסֶר	grape
בְּעִי	grave
בַּעַל הָמוֹן	Baal-hamon
בַּעַל חָצוֹר	Baal-hazor
בַּעֲלִי	Baali
בְּעֶליָדָע	Beeliada
בְּעַליָה	Bealiah
בַּעֲלֵי יְהוּדָה	Baale-judah
בַּעֲלִיס	Baalis
בַּעַל שָׁלִשָׁה	Baal-shalishah
בַּעֲלַת בְּאֵר	Baalath-beer
בַּעַל תָּמָר	Baal-tamar
בְּעוֹן	Beon
בָּעֲרָא	Baara
בְּעֵרָה	fire
בַּעֲשֵׂיָה	Baaseiah
בְּעֶשׁתְּרָה	Be-eshterah
בּוֹץ	mire
בֶּצֶל	onions
בְּצַר	gold
בָּצרָה	fold
בִּצָּרוֹן	stronghold
בַּקבַּקַּר	Bakbakkar
בִּקעָא	plain
בַּקָּרָה	cares
בִּקּוֹרֶת	punishment
בּוֹר	so
בְּרוֹאדַּך בַּלאֲדָן	Berodach-baladan
בְּרָאיָה	Beraiah
בַּרבּוּר	fowl
בָּרַד	hail
*** 6401 - 6450 (/course/1969831/strongs-numbers-biblical-hebrew/129/)	
בְּרוֹם	colors
בְּרוֹת	cypresses
בָּרוּת	food
בִּרזוֹת	Birzaith
בַּרחוּמִי	Barhumite
בֵּרִי	Beri
בֵּרִי	Berites
בְּרִיאָה	thing
בָּרִיַח	Bariah
בְּרִיעִי	Beriites
בְּרִיתּ	Berith
בֶּרֶך	knees
בֶּרַע	Bera
בָּרַק	forth
בִּרשַׁע	Birsha
בֵּרוֹתִי	Berothite
בִּשׁלָם	Bishlam
בָּשׁנָה	shame
בָּשַׁס	rent
בָּתָה	waste
בַּתּתָּה	steep
בְּתוּל	Bethul
בִּתיָה	Bithia
בָּתַק	pieces
בַּת רַבִּים	Bath-rabbim
בִּתרוֹן	morning
בַּת ־ שׁוַּע	Bath-shua
גֵּא	proud
גֵּאָה	arrogance
גְּאוּאֵל	Geuel
גַּאֲיוֹן	proud
גּוֹאֶל	defiled
גַּב	back
גֵּב	locust
גִּבֵַּח	forehead
גַּבַּי	Gabbai
גֵּבִים	Gebim
גָּבִישׁ	crystal
גְּבַל	Gebal
גְּבָל	Gebal
גִּבֵּן	hunchback
גְּבִנָה	cheese
גִּבעָא	Gibea
גִּבעוֹל	bud
גִּבעַת	Gibeath
גִּבעָתִי	Gibeathite
גֶּבֶר	Geber
גְּבַר	man
גִּבָּר	warriors
גִּבָּר	Gibbar
*** 6451 - 6500 (/course/1969831/strongs-numbers-biblical-hebrew/130/)	
גְּדוּפָה	reviling
גַּדִּי	had
גַּדִּיאֵל	Gaddiel
גְּדִיָה	goats
גִּדעוֹם	Gidom
גֶּדֶר	Geder
גְּדֵרִי	Gederite
גְּדֵרָתִי	Gederathite
גְּדֵרוֹתַיִם	Gederothaim
גֵּה	this
גָּהָה	cure
גֵּהָה	medicine
גּוּב	husbandman
גֵּוָה	back
גֵּוָה	pride
גּוּמָּץ	pit
גּוּנִי	Gunites
גּוּף	shut
גּוּר	Gur
גּוּר ־ בַּעַל	Gur-baal
גּוּשׁ גִּישׁ	crust
גִּזבָּר	treasurer
גִּזבָּר	treasurers
גָּזָה	took
גִּזוֹנִי	Gizonite
גְּזֵרָה	solitary
גִּזרִי גִּרזִי	Gezrites
גַּחַם	Gaham
גִּיַח גּוַּח	stirring
גִּיַח	Giah
גִּיר	plaster
גֵּישָׁן	Geshan
גַּלָּב	barber's
גַּלגַּל	wheels
גִּלגָּל	wheel
גֶּלֶר	skin
גְּלוֹם	clothes
גְּלִילוֹת	Geliloth
גָּלָל	dung
גִּלֲלַי	Gilalai
גָּלַם	together
גּוֹלֶם	substance
גּוֹמֶד	cubit
גַּמָּד	Gammadim
גָּמוּל	Gamul
גִּמזוֹ	Gimzo
גְּמַלִּי	Gemalli
גְּמַר	perfect
גִּנזַך	storehouses
גּוֹעָה	Goah
*** 6501 - 6550 (/course/1969831/strongs-numbers-biblical-hebrew/131/)	
גּוֹעַל	abhorred
גּוֹפֶר	gopher
גִּר	chalk
גַּרגַּר	olives
גָּרַד	scrape
גֵּרוּת	Geruth
גָּרַז	off
גֶּרֶם	bones
גַּרמִי	Garmite
גָּרַף	away
גֶּרֶשׁ	produce
גְּרוּשָׁה	expropriations
גָּשַׁם	rain
גּוֹשֶׁם	upon
גִּשׁפָּא	Gishpa
דְּאָבָה	dismay
דְּאָבוֹן	despair
דָּאָה	kite
דּוֹב	bear
דּוֹבֶא	walk
דָּבַב	gently
דְּבַח	offered
דְּבַח	sacrifices
דִּבלָה	Diblah
דִּבלַיִם	Diblaim
דְּבַק	adhere
דּוֹבְרָה	rafts
דַּבָּרָה	words
דִּברִי	Dibri
דַּבֶּשֶׁת	humps
דַּבֶּשֶׁת	Dabbesheth
דָּגָה	grow
דְּדָנִים	Dedanites
דָּהַם	dismayed
דָּהַר	galloping
דּוּב	away
דַּוָּג	fishermen
דּוּגָה	fish
דּוֹדָוָהוּ	Dodavahu
דּוֹדַי	Dodai
דָּוָה	menstruation
דּוּך	beat
דּוּץ	leaps
דּוּר	dwell
דּוּרָא	Dura
דּוּשׁ	down
דַּחֲוָה	music
דּוֹחַן	millet
דִּיגּ	fish
דְּיוֹ	ink
*** 6551 - 6600 (/course/1969831/strongs-numbers-biblical-hebrew/132/)	
דִּי זָהָב	Dizahab
דִּימוֹנָה	Dimonah
דִּין	judge
דַּיָן	judges
דִּינַי	dinaites
דַּיִשׁ	threshing
דִּישׁוֹן	ibex
דַּכָּה	emasculated
דֳּכִי	waves
דִּלעָן	Dilean
דַּלפוֹן	Dalphon
דְּלַק	burning
דַּלֶּקֶת	inflammation
דּוּמָּה	silent
דִּמיוֹן	like
דִּמנָה	Dimnah
דֶּמַע	vintage
דְּמֶשֶׁק	cover
דַּנָּה	Dannah
דָּן יַעַן	Dan-jaan
דָּפִי	slander
דּוֹק	curtain
דַּר	mother-of-pearl
דַּרדַּע	Darda
דְּרַע	arms
דָּרַע	Dara
הַבהָב	gifts
הוֹבֶן	ebony
הָבַר	astrologers
הָגוּת	meditation
הָגִין	directly
הֵד	shouting
הֲדַדרִמּוֹן	Hadadrimmon
הָדָה	put
הִדַּי	Hiddai
הָדַך	down
הֲדַסָּה	Hadassah
הֲדַר	Hadar
הֶדֶר	Jewel
הָהּ	alas
הוֹד	Hod
הוֹהָם	Hoham
הוֹלֵלוּת	madness
הוֹמָם	Hemam
הוּן	easy
הוֹשָׁמָע	Hoshama
הָזָה	dreamers
הִי	woe
הוּיְדָה	thanksgiving
הַיָה	calamity
*** 6601 - 6650 (/course/1969831/strongs-numbers-biblical-hebrew/133/)	
הֵילֵל	morning
הֵימָם	Hemam
הָכַר	wrong
הַכָּרָה	expression
הָלָא	outcasts
הַלֵּזוּ	this
הָלִיכּ	steps
הֶלֶם	Helem
הַלמוּת	hammer
הָם	Ham
הֵם	wealth
הֲמוֹנָה	Hamonah
הֶמיָה	music
הָמָס	brushwood
הֲנָחָה	holiday
הֲפוּגָה	stopping
הוֹפֶך	perversity
הֲפֵכָה	overthrow
הֲפַכפַּך	crooked
הַצָּלָה	deliverance
הוֹצֶן	weapons
הָרָא	Hara
הַרהוֹר	fantasies
הֲרוֹרִי	Harorite
הֲרִיסָה	ruin
הֲרִיסוּת	destroyed
הוֹרָם	Horam
הָרוּם	Harum
הַרמוֹן	Harmon
הֶרֶס	destruction
הָשֵׁם	Hashem
הַשׁמָעוּת	information
הִתּתּוּך	melted
הָתוֹל	mockers
הָתַת	mischief
וָהֵב	Waheb
וָזָר	guilty
וַיְזָתָא	Vaizatha
וָלָד	child
וַניָה	Vaniah
וָפסִי	Vophsi
וַשׁנִי	Vashni
זָבַד	endowed
זֶבֶד	gift
זָבוּד	Zabud
זַבּוּד	Zabbud
זְבִידָּה	Zebidah
זְבִינָא	Zebina
זָבַל	dwell
זְבַן	bargaining
*** 6651 - 6700 (/course/1969831/strongs-numbers-biblical-hebrew/134/)	
זָג	skin
זָהַם	loathes
זַהַם	Zaham
זְהַר	heed
זוֹ	this
זוּד	arrogantly
זוּזִים	Zuzim
זוֹחֵת	Zoheth
זוּן	well-fed
זוּן	fed
זוּרֶה	on
זָזָא	Zaza
זוֹחֶלֶת	Zoheleth
זֵידּוֹן	raging
זִיזָה	Zizah
זִינָא	Zina
זִיַע	Zia
זִיפָה	Ziphah
זֵיתָּן	Zethan
זָכוּ	innocent
זְכוּכִיתּ	glass
זֶכֶר	Zecher
זוּלּוּת	vileness
זַלזַל	sprigs
זַמזוֹם	Zamzummin
זְמִירָה	Zemirah
זָמָם	device
זְמַן	together
זֶמֶר	sheep
זַמָּר	singers
זִמרָה	products
זָנַק	leaps
זֵעָה	sweat
זְעֵיר	one
זָעַך	extinguished
זְעִק	cried
זִפרוֹן	Ziphron
זוֹקֶן	age
זְקַף	impaled
זָרָא	loathsome
זָרַב	waterless
זְרוּבָּבֶל	Zerubbabel
זַרזִיף	water
זַרזִיר	strutting
זֶרַח	rising
זְרַע	seed
זָרַר	sneezed
זֵתַר	Zethar
חוֹב	bosom
חָבַב	loves
*** 6701 - 6750 (/course/1969831/strongs-numbers-biblical-hebrew/135/)	
חֲבוּלָה	crime
חֶביוֹן	hiding
חִבֵּל	mast
חֲבַצַּניָה	Habazziniah
חַבָּר	traders
חֲבַרבּוּרָה	spots
חַברָה	associates
חֶברָה	company
חֶברִי	Heberites
חֲבֶרֶת	companion
חָבֵת	pans
חָגָא	terror
חָגָב	Hagab
חַגִּיָה	Haggiah
חַד	one
חַדּוּד	sharp
חֶדוָה	joy
חֲדִי	breast
חֶדֶל	world
חַדלַי	Hadlai
חָדַר	surrounds
חַדרָך	Hadrach
חוֹדֶשׁ	Hodesh
חֲדָשָׁה	Hadashah
חֲדָת	new
חוּב חָיַב	forfeit
חוֹב	debtor
חוֹבָה	Hobah
חוּג	circle
חוֹזַי	Hozai
חוּט	repairing
חוּפָם	Hupham
חוּפָמִי	Huphamites
חוּר חוּר	hole
חוֹר	network
חָרַר	pale
חִוָּר	white
חוּרִי	Huri
חוּרַי	Hurai
חוּשָׁה	Hushah
חֲזוֹ	Hazo
חָזוֹת	visions
חֲזִיאֵל	Haziel
חֲזָיָה	Hazaiah
חֶזיוֹן	Hezion
חֵזֶק	strength
חִזקִי	Hizki
חַטָּאָה	offering
חֲטוּבָה	colored
חֲטִי	sins
*** 6751 - 6800 (/course/1969831/strongs-numbers-biblical-hebrew/136/)	
חָטַם	restrain
חִיאֵל	Hiel
חָיֶה	lively
חַיוּת	living
חֵילָה	bulwark
חִילֵן	Hilen
חִין	orderly
חַיִץ	wall
חִישׁ	soon
חַכלִיל	dull
חַכלִלוּת	redness
חָלָא	diseased
חֵלֶב	Heleb
חֶלבָּה	Helbah
חֶלבּוֹן	Helbon
חֶלבְּנָה	galbanum
חֵלֶד	Heled
חוֹלֶד	mole
חֲלוֹף	unfortunate
חֲלוּשָׁה	defeat
חַלחוּל	Halhul
חָלַט	catching
חֲלִי	Hali
חֶליָה	jewelry
חֵלֶם	Helem
חַלָּמוּת	egg
חֶלֶף	Heleph
חַלָּק	smooth
חַלּוּק	smooth
חֲלַקָּה	smooth
חֲלוּקָּה	division
חֶלקִי	Helekites
חֶלקַי	Helkai
חֶלקַת הַצּוּרִים	Helkath-hazzurim
חַלָּשׁ	weak
חֶמדָּן	Hemdan
חַמּוּאֵל	Hamuel
חָמוּלִי	Hamulites
חָמוֹץ	ruthless
חַמּוּק	curves
חוֹמֶט	reptile
חוּמטָּה	Humtah
חָמִיצּ	salted
חֶמֶר	wine
חַמרָן	Hamran
חָמַשׁ	fifth
חוֹמֶשׁ	fifth
חַמּוֹת דּוֹאר	Hammoth-dor
חֲמַת צּוֹבָה	Hamath-zobah
חֵן	Hen
*** 6801 - 6850 (/course/1969831/strongs-numbers-biblical-hebrew/137/)	
חָנוּת	cell
חַנּוֹת	gracious
חָנִיכּ	men
חֲנִינָה	favor
חֲנוֹכִי	Hanochites
חֲנָמָל	frost
חָנֵס	Hanes
חוֹנֶף	ungodliness
חֲנוּפָה	pollution
חַנָּתוֹן	Hannathon
חֲסַדיָה	Hasadiah
חָסוּת	shelter
חֲסִין	mighty
חַסִּיר	deficient
חָסַל	consume
חָסַן	hoarded
חַספַּס	thing
חַסרָה	Hasrah
חֶסרוֹן	lacking
חַף	innocent
חָפָא	secret
חוּפָּה	Huppah
חָפַף	shields
חֶפרִי	Hepherites
חֲפָרַיִם	Haphraim
חֵפֶשׂ	plot
חָפַשׁ	free
חוֹפֶשׁ	saddlecloths
חוּפשָׁה	freedom
חָצוֹר חֲדַתּתָּה	Hazor-hadattah
חֲצִי הַמנוּחוֹת	Manahethites
חֲצִי הַמְּנַחתִּי	Manahethites
חָצִיר	abode
חֵצֶן	bosom
חֲצַר אַדָּר	Hazaraddar
חֲצַר גַּדָּה	Hazar-gaddah
חֲצַר הַתּתִּיכּוֹן	Hazer-hatticon
חֲצֵרִים	Hazerim
חֲצַר סוּסָה	Hazar-susah
חֲצַר סוּסִים	Hazar-susim
חֲצַר עֵינוֹן	Hazar-enan
חֶרֶא חֲרִי	dung
חֲרַב	waste
חֲרָבוֹן	heat
חָרַג	trembling
חָרגּוֹל	cricket
חַרהֲיָה	Harhaiah
חָרוּז	beads
חֲרוּמַף	Harumaph
חֲרוּפִי	Haruphite
*** 6851 - 6900 (/course/1969831/strongs-numbers-biblical-hebrew/138/)	
חָרוּץ	Haruz
חַרחַס	Harhas
חַרחוּר	heat
חוֹרִי	bread
חֲרִישִׁי	scorching
חָרַך	roast
חֲרַך	singed
חֶרֶך	lattice
חֳרֵם	Horem
חֶרמוֹנִים	Hermon
חַרנֶפֶר	Harnepher
חֶרֶס	Heres
חַרסוּת	potsherd
חָרֵף	Hareph
חֲרַץ	hip
חַרצַּן	seeds
חָרֵר	wastes
חֶרֶשׁ	Heresh
חָרַת	engraved
חֶרֶת	Hereth
חֲשַׁב	accounted
חַשׁבַּדָּנָה	Hashbaddanah
חֲשׁוּבָה	Hashubah
חֲשַׁבנָה	Hashabnah
חֲשׁוֹך	darkness
חָשׁוֹך	men
חֶשׁכָּה	dark
חָשַׁל	stragglers
חֲשַׁל	shatters
חֶשׁמוֹן	Heshmon
חַשׁמַן	envoys
חָשִׂף	flocks
חִשּׁוּק	spokes
חִשּׁוּר	hubs
חַשׁרָה	mass
חִתּתָּה	terror
חִתּתּוּל	bandage
חַתחַת	terrors
חָתַך	decreed
חֲתוּלָּה	band
חֲתַם	sealed
חוֹתֶמֶת	ring
חֲתוּנָּה	wedding
חָתַף	away
חֶתֶף	robber
חֲתַת	terror
חֲתַת	Hathath
טְּאֵב	pleased
טָּבוּל	turbans
טַּבָּח	bodyguard
*** 6901 - 6950 (/course/1969831/strongs-numbers-biblical-hebrew/139/)	
טַּבָּחָה	cooks
טִּבחַת	Tibhath
טְּבַליָהוּ	Tebaliah
טַּברִמּוֹן	Tabrimmon
טֵּבֶת	Tebeth
טַּבַּת	Tabbath
טּוּא	sweep
טּוֹב אֲדוֹנִיָהוּ	Tob-adonijah
טּוּשׂ	swoops
טְּוָת	fasting
טָּחָה	bowshot
טְּחוֹן	grind
טַּחֲנָה	mill
טִּיַח	plaster
טְּלָא	lamb
טְּלָאִים	Telaim
טַּלטֵּלָה	headlong
טָּלַל	covered
טְּלַל	shade
טָּנַף	dirty
טָּעָה	misled
טָּעַן	load
טָּעַן	pierced
טִּפּוּח	healthy
טָּפַף	steps
טָּפַשׁ	covered
טָּפַת	Taphath
טְּרוֹם	before
טָּרַח	loads
טָּרָף	picked
טַּרפְּלַי	officials
יָאַב	longed
יָאָה	due
יָאִרִי	Jairite
יְאִתוֹן	entrance
יְאָתְרַי	Jeatherai
יָבַב	lamented
יָבָל	Jabal
יַבֵּל	sore
יַבנֶה	Jabneh
יִבנְיָה	Ibneiah
יִבנִיָה	Ibnijah
יְבֶרֶכיָהוּ	Jeberechiah
יִבשָׂם	Ibsam
יַבֶּשֶׁת	earth
יָגַב	plowmen
יָגֵב	fields
יִגדַּליָהוּ	Igdaliah
יָגָה	removed
יָגוּר	Jagur
*** 6951 - 7000 (/course/1969831/strongs-numbers-biblical-hebrew/140/)	
יָגִיַע	weary
יָגלִי	Jogli
יָגָע	attained
יְגִעָה	wearying
יְגַר שַׂהֲדוּתָא	Jegar-sahadutha
יִדאֲלָה	Idalah
יִדבָּשׁ	Idbash
יְדִדוּת	beloved
יָדוֹן	Jadon
יְדִידָּה	Jedidah
יְדִידְּיָה	Jedidiah
יִדלָף	Jidlaph
יְהָב	burden
יָהַד	Jews
יְהוּד	Jehud
יֶהדַּי	Jahdai
יְהוּדִיָה	Jewish
יְהוּדִיתּ	1365
יְהוּכַל	Jehucal
יְהוֹסֵף	Joseph
יְהוֹשֶׁבַע	Jehosheba
יוֹב	Iob
יוּבַל	stream
יוּבָל	Jubal
יוֹיָכִין	Jehoiachin
יוּכַל	Jucal
יְוָנִי	Greeks
יוֹנֵק	shoot
יוֹסִפיָה	Josiphiah
יוֹעֵאלָה	Joelah
יוֹעֵד	Joed
יוֹעֶזֶר	Joezer
יוֹקִים	Jokim
יוֹרָה	Jorah
יוֹרַי	Jorai
יוּשַׁב חֶסֶד	Jushab-hesed
יוֹשִׁביָה	Joshibiah
יוֹשָׁה	Joshah
יוֹשַׁויָה	Joshaviah
יְזַואֵל	Jeziel
יִזִּיָה	Izziah
יָזִיז	Jaziz
יִזלִיאָה	Jezliah
יֶזַע	sweat
יִזרָח	Izrahite
יְחוּבָּה	Jehubbah
יַחדּוֹ	Jahdo
יַחדִּיאֵל	Jahdiel
יַחזְיָה	Jahzeiah
יְחִזקִיָה יְחִזקִיָהוּ	Jehizkiah
*** 7001 - 7050 (/course/1969831/strongs-numbers-biblical-hebrew/141/)	
יַחזֵרָה	Jahzerah
יְחִיָה	Jehiah
יַחלְאֵלִי	Jahleelites
יַחמַי	Jahmai
יַחצְּאֵלִי	Jahzeelites
יַחצִּיאֵל	Jahziel
יְטַב	good
יָטבָּה	Jotbah
יָכִינִי	Jachinites
יָלוֹן	Jalon
יְלֵל	howling
יָלַע	devour
יַלקוּט	pouch
יֵם	springs
יְמִימָה	Jemimah
יַמלֵך	Jamlech
יִמנָע	Imna
יָמַר	boast
יִמרָה	Imrah
יָמַשׁ	feel
יָנִים	Janum
יְנִיקָה	twigs
יְסוּד	began
יָסוּר	depart
יִסּוֹר	faultfinder
יָסַך	poured
יִסכָּה	Iscah
יִסמַכיָהוּ	Ismachiah
יְסַף	added
יֶעדִּי	Iddo
יָעָה	away
יְעוּאֵל	Jeiel
יְעוּץ	Jeuz
יָעוּר	Jair
יָעַז	fierce
יַעֲזִיאֵל	Jaaziel
יָעַט	cover
יַעכָּן	Jacan
יַעֲלָה	doe
יַעֲנַי	Janai
יְעָף	weariness
יַעֲקוֹבָה	Jaakobah
יַעֲקָן	Jaakan
יַעֲרֵי אוֹרְגִים	Jaare-oregim
יְעָרִים	Jearim
יַעֲרֶשׁיָה	Jaareshiah
יַעֲשׂוּ	Jaasu
יִפדְּיָה	Iphedeiah
יְפֵה ־ פִיָה	pretty
יָפַח	breath
*** 7051 - 7100 (/course/1969831/strongs-numbers-biblical-hebrew/142/)	
יָפֵַח	breathe
יַפלֵטִי	Japhletites
יְצָא	completed
יְצֵב	meaning
יִצחַר	Izhar
יָצִיא	children
יָצוּר	members
יְקַבצְּאֵל	Jekabzeel
יְקֵדָא	burning
יָקדְּעָם	Jokdeam
יָקֶה	Jakeh
יָקוֹשׁ	catcher
יְקוּתִיאֵל	Jekuthiel
יַקִּיר	dear
יִראוֹן	Yiron
יְרוּבֶּשֶׁת	Jerubbesheth
יְרוּאֵל	Jeruel
יָרוַֹח	Jaroah
יָרוֹק	thing
יְרִיאֵל	Jeriel
יְרִיבַּי	Jeribai
יְרִיעוֹת	Jerioth
יַרכָּא	thighs
יְרֵמַי	Jeremai
יִרפְּאֵל	Irpeel
יָרקְעָם	Jorkeam
יֶשֶׁבאָב	Jeshebeab
יִשׁבּוֹ בְּנוֹב	Ishbi-benob
יִשׁבַּח	Ishbah
יָשׁוּבִי	Jashubites
יָשׁוּבִי לֶחֶם יוֹשֶׁבֵי לֶחֶם	Jashubi-lehem
יְשׁוֹחָיָה	Jeshohaiah
יִשׁוִי	Ishvites
יֵשׁוַּע	Jeshua
יֶשַׁח	vileness
יְשִׂימִאֵל	Jesimiel
יְשִׁימָה	death
יְשִׁישָׁי	Jeshishai
יִשׁמָא	Ishma
יִשׁמְרַי	Ishmerai
יָשֵׁן	Jashen
יִשׁפָּה	Ishpah
יִשׁפָּן	Ishpan
יֵשֶׁר	Jesher
יְשַׂראֵלָה	Jesharelah
יִשׁרָה	uprightness
יָשֵׁשׁ	infirm
יַת	whom
יָתוּר	range
יִתלָה	Ithlah
*** 7101 - 7150 (/course/1969831/strongs-numbers-biblical-hebrew/143/)	
יִתמָה	Ithmah
יַתנִיאֵל	Jathniel
יִתנָן	Ithnan
יִתרָא	Ithra
כְּבֵדוּת	difficulty
כַּבּוֹן	Cabbon
כָּבַר	abundance
כְּבָרָה	sieve
כֶּבֶשׁ	footstool
כְּדַב	false.
כָּה	point
כֵּהָה	relief
כַּו	windows
כּוּב	Chub
כּוּן	Cun
כּוֹר עָשָׁן	Chor-ashan
כּוּשִׁי	Cushi
כּוּשָׁן	Cushan
כּוֹשָׁרָה	prosperity
כּוֹזְבָא	Cozeba
כְּזִיבּ	Chezib
כָּחַל	painted
כֶּחָשׁ	false.
כִּי	branding
כִּידּ	decay
כִּידּוֹד	sparks
כִּידּוֹן	Chidon
כִּידּוֹר	attack
כִּיוּן	Kiyyun
כֵּילַף	hammers
כִּיר	stove
כִּישׁוֹר	distaff
כִּכֵר	talents
כִּלאָב	Chileab
כָּלֵב אֶפרָתָה	Caleb-ephrathah
כָּלֶה	yearn
כְּלוּבַי	Chelubai
כְּלוּהַי	Cheluhi
כְּלוּלָה	betrothal
כְּלָל	Chelal
כִּלמָד	Chilmad
כְּלִמּוּת	humiliation
כָּמַהּ	yearns
כָּמַס	store
כִּמרִיר	blackness
כַּנֶּה	Canneh
כַּנָּה	shoot
כְּנָנִי	Chenani
כִּנעָה	bundle
כָּנַף	hide
*** 7151 - 7200 (/course/1969831/strongs-numbers-biblical-hebrew/144/)	
כְּנָת	colleagues
כֵּס	sworn
כַּסדַּי	Chaldean
כְּסִיל	Chesil
כְּסִילוּת	folly
כָּסַל	foolish
כִּסלוֹן	Chislon
כְּסָלוֹן	Chesalon
כְּסוּלּוֹת	Chesulloth
כִּסוֹלתּ תָּבוֹר	Chisloth-tabor
כָּסַס	divide
כָּפָה	subdues
כָּפִיס	rafter
כָּפַן	bent
כְּפַר הָעַמּוֹנִי	Chephar-ammoni
כָּפַשׁ	cower
כָּרָא	distressed
כַּרבֵּל	clothed
כַּרבְּלָא	caps
כֵּרָה	feast
כָּרָה	caves
כָּרוֹז	herald
כְּרַז	proclamation
כַּרכּוֹם	saffron
כַּרכַּס	Carkas
כַּרכָּרָה	camels
כַּרמִי	Carmites
כִּרסֵם	away
כַּרפַּס	linen
כְּרֵשׂ	stomach
כַּרשְׁנָא	Carshena
כִּשׂבָּה	lamb
כֶּשֶׂד	Chesed
כָּשָׂה	sleek
כַּשִּׁיל	hatchet
כִּשָּׁלוֹן	stumbling
כַּשָּׁף	sorcerers
כְּתוֹבֶת	marks
כּוֹתֶל	wall
כִּתלִישׁ	Chitlish
כָּתַם	stain
כָּתַשׁ	pound
לָאַט	covered
לָאֵל	Lael
לְאוּמִּים	Leummim
לוֹא עַמִּי	Lo-ammi
לֵב	myself
לְבָאוֹת	Lebaoth
לַבָּה	flame
לְבוֹנָה	Lebonah
*** 7201 - 7250 (/course/1969831/strongs-numbers-biblical-hebrew/145/)	
לִבנָה	paved
לַהַג	devotion
לַהַד	Lahad
לַהֲקָה	company
לוּז	almond
לוֹט	covering
לוּל	stairs
לְוָת	adhering
לְזוּת	devious
לֵַח	vigor
לְחֶם	feast
לָחֶם	war
לַחמִי	Lahmi
לַחמָס לַחמָם	Lahmas
לְטָאָה	lizard
לְטוּשִׁם	Letushim
לִילִיתּ	owl
לֶכֶד	caught
לֵכָה	Lecah
לוַֹע	throat
לָעַב	mocked
לַעדָּה	Laadah
לָעַז	language
לָעַט	swallow
לַפִּידּוֹת	Lappidoth
לָצַץ	scorn
לַקוּם	Lakkum
לִקחִי	Likhi
לָקַשׁ	glean
לֶשַׁע	Lasha
לֶתֶך	half
מַאֲבוּס	barns
מַאֲוַי	desires
מְאוּרָה	den
מוֹאזֵן	scales
מַאֲמָץ	forces
מֵאֵן	refuse
מַאֲפֶה	baked
מַאֲפֵל	darkness
מַאֲפֵלְיָה	darkness
מִבדָּלָה	apart
מְבוּקָה	desolate
מִבחוֹר	choice
מִבחָר	Mibhar
מַבלִיגִּיתּ	healing
מִבנֶה	structure
מְבוּנַּי	Mebunnai
מִברָח	fugitive
מָבוּשׁ	genitals
מְבַשְׁלָה	boiling-places
*** 7251 - 7300 (/course/1969831/strongs-numbers-biblical-hebrew/146/)	
מַגבִּישׁ	Magbish
מִגבָּלָה	twisted
מִגדַּל ־ אֵל	Migdal-el
מִגדַּל ־ גָּד	Migdal-gad
מִגדַּל ־ עֵדֶר	Eder
מְגוֹרָה	fears
מָגוֹר מִסָּבִיבּ	Magor-missabib
מַגזֵרָה	axes
מְגִלָּה	scroll
מְגַמָּה	horde
מְגִנָּה	hardness
מִגעֶרֶת	rebuke
מַגפִּיעָשׁ	Magpiash
מְגַר	overthrow
מִגרָעָה	offsets
מִגרָפָה	clods
מַדבַּח	altar
מִדַּד	gone
מַדהֵבָה	city
מַדּוַּח	oracles
מָדוֹן	stature
מִדחֶה	ruin
מְדַחפָה	speedily
מָדַי	Mede
מָדַי	Mede
מִדִּין	Middin
מְדוֹכָה	mortar
מַדמֵן	madmen
מַדמֵנָה	pile
מַדמֵנָה	Madmenah
מַדקָרָה	piercing
מִדרָך	footstep
מְדוּשָּׁה	threshed
מְהוּמָן	Mehuman
מָהַל	diluted
מַהלֵך	walk
מַהֲלָל	praise
מַהֲמוֹרָה	pits
מַהֲתַלָּה	illusions
מוֹבָא	coming
מוֹדַע מוֹדָע	friend
מוֹדַעַת	kinsman
מוּלָה	circumcision
מוֹלִידּ	Molid
מוּסָב	surrounding
מוּסָדָה	foundations
מוֹעָד	ranks
מוּעָדָה	appointed
מוֹעַדיָה	Moadiah
מוּעֶדֶת	joint
*** 7301 - 7350 (/course/1969831/strongs-numbers-biblical-hebrew/147/)	
מוּעָף	gloom
מוּעָקָה	burden
מוּץ	extortioner
מוּק	mock
מוֹקְדָה	hearth
מוֹרֶשֶׁת גַּת	Moresheth-gath
מוֹשְׁכָה	cords
מוֹשָׁעָה	deliverances
מוֹת	death
מֶזֶג	wine
מָזֶה	wasted
מֶזֶו	garners
מָזוֹר	ambush
מַזָּלָה	constellations
מְזָרֶה	north
מַזָּרָה	constellation
מִזרָע	fields
מוַֹח	marrow
מַחֲגוֹרֶת	donning
מְחוּגָה	compass
מָחוֹז	haven
מַחֲוִים	Mahavite
מָחוֹל	Mahol
מְחִי	blow
מְחִיר	Mehir
מְחִלָּה	holes
מַחלוּי	sick
מַחֲלָף	duplicates
מַחלְקָה	course
מַחֲמָאָה	butter
מַחמָל	pitieth
מַחֲנֵה ־ דָּן	Mahaneh-dan
מַחֲנַק	suffocation
מַחסוֹם	muzzle
מַחַץ	bruise
מָחַק	smashed
מֶחקָר	depths
מַחֲרֶשֶׁת	share
מַחשׂוֹף	exposing
מַטאֲטֵא	broom
מַטבֵַּח	slaughter
מוּטֶּה	perversion
מוּטָּה	spread
מַטוֶה	spun
מְטִיל	bars
מַטרִי	Matrite
מֵי הַיַּרקוֹן	Me-jarkon
מִיכָּל	brook
מֵיסָך	portico
מֵישָׁא	Mesha
*** 7351 - 7400 (/course/1969831/strongs-numbers-biblical-hebrew/148/)	
מִישָׁאֵל	Mishael
מֵישַׁך	Meshach
מֵישָׁע	Mesha
מֵישַׁע	Mesha
מַכבִּיר	abundance
מַכבֵּנָא	Machbena
מַכבַּנַּי	Machbannai
מַכבָּר	grating
מָכִי	Machi
מָכִירִי	Machirites
מִכלָה	purest
מִכלָל	perfection
מִכלוּל	garments
מַכּוֹלֶת	food
מִכמַן	treasures
מַכנַדבַּי	Machnadebai
מְכוֹנָה	Meconah
מְכוּנָה	base
מְכֵרָה	swords
מִכרִי	Michri
מְכֵרָתִי	Mecherathite
מְכִתּתָּה	pieces
מַכתֵּשׁ	mortar
מַלאֲכוּת	commission
מַלאָכִי	Malachi
מִלֵּאתּ	setting
מַלּוַּח	mallow
מְלַח	service
מֶלֶט	mortar
מְלַטיָה	Melatiah
מְלִילָה	heads
מְלַך	advice
מַלכּוֹדֶת	trap
מַלכִּיאֵלִי	Malchielites
מַלכִּירָם	Malchiram
מוֹלֶכֶת	Hammolecheth
מִלֲלַי	Milalai
מַלמָד	oxgoad
מָלַץ	sweet
מֶלתָּחָה	wardrobe
מַלתָּעָה	tooth
מַמְּגוּרָה	barns
מֵמַד	measurements
מִמכֶּרֶת	sale
מֶמֶר	bitterness
מַמרוֹר	bitterness
מִמשַׁח	anointed
מִמשָׁק	possessed
מַנגִּינָה	song
מִנהָרָה	dens
*** 7401 - 7450 (/course/1969831/strongs-numbers-biblical-hebrew/149/)	
מָנוֹד	laughingstock
מָנוֹן	son
מִנְּזָר	guardsmen
מְנִי	destiny
מִנִּי	Minni
מִניָן	number
מִנלֶה	grain
מַנעָל	locks
מַנעַם	delicacies
מְנַענַע	castanets
מָס	man
מַסַּד	foundation
מִסדְּרוֹן	vestibule
מִסָּה	tribute
מְסוּכָה	hedge
מַסָּח	defense
מִסחָר	wares
מֶסֶך	mixed
מְסוּכָּה	covering
מִסכֵּנוּת	scarcity
מַסלוּל	highway
מִסעָד	supports
מִספָּר	Mispar
מִספֶּרֶת	Mispereth
מוֹסָר	instruction
מָסוֹרֶת	bond
מִסתּוֹר	protection
מַסתֵּר	hide
מַעבָּד	works
מַעבָּד	works
מַעֲבֶה	clay
מַעֲדַי	Maadai
מַעַדיָה	Maadiah
מַעֲדַנָּה	influence
מַעדֵּר	hoe
מְעָה מְעָא	belly
מֵעָה	grains
מָעוֹך	Maoch
מְעוֹנוֹתַי	Meonothai
מָעוּף	gloom
מָעוֹר	nakedness
מָעוֹט	up
מַעֲטֶה	mantle
מַעֲטָפָה	tunics
מְעִי	ruin
מָעַי	Maai
מֵעָל	sunset
מוֹעַל	lifting
מָעֳמָד	foothold
מַעֲמָסָה	heavy
*** 7451 - 7500 (/course/1969831/strongs-numbers-biblical-hebrew/150/)	
מַעַץ	Maaz
מַעֲצֵבָה	torment
מַעצּוֹר	restrained
מַעצָּר	control
מַעֲקֶה	parapet
מַעֲקָשׁ	places
מַעֲרֶה	meadows
מַעֲרָה	army
מְעָרָה	Mearah
מַעֲרָך	plans
מַעֲרוֹם	ones
מַעֲרָצָה	crash
מַעֲרָת	Maarath
מַעֲשַׂי	Maasai
מוֹף	Memphis
מִפגָּע	target
מַפָּח	last
מַפּוַּח	bellows
מוּפִּים	Muppim
מֵפִיצּ	club
מִפלָאָה	wonders
מִפלַגָּה	sections
מִפלָט	refuge
מִפלָשׂ	layers
מַפָּץ	shattering
מַפֵּץ	war-club
מִפקָד	inspection
מִפרָץ	landings
מִפרֶקֶת	neck
מִפשָׂעָה	hips
מוּצָּב	siegeworks
מְצוֹבָיָה	Mezobaite
מוֹצָה	Mozah
מַצּוּת	quarrel
מִצחָה	greaves
מְצִלָּה	bells
מְצוּלָּה	ravine
מַצָּע	bed
מִצְּעִירָה	little
מִצעָר	Mizar
מִצפּוּן	treasures
מָצַץ	suck
מִקוָה	reservoir
מִקָּח	taking
מַקָּחָה	wares
מִקטָּר	burn
מָקַץ	Makaz
מַקצּוּעָה	planes
מְקָרֶה	rafters
מִקשֶׁה	hair
*** 7501 - 7550 (/course/1969831/strongs-numbers-biblical-hebrew/151/)	
מִקשָׁה	field
מַר	drop
מָרָא	Mara
מְראוֹדַך בַּלאָדָן	Merodach-baladan
מוּראָה	crop
מַראָשָׁה	principality
מִרבָּה	much
מַרגּוַֹע	rest
מַרגֵּמָה	sling
מַרגֵּעָה	repose
מְרַד	rebellion
מֶרֶד	rebellion
מַרדּוּת	rebellious
מְרוֹדָך	Marduk
מוּרדָּף	persecution
מוֹרָה	grief
מֵרוֹז	Meroz
מְרוַֹח	crushed
מֵרוֹץ	race
מָרוּק	beautification
מָרוֹת	Maroth
מִרזַח	banquet
מַרזֵַח	banqueting
מָרַח	apply
מְרַט	plucked
מְרִי בַּעַל	a
מְרָיָה	Meraiah
מְרִירוּת	grief
מְרִירִי	bitter
מוֹרֶך	weakness
מַרכּוֹלֶת	merchandise
מִרמָה	Mirmah
מֶרֶס	Meres
מַרסְנָא	Marsena
מֵרַע	mischief
מַרעֲלָה	Maralah
מִרפָּשׂ	foul
מְרוּצָה	extortion
מַרצֶּפֶת	pavement
מֶרקָח	herbs
מְרֵרָה	gall
מְרָרִי	Merarites
מִרשַׁעַת	wicked
מְרָתַיִם	Merathaim
מַשׁ	Mash
מֵשָׁא	Mesha
מַשּׂוֹא	respect
מַשׁאָב	places
מַשָּׂאָה	smoke
מַשָּׁאוֹן	guile
*** 7551 - 7600 (/course/1969831/strongs-numbers-biblical-hebrew/152/)	
מִשׁבָּת	ruin
מִשׁגֶּה	mistake
מוֹשֶׁה	Moses
מַשֶּׁה	creditor
מְשׁוֹבָב	Meshobab
מְשׁוּגָה	error
מְשׁוּסָה	spoil
מַשּׂוֹר	saw
מִשׂחָק	laughing
מִשׁחָר	dawn
מַשׁחֵת	destroying
מִשׁטָּר	rule
מִשׁכַּן	habitation
מָשָׁל	Mashal
מְשׁוֹל	byword
מְשִׁלֵּמִיתּ	Meshillemith
מְשׁוּלֶּמֶת	Meshullemeth
מִשׁמַנָּה	Mishmannah
מִשׁמָע	heard
מַשׂמְרָה	nail
מִשׁעוֹל	path
מִשׁעִי	cleansing
מִשׁעָם	Misham
מִשׂפָּח	bloodshed
מֶשֶׁק	heir
מַשָּׁק	about
מִשׁקוֹל	weight
מִשׁקָע	clear
מִשׁרָה	juice
מִשׁרָעִי	Mishraites
מַשׂרֵת	pan
מִשׁתֶּה	banquet
מַתבֵּן	straw
מֶתֶג הָאַמָּה	Metheg-ammah
מָתַח	spreads
מַתּתְּלָאָה	weariness
מִתנִי	Mithnite
מוֹתֶק	sweetness
מָתָק	sweetly
מַתּתַּתּתָּה	Mattattah
נָא	raw
נָאַם	declare
נַאֲפוּף	adultery
נְבוּאָה	prophesying
נְבוּשַׁזבָּן	Nebushazban
נָבַח	bark
נִבחַז	Nibhaz
נֵבֶך	springs
נַבלוּת	lewdness
נְבַלָּט	Neballat
*** 7601 - 7650 (/course/1969831/strongs-numbers-biblical-hebrew/153/)	
נֶברְשָׁא	lampstand
נִבשָׁן	Nibshan
נְגַד	flowing
נֶגֶד	toward
נוֹגַהּ	day
נְגוֹהָה	brightness
נְדַביָה	Nedabiah
נְדַד	fled
נָדוּד	tossing
נֵדֶה	gifts
נְדִיבָּה	plans
נָדָן	gifts
נָדָן	sheath
נִדנֶה	body
נוַֹהּ	eminent
נַחֲלוֹל	places
נְהָרָה	light
נוֹבַי	Nebai
נוּד	flee
נוֹד נוֹד	wanderings
נוֹד	Nod
נוֹדָב	Nodab
נוֹחָה	Nohah
נוּט	shake
נוּמָה	drowsiness
נוּן	increase
נוֹף	elevation
נוּק	nursed
נוּשׁ	sick
נֵזֶק	annoyance
נַחבִּי	Nahbi
נְחוּם	Nehum
נַחוּם	Nahum
נָחוּשׁ	bronze
נְחִילָה	Nehiloth
נְחִיר	nostrils
נַחַם	Naham
נוֹחַם	compassion
נַחֲמָנִי	Nahamani
נָחַץ	urgent
נְחוּשׁתָּא	Nehushta
נְחוּשׁתָּן	Nehushtan
נְטִיל	weigh
נֵטֶל	weighty
נָטִיַע	plants
נְטָעִים	Netaim
נְטַר	kept
נִי	wailing
נִידּ	solace
נִידָּה	thing
*** 7651 - 7700 (/course/1969831/strongs-numbers-biblical-hebrew/154/)	
נִיס	fugitive
נִיצּוֹץ	spark
נָכָא	scourged
נֵכֶה	smiters
נָכוֹן	Nachon
נֵכֶל	tricks
נֶכֶר נוֹכֶר	strange
נָלָה	cease
נְמוּאֵלִי	Nemuelites
נְמַר	leopard
נִמרָה	Nimrah
נְסִבָּה	turn
נְסַח	drawn
נָסַך	make
נְסַך	present
נְסַך	offerings
נָסַק	ascend
נֵעָה	Neah
נְעִיאֵל	Neiel
נַעַם	Naam
נַעֲמִי	Naamites
נַעֲמָן	delightful
נָעַר	growl
נַעֲרַי	Naarai
נַעֲרָן	Naaran
נוֹפַח	Nophah
נֶפֶץ	cloudburst
נֶפֶת	Napheth
נַפתּוּל	wrestlings
נָצָא	flee
נִצָּב	handle
נִצבָּה	toughness
נְצַח	distinguishing
נְצִיבּ	Nezib
נָצִיר	preserved
נִצָּן	flowers
נָצַץ	sparkle
נְקֵא	pure
נֶקֶב	sockets
נֶקֶב	Nekeb
נְקוּדָּה	beads
נָקַט	weary
נִקפָּה	rope
נְקַשׁ	knocking
נֵרגַּל	Nergal
נִשֵּׂאתּ	gift
נְשׂוּאָה נְשׂוּאָה	carry
נְשִׁי	debt
נְשִׁיָה	forgetfulness
נָשִׁין	wives
*** 7701 - 7750 (/course/1969831/strongs-numbers-biblical-hebrew/155/)	
נָשַׁם	gasp
נִשׁמָא	life-breath
נְתִין	Nethinim
נְתַן ־ מֶלֶך	Nathan-melech
נָתַס	break
נָתַע	broken
נְתַר	off
סְאוֹן	boot
סָאַן	warrior
סַאסְאָה	banishing
סְבָאִי	Sabeans
סִבָּה	turn
סוֹבֶך	forest
סְבַל	retained
סִבּוֹלֶת	sibboleth
סְבַר	intend
סִברַיִם	Sibraim
סְגַר	shut
סַגרִידּ	rain
סֶדֶר	order
סַהַר	round
סוֹא	so
סוּג	fence
סוּגַר	cage
סוֹדִי	Sodi
סוַּח	Suah
סוּחָה	refuse
סוּסָה	mare
סוּסִי	Susi
סוּף	Suph
סוּר	degenerate
סוּר	Sur
סוּת	robes
סָחָה	scrape
סְחִי	offscouring
סְחוֹרָה	market
סוֹחֵרָה	bulwark
סוֹחֶרֶת	stones
סִיוָן	Sivan
סִינִים	Sinim
סָך	throng
סִכּוּת	Sikkuth
סוּכּוֹת בְּנוֹת	Succoth-benoth
סוּכִּי	Sukkiim
סְכָכָה	Secacah
סֶכֶל	folly
סָכַת	silent
סָלָא	weighed
סִלָּא	Silla
סָלַד	rejoice
*** 7751 - 7800 (/course/1969831/strongs-numbers-biblical-hebrew/156/)	
סַלָּח	forgiving
סוּלָּם	ladder
סַלסִלָּה	branches
סֶלַע הַמַּחלְקוֹת	sela-hammahlekoth
סָלעָם	locust
סַמגַּר נְבוֹ	Samgar-nebu
סְמַכיָהוּ	Semachiah
סָמַן	place
סָמָר	bristly
סֶנֶה	Seneh
סַנסִן	stalks
סַנסַנָּה	Sansannah
סָס	grub
סְעַד	supporting
סָעָה	stormy
סָעַף	off
סֵעֵף	double-minded
סַף	Saph
סִפַּי	Sippai
סְפִינָה	ship
סִפּוּן	ceiling
סָפַף	threshold
סְפָר	census
סְפָר	Sephar
סְפָרָד	Sepharad
סְפוֹרָה	sum
סְפַרוִי	Sepharvites
סָרָב	thistles
סַרגּוֹן	Sargon
סַרדִּי	Seredites
סִרָה	Sirah
סֶרַח	part
סַרעַפָּה	boughs
סָרַף	burn
סַרפָּד	nettle
סְתָו	winter
סְתוּר	Sethur
סִתרִי	Sithri
עֲבָד	deeds
עַבדֶּאֵל	Abdeel
עַבדִּיאֵל	Abdiel
עֲבֵד נֶגוֹ	Abed-nego
עַבטִּיטּ	loans
עִברִי	Ibri
עֶברוֹן	Ebron
עָבַשׁ	shrivel
עָבַת	together
עֲגָבָה	lust
עָגַם	grieved
עָגַן	refrain
*** 7801 - 7850 (/course/1969831/strongs-numbers-biblical-hebrew/157/)	
עֵד	filthy
עָדִין	one
עֲדִינָא	Adina
עֲדִינוֹ	Adino
עֲדִיתַּיִם	Adithaim
עַדלַי	Adlai
עָדַן	reveled
עֲדעָדָה	Adadah
עֶדֶר	Eder
עוּב	cloud
עוֹבָל	Obal
עוּג	baked
עִויָא	iniquities
עֲוִיל	ruffians
עַוִּים	Avvim
עוֹנָה	marriage
עַועֶה	distortion
עוֹפַי	Ephai
עוּר	bare
עוּר	chaff
עוּשׁ	hasten
עוּת	sustain
עַוָּתָה	oppression
עֵז	goats
עַזבּוּק	Azbuk
עָזָז	Azaz
עוּזִּיָא	Uzzia
עֲזִיאֵל	Aziel
עֲזִיזָא	Aziza
עַזָּן	Azzan
עָזַק	around
עֶזֶר	Ezer
עֶזרָה	Ezrah
עֶזרִי	Ezri
עֲזַריָה	Azariah
עֵטָא	discretion
עֲטִין	sides
עֲטִישָׁה	sneezes
עֲטָרָה	Atarah
עַטרוֹת בֵּיתּ יוֹאָב	Atroth-beth-joab
עַטרוֹת שׁוֹפָן	Atroth-shophan
עֵילוֹם	ever
עִילַי	Ilai
עֵין הַקּוֹרֵא	En-hakkore
עֵין חַדָּה	En-haddah
עֵין חָצוֹר	En-hazor
עֵין חֲרוֹד	Harod
עֵין מִשׁפָּט	En-mishpat
עֵין עֶגלַיִם	Eneglaim
עֵין רִמּוֹן	En-rimmon
*** 7851 - 7900 (/course/1969831/strongs-numbers-biblical-hebrew/158/)	
עֵין תַּפּוַּח	En-tappuah
עָיֵף	weary
עִיר	Ir
עִיר הַמֶּלַח	Salt
עִירוּ	Iru
עִירִי	Iri
עִיר נָחָשׁ	Ir-nahash
עִיר שֶׁמֶשׁ	Ir-shemesh
עַכּוֹ	Acco
עָכַס	bangles
עָכָר	Achar
עַכשׁוּב	viper
עֵלָּא	over
עוּלָּא	Ulla
עִלֵּג	stammerers
עֲלָה	offering
עַלוָה	iniquity
עֲלוּקָה	leech
עָלֵז	jubilant
עֱלִי	pestle
עֲלִיל	furnace
עֲלִילִיָה	deed
עֲלִיצּוּת	exultation
עַלִּיתּ	chamber
עַלמוֹן	Almon
עַלמִי	Elamites
עָלַע	suck
עֲלַע	ribs
עוּלפֶּה	fainted
עֶמדָּה	support
עוּמָּה	Ummah
עַמִּיזָבָד	Ammizabad
עַמִּיחוּר	Ammihud
עֲמִיק	profound
עָמָל	Amal
עֲמַסיָה	Amasiah
עַמעָד	Amad
עוֹמֶק	depth
עֲמַר	wool
עֲמַשׁסַי	Amashsai
עֲנָה	poor
עָנוּב	Anub
עֱנוּת	affliction
עָנִים	Anim
עָנֵם	Anem
עֲנַמֶּלֶך	Anammelech
עֲנַן	clouds
עָנָן	Anan
עֲנָנָה	cloud
עֲנָנִי	Anani
*** 7901 - 7950 (/course/1969831/strongs-numbers-biblical-hebrew/159/)	
עָנֵף	branches
עֲנַשׁ	confiscation
עַנתּוֹתִיָה	Anthothijah
עָסַס	down
עֳפֶא	branch
עָפנִי	Ophni
עָפַר	threw
עֲצַב	troubled
עָצֵב	workers
עָצֶה	backbone
עֵצָה	trees
עָצַל	delay
עַצלוּת	idleness
עַצּוּמָה	strong
עֵצֶן	Eznite
עֶצֶר	ruler
עָקֵב	foes
עָקבָּה	cunning
עָקַד	bound
עָקָה	pressure
עָקַל	perverted
עֲקַלָּתוֹן	twisted
עָקָן	Akan
עֲקַר	roots
עֵקֶר	descendants
עֵקֶר	Eker
עָר	adversaries
עָרֵב	sweet
עֲרָד	donkeys
עָרָה	bulrushes
עָרוֹד	donkey
עַרוָה	dishonor
עָרוּץ	dreadful
עֵרִי	Erites
עָרִיף	clouds
עָרַם	piled
עוֹרֶם	shrewdness
עֵרָן	Eran
עֵרָנִי	Eranites
עַרעָר	destitute
עֲרוֹעֵרִי	Aroerite
עָשׁוֹק	oppressor
עָשׁוֹת	wrought
עַשׁוָת	Ashvath
עֲשִׂיאֵל	Asiel
עָשַׂק	contended
עֵשֶׂק	Esek
עֵשֶׁק	Eshek
עָשׁקָה	oppressed
עֶשׂרִין	120
*** 7951 - 8000 (/course/1969831/strongs-numbers-biblical-hebrew/160/)	
עֲשִׁת	planned
עֶשֶׁת	carved
עַשׁתּוּת	holds
עֶשׁתּוֹנָה	thoughts
עַשׁתְּרָתִי	Ashterathite
עַשׁתְּרוֹת קַרנַיִם	Ashteroth-karnaim
עָתוּד	ready
עִתּתִּי	readiness
עֲתִידּ	ready
עֲתָיָה	Athaiah
עָתִיק	choice
עֲתָך	Athach
עַתלַי	Athlai
עָתַם	burned
עָתנִי	Othni
עָתֵק	enduring
עֵת קָצִין	Eth-kazin
עֲתֶרֶת	abundance
פָּאָה	pieces
פַּג	figs
פְּדַהאֵל	Pedahel
פָּדַע	deliver
פּוּגָה	relief
פּוּטִיאֵל	Putiel
פּוּן	distracted
פּוּנִי	Punites
פּוּעָה	Puah
פּוּקָה	grief
פּוֹרָתָא	Poratha
פּוּתִי	Puthites
פָּזַז	refined
פַּחַד	thighs
פַּחדָּה	dread
פַּחֲזוּת	boasting
פָּחַח	trapped
פֶּחָר	potter's
פְּחֶתֶת	away
פַּטִּישׁ	coats
פִּי ־ בֶּסֶת	Pi-beseth
פֵּיָה פִּיָה	edge
פִּימָה	collops
פִּיק	knocking
פִּישׁוֹן	Pishon
פַּלּוּאִי	Palluites
פְּלַג	divided
פְּלַג	half
פְּלַגָּה	divisions
פְּלוּגָּה	divisions
פְּלָדָה	steel
פִּלדָּשׁ	Pildash
*** 8001 - 8050 (/course/1969831/strongs-numbers-biblical-hebrew/161/)	
פִּלחָא	Pilha
פָּלחָן	service
פַּלטִּי	Paltite
פִּלטַּי	Piltai
פְּלִילָה	decision
פְּלִילִי	judgment
פְּלִילִיָה	judgment
פָּלָל	Palal
פְּלַליָה	Pelaliah
פַּלמוֹנִי	certain
פָּלַץ	tremble
פֵּן	corner
פַּנַּג	cakes
פָּנַק	pampers
פָּסַג	through
פַּס דַּמִּים	Pasdammim
פִּסָּה	abundance
פָּסַך	Pasach
פָּסַס	disappear
פִּספָּה	Pispa
פָּעָה	groan
פְּעוּלְּתַי	Peullethai
פַּעֲרַי	Paarai
פְּצִירָה	charge
פְּצָלָה	stripes
פָּצַם	open
פִּצֵּץ	break
פְּקִדוּת	guard
פְּקַח ־ קוַֹח	freedom
פַּקּוּעָה	gourds
פָּרָא	fruitful
פִּראָם	Piram
פְּרוּדָה	seeds
פָּרָה	Parah
פָּרוַּח	Paruah
פַּרוַיִם	Parvaim
פָּרָז	throngs
פִּרחַח	brood
פָּרַט	improvise
פֶּרֶט	fruit
פַּרמַשׁתָּא	Parmashta
פַּרנַך	Parnach
פַּרסִי	Persian
פַּרסִי	Persian
פַּרעוֹה חָפרַע	Hophra
פִּרעָתוֹן	Pirathon
פַּרפַּר	Pharpar
פַּרצִּי	Perezites
פְּרָצִים	Perazim
פְּרַק	away
*** 8051 - 8100 (/course/1969831/strongs-numbers-biblical-hebrew/162/)	
פָּרָק	broth
פְּרַשׁ	translated
פֶּרֶשׁ	Peresh
פַּרשְׁדוֹן	refuse
פַּרשֵׁז	spreads
פַּרשַׁנדָּתָא	Parshandatha
פַּשׁ	extremity
פָּשַׁח	pieces
פָּשַׂע	step
פֶּשַׂע	step
פֵּשֶׁר	interpretation
פְּתוּאֵל	Pethuel
פֵּתַח	unfolding
פְּתִחָה	swords
פְּתִיגִּיל	clothes
פְּתַיוּת	naive
פְּתַלתּוֹל	crooked
פִּתוֹם	Pithom
פָּתַת	break
צַּאֲנָן	Zaanan
צּוֹבֵבָה	Zobebah
צְּבוּ	nothing
צָּבוַּע	speckled
צָּבַט	served
צִּביָא	Zibia
צִּבּוּר	heaps
צֶּבֶת	bundles
צְּדָא	truth
צִּדִּים	Ziddim
צִּדקָה	righteousness
צָּהַב	shiny
צָּהַר	oil
צָּוַח	joy
צּוּלָה	sea
צּוּרִיאֵל	Zuriel
צּוּת	burn
צִּחֶה	parched
צָּחַח	whiter
צְּחִיחָה	land
צְּחִיחִי	place
צַּחֲנָה	smell
צַּחצָּחָה	places
צַּחַר	white
צָּחוֹר	white
צַּיָד	hunter
צִּינוֹק	collar
צִּיעוֹר	Zior
צִּיצּ	Ziz
צִּיצָּה	flower
צָּיַר	envoys
*** 8101 - 8150 (/course/1969831/strongs-numbers-biblical-hebrew/163/)	
צְּלוּל	loaf
צֵּלָחָה	pans
צְּלוֹחִיתּ	jar
צָּלַל	sank
צְּלֶלפּוֹנִי	Hazzelelponi
צָּלָף	Zalaph
צֶּלצַּח	Zelzah
צִּמאָה	thirst
צָּמַק	dry
צָּנַם	withered
צְּנָן	Zenan
צְּנֵפָה	toss
צִּנצֶּנֶת	jar
צַּנתָּרָה	pipes
צָּעִיר	Zair
צְּעִירָה	youth
צָּעַן	folded
צַּעצּוַּע	sculptured
צָּפַד	shriveled
צָּפָה	discharge
צְּפוֹן	Zephon
צָּפוֹן	Zaphon
צְּפוֹנִי	northern
צְּפוֹנִי	Zephonites
צְּפוַּע	dung
צִּפיוֹן	Ziphion
צַּפִּיחִת	wafers
צּוֹפִים	Zophim
צָּפִין	treasure
צְּפִיר	male
צָּפנַת פַּענֵַח	Zaphenath-paneah
צְּפִעָה	issue
צַּפצָּפָה	willow
צָּפַר	depart
צְּפַת	Zephath
צֶּפֶת	capital
צְּפָתָה	Zephathah
צִּקלוֹן	sack
צֵּר	Zer
צָּרַב	burn
צְּרוּעָה	Zeruah
צְּרִי	Zeri
צּוֹרֶך	need
צּוֹרְפִי	goldsmiths
צְּרֵרָה	Zererah
צֶּרֶת	Zereth
צֶּרֶת הַשַּׁחַר	Zereth-shahar
קַב	kab
קֵבָה	body
קוֹבָה	belly
*** 8151 - 8200 (/course/1969831/strongs-numbers-biblical-hebrew/164/)	
קוּבָּה	tent
קִבּוּץ	collection
קְבוּצָה	gather
קִבצַּיִם	Kibzaim
קָדוּם	ancient
קַדמוֹן	eastern
קַדמוֹנִי	Kadmonite
קַדרוּת	blackness
קְדוֹרַנִּיתּ	mourning
קוֹמְמִיוּת	erect
קוַֹע	Koa
קוּץ	summer
קוֹשׁ	ensnare
קוּשָׁיָהוּ	Kushaiah
קַט	too
קוֹטֶב	destruction
קְטוֹרָה	incense
קָטַט	off
קֶטֶל	slaughter
קָטָן	Hakkatan
קָטַר	enclosed
קִטֵּר	sacrifices
קִטרוֹן	Kitron
קַטָּת	Kattah
קָיָה	spue
קַיִט	summer
קִים	adversaries
קִימָה	rising
קַיִן	spear
קִינָה	Kinah
קִיקָלוֹן	disgrace
קִישִׁי	Kishi
קָלַהּ	together
קָלַט	stunted
קַלַּי	Kallai
קֵלָיָה	Kelaiah
קַלָּסָה	mocking
קַלָּע	slingers
קְלוֹקֵל	miserable
קִלְּשׁוֹן	forks
קָמוֹן	Kamon
קִמָּשׁוֹן	thorn
קְנָא	buy
קֶנֶץ	hunt
קָסַס	off
קַעֲקַע	tattoo
קָפַד	rolled
קְפָדָה	anguish
קִפּוֹז	snake
קְצִיעָה	cassia
*** 8201 - 8250 (/course/1969831/strongs-numbers-biblical-hebrew/165/)	
קְצִיעָה	Keziah
קְצִיצּ	Emek-keziz
קְצַף	furious
קְצַף	wrath
קְצָפָה	splinters
קְצַץ	off
קוֹצֶר	despondency
קוֹר	cold
קְרָב	war
קָרֶה	emission
קְרִיאָה	proclamation
קִריַת חוּצוֹת	Kiriath-huzoth
קֶרֶן הַפּוּך	Keren-happuch
קֶרֶץ	horsefly
קַרקַע	Karka
קַרקוֹר	Karkor
קַרתָּה	Kartah
קַרתָּן	Kartan
קִשּׁוּא	cucumbers
קְשִׁי	stubbornness
קַשָּׁת	archer
רָאָה	glede
רוֹאֵה	Haroeh
רְאוּמָה	Reumah
רְאִי	mirror
רָאַם	rise
רוֹאשׁ	Rosh
רִאשָׁה	first
רוֹאשָׁה	top
רִאשׁוֹנִי	first
רַאֲשׁוֹת	bolster
רָבַד	spread
רַבִּיתּ	Rabbith
רֶבַע	down
רְגַז	provoked
רְגַז	rage
רַגָּז	trembling
רָגזָה	quivering
רֶגֶם	Regem
רִגמָה	throng
רֶגֶם מֶלֶך	Regemmelech
רָגֵַע	quiet
רָגַשׁ	uproar
רַדַּי	Raddai
רָהָב	proud
רוֹהָב	pride
רָהָה	afraid
רוֹהֲגָה	Rohgah
רוֹם	high
רוּמָה	Rumah
*** 8251 - 8300 (/course/1969831/strongs-numbers-biblical-hebrew/166/)	
רוֹמָה	haughtily
רוֹמָם	praises
רוֹמְמָה	high
רוּף	tremble
רוּר	run
רְזוֹן	Rezon
רָזוֹן	prince's
רָזַם	flash
רְחִיטּ	rafters
רַחִיק	away
רַחַם	Raham
רְחֵם	compassion
רַחֲמָה	damsel
רַחמָנִי	compassionate
רְחַץ	trust
רָחֵק	far
רָחַשׁ	overflows
רַחַת	shovel
רָטַב	wet
רָטוֹב	green
רֶטֶט	panic
רוּטֲפַשׁ	fresher
רִי	moisture
רֵיַח	smell
רוֹך	refinement
רִכבָּה	riding
רְכוּב	chariot
רָכָל	Racal
רֶכֶס	terrain
רוֹכֶס	conspiracies
רָמוֹת ־ נֶגֶב רָמַת נֶגֶב	Negev
רָמוּת	refuse
רַמִּי	Syrian
רַמיָה	Ramiah
רַמָּך	stud
רוֹמֵמוּת	lifting
רֶמֶת	Remeth
רָמַת הַמִּצפֶּה	Ramath-mizpeh
רָמָתִי	Ramathite
רָמָתַיִם צּוֹפִים	Ramathaim-zophim
רָמַת לֶחִי	Ramath-lehi
רוֹן	songs
רָנָה	rattles
רִנָּה	Rinnah
רֶנֶן	ostrich
רֶסֶן	Resen
רָסַס	moisten
רוֹעָה	broken
רְעִי	pasture-fed
רֵעִי	Rei
*** 8301 - 8350 (/course/1969831/strongs-numbers-biblical-hebrew/167/)	
רָעַל	brandished
רַעַל	reeling
רַעֲלָה	veils
רְעֵלָיָה	Reelaiah
רַעמָה	mane
רַעַמיָה	Raamiah
רַעמְסֵס רַעַמסֵס	flourishing
רִפאוּת	healing
רְפָאֵל	Rephael
רָפוּא	Raphu
רֶפַח	Rephah
רְפִידָּה	back
רִפיוֹן	limpness
רַפסוֹדָה	rafts
רָפַק	lean
רֶפֶשׁ	refuse
רֶפֶת	stalls
רַץ	pieces
רָצָא	ran
רָצַד	envy
רִציָא	Rizia
רָצַע	pierce
רָצַף	fitted
רֶצֶף	coal
רִקָּבוֹן	rotten
רַקּוֹן	Rakkon
רֶקַח	spiced
רַקָּח	perfumers
רַקּוַּח	perfumes
רַקָּחָה	perfumers
רִקּוַּע	hammered
רָקַק	spits
רַקַּת	Rakkath
רִשׁיוֹן	permission
רָשַׁם	inscribed
רֶשֶׁף	Resheph
רַתּתּוֹק	chain
רֶתַח	vigorously
רַתּתִּיקָה	chain
רָתַם	harness
רָתַק	bound
רְתוּקָה	chains
רְתֵת	trembling
שָׁאָה	gazing
שַׁאֲוָה	storm
שָׁאוּלִי	Shaulites
שְׁאִיָה	ruins
שְׁאָל	Sheal
שְׁאֵלָא	decision
שְׁאַלתִּיאֵל	Shealtiel
*** 8351 - 8400 (/course/1969831/strongs-numbers-biblical-hebrew/168/)	
שָׁאַס	spoil
שַׁאֲרָה	kinswomen
שֶׁאֱרָה	Sheerah
שְׁאָר יָשׁוּב	Shear-jashub
שֵׁאתּ	devastation
שְׁבָאִי	Sabeans
שָׁבָב	pieces
שְׁבַט	tribes
שְׁבָט	Shebat
שׁוֹבִי	Shobi
שָׁבִיבּ	flame
שָׁביָה	captives
שָׁבִיס	headbands
שָׂבָך	net
שׁוֹבֶל	skirt
שַׁבלוּל	snail
שִׂבעָה	fulness
שִׁבעָה	Shibah
שִׁבעָנָה	seven
שָׁבָץ	agony
שֶׁבֶר	Sheber
שְׁבָרִים	Shebarim
שְׁבַשׁ	perplexed
שָׁגֵא	Shagee
שְׁגִיאָה	errors
שְׁדַר	exerting
שַׁדרַך	Shadrach
שָׂהֵד	advocate
שׁוֹהַם	Shoham
שׂוֹא	arise
שׁוּבָה	repentance
שׂוֹבֶך	branches
שׁוֹבֵק	Shobek
שׂוּג	back
שׂוּג	grow
שׁוּד	waste
שָׁוָה	substance
שׂוַּח	meditate
שׁוּחָה	Shuhah
שׁוּחָם	Shuham
שׂוּכָתִי	Sucathites
שׁוּם	garlic
שׁוּנִי	Shunites
שׁוַֹע	Shoa
שֶׁוַע	help
שׁוּפָמִי	Shuphamites
שׂוּר	cut
שׁוּר	foes
שׂוֹרָה	principal
שׂוֹרֵק	Sorek
*** 8401 - 8450 (/course/1969831/strongs-numbers-biblical-hebrew/169/)	
שַׁושָׁא	Shavsha
שׁוּשַׁנכִּי	Susa
שַׁח	person
שֵַׂח	thoughts
שָׂחוּ	swim
שְׁחוֹר	soot
שְׁחוּת	pit
שָׂחַט	squeezed
שְׁחִיטָּה	killing
שָׁחִיף	paneled
שְׁחֵלֶת	onycha
שַׁחֲצוֹם	Shahazumah
שָׁחַר	black
שַׁחֲרוּת	life
שְׁחַרחוֹרֶת	swarthy
שְׁחַריָה	Shehariah
שַׁחֲרַיִם	Shaharaim
שֵׂט סֵט	revolters
שׁוֹטֵט	whip
שִׂטנָה	accusation
שִׂטנָה	Sitnah
שְׁטַר	side
שִׁטרַי	Shitrai
שִׂיא	loftiness
שִׂיאוֹן	Sion
שִׁיאוֹן	Shion
שֵׂיבּ	age
שִׁיבָּה	captivity
שִׁיבָּה	stayed
שִׂיגּ	pursuing
שָׁיָה	neglected
שִׁיזָא	Shiza
שִׁיחוֹר לִבֶנָת	Shihor-libnath
שִׁילוֹה	Shiloh
שִׁימוֹן	Shimon
שַׁיִשׁ	alabaster
שִׁישָׁא	Shisha
שֵׂך	pricks
שׂוֹך	tabernacle
שָׁכָה	lusty
שׂוּכָּה	harpoons
שֵׂכוּ	Secu
שֶׂכוִי	mind
שָׁכֵַח	forget
שְׂכִיָה	picture
שַׂכִּין	knife
שְׂכִירָה	hired
שְׂכַל	contemplating
שִׁכּוּלִים	bereaved
שִׁכמָה	blade
*** 8451 - 8500 (/course/1969831/strongs-numbers-biblical-hebrew/170/)	
שִׁכמִי	Shechemites
שֶׁכֶן	habitation
שִׁכְּרוֹן	Shikkeron
שַׁל	irreverence
שַׁלאֲנָן	ease
שָׁלַג	snowing
שָׁלָה	requires
שְׁלָה	ease
שָׁלָה	amiss
שֶׁלֶו	prosperity
שְׁלֵוָה	prosperity
שַׁלוּן	Shallum
שִׁלּוּחָה	tendrils
שִׁלחִים	Shilhim
שַׁלֶּטֶת	imperious
שְׁלִי	privately
שִׁליָה	afterbirth
שַׁלֶּכֶת	felled
שַׁלֶּכֶת	Shallecheth
שִׁלֵּם	retribution
שַׂלמָה	Salmon
שִׁלּוּמָה	recompense
שַׂלמוֹן	Salmon
שְׁלוֹמִי	Shelomi
שִׁלֵּמִי	Shillemites
שַׁלמַן	Shalman
שַׁלמוֹן	rewards
שִׁלוֹנִי	Shiloni
שֵׁלָנִי	Shelanites
שֶׁלֶשׁ	Shelesh
שִׁלשָׁה	Shilshah
שָׁלִשָׁה	Shalishah
שֶׁמאֵבֶר	Shemeber
שִׁמאָה	Shimeah
שִׁמאָם	Shimeam
שְׁמַד	consume
שַׁמהוּת	Shamhuth
שָׁמוּר	Shamir
שַׁמּוֹת	Shammoth
שְׁמִידָּעִי	Shemidaites
שְׂמִיכָּה	rug
שְׁמַם	appalled
שְׂמָמִיתּ	lizard
שְׁמָע	Shema
שָׁמָע	Shama
שְׁמָעָה	Shemaah
שִׁמעָתִי	Shimeathites
שִׁמצָּה	derision
שָׁמרָה	guard
שְׁמוּרָה	eyelids
*** 8501 - 8550 (/course/1969831/strongs-numbers-biblical-hebrew/171/)	
שִׁמרוֹן מְראוֹן	Shimron-meron
שִׁמרִיתּ	Shimrith
שִׁמרוֹנִי	Shimronites
שׁוֹמְרוֹנִי	Samaria
שִׁמרָת	Shimrath
שְׁמַשׁ	attending
שֶׁמֶשׁ	sunset
שַׁמשְׁרַי	Shamsherai
שׁוּמָתִי	Shumathites
שֵׁן	Shen
שְׂנֵא	hate
שִׁנאָב	Shinab
שִׁנאָן	thousands
שֶׁנאַצַּר	Shenazzar
שְׁנָה	sleep
שָׂנִיא	unloved
שָׁנַס	girded
שְׁנָת	sleep
שָׁסַף	pieces
שַׁעֲטָה	galloping
שָׂעִיר	droplets
שְׂעִירָה	Seirah
שַׁעֲלִים	Shaalim
שָׁעַר	thinks
שַׁעַר	hundredfold
שׁוֹעָר	split-open
שְׂעוֹרִים	Seorim
שַׁעַשׁגַּז	Shaashgaz
שָׁפָה	bare
שָׁפָה	cheese
שְׁפַט	magistrates
שִׁפטָּן	Shiphtan
שְׁפִיפוֹן	snake
שָׁפִיר	Shaphir
שָׁפכָּה	organ
שְׁפַל	lowliest
שִׁפלָה	utterly
שִׁפלוּת	slackness
שָׁפָם	Shapham
שִׂפמוֹת	Siphmoth
שִׁפמִי	Shiphmite
שָׂפַן	treasure
שֶׁפַע	abundance
שִׁפעִי	Shiphi
שָׁפַר	goodly
שֶׁפֶר	beautiful
שִׁפרָה	cleared
שִׁפרָה	Shiphrah
שַׁפרוּר	canopy
שְׁפַרפַר	dawn
*** 8551 - 8600 (/course/1969831/strongs-numbers-biblical-hebrew/172/)	
שֶׁצֶף	little
שָׁק	legs
שָׂקַד	bound
שִׁקּוּו	drink
שֶׁקֶט	quiet
שְׁקַערוּרָה	depressions
שֶׁקֶף	frames
שָׂקַר	seductive
שָׂרַד	remained
שֶׂרֶד	chalk
שָׁרָה	wall
שֵׁרָה	bracelets
שָׁרוּחֶן	Sharuhen
שָׁרוֹנִי	Sharonite
שָׂרוּק	clusters
שָׁרַי	Sharai
שְׂרִיקָה	combed
שָׁרִיר	muscles
שָׂרַך	entangling
שְׁרֵמָה	field
שַׂרסְכִים	sarsechim
שָׂרָף	Saraph
שָׂרוּק	sorrel
שׁוֹרֶר	navel
שֶׁרֶשׁ	Sheresh
שַׁרשָׁה	chain
שְׁרוֹשׁוּ	banishment
שָׁשָׁא	drive
שָׁשָׁה	sixth
שָׁשַׁי	Shashai
שֵׁת	buttocks
שְׁתִי	drunkenness
שְׁתִיָה	drinking
שְׁתִיל	plants
שׁוּתַלחִי	Shuthelahites
שָׂתַר	broke
שֵׁתָר	Shethar
תָּאַב	loathe
תַּאֲבָה	longing
תַּאֲוָה	bound
תַּאֲלָה	curse
תְּאוּן	toil
תַּאֲנַת שִׁלוֹה	Taanath-shiloh
תַּאֲרֵַע	Tarea
תְּבוּסָה	destruction
תַּבלִיתּ	destruction
תְּבַלּוּל	defect
תְּבַר	brittle
תַּגמוּל	benefits
תִּגרָה	opposition
*** 8601 - 8650 (/course/1969831/strongs-numbers-biblical-hebrew/173/)	
תָּהֳלָה	error
תַּהֲלוּכָה	proceeding
תָּוָה	pained
תְּוַהּ	astounded
תּוַֹח	Toah
תּוֹלָד	Tolad
תּוּלוֹן	Tilon
תּוֹלָל	tormentors
תּוֹלָעִי	Tolaites
תּוֹקַהַת	Tokhath
תּוֹר	border
תּוֹרָה	law
תּוֹתָח	clubs
תָּזַז	away
תּוֹחוּ	Tohu
תַּחכְּמוֹנִי	Tahchemonite
תַּחֲנָה	camp
תְּחִנָּה	Tehinnah
תַּחֲנִי	Tahanites
תַּחרֵַע	Tahrea
תַּחַשׁ	Tahash
תַּחַת	as
תַּחתִּים חָדשִׁי	Tahtim-hodshi
תֵּימְנִי	Temeni
תִּיצִּי	Tizite
תִּירְיָא	Tiria
תָּכָה	followed
תְּכוּנָה	seat
תָּכָך	deceitful
תִּכלָה	perfection
תּוֹכֶן	Tochen
תַּכרִיכּ	garment
תֵּל אָבִיבּ	Tel-abib
תַּלאוּבָה	drought
תַּלבּוֹשֶׁת	clothing
תְּלַג	snow
תֶּלַח	Telah
תְּלִי	quiver
תָּלַל	deceived
תַּלמִידּ	pupil
תָּלַע	scarlet
תַּלפִּיָה	stones
תַּלתַּל	dates
תַּמּוּז	Tammuz
תִּמנִי	Timnite
תֶּמֶס	away
תַּמרוּר	guideposts
תִּניָן	second
תִּניָנוּת	time
תַּעֲנִיתּ	humiliation
*** 8651 - 8674 (/course/1969831/strongs-numbers-biblical-hebrew/174/)	
תַּעֲצוּמָה	power
תְּפוֹצָה	dispersion
תּוּפִין	baked
תּוֹפֶל	Tophel
תִּפלֶצֶת	terror
תּוֹפֶת	spit
תָּפתֶּה	Topheth
תְּקוּמָה	stand
תְּקוֹמֵם	against
תָּקוַֹע	trumpet
תְּקַן	reestablished
תֵּקַע	sound
תַּראֲלָה	Taralah
תִּרגַּם	translated
תְּרוּמִיָה	allotment
תְּרוּפָה	healing
תִּרזָה	cypress
תִּרחֲנָה	Tirhanah
תָּרָע	doorkeepers
תִּרעָתִי	Tirathites
תַּרתָּק	Tartak
תַּשׁבֵּץ	work
תְּשׂוּמֶת	security
תְּשׁוּרָה	present
