*** October 2016 (/course/1337896/misc-russian-vocab/1/)	
перево́дчик	translator
змея́	snake
по́езд	train
ковёр	carpet
что́-то	something
тури́зм	tourism
кто́-то	someone
кто́-нибуд	anyone
что́-нибуд	anything
*** November 2016 (/course/1337896/misc-russian-vocab/2/)	
благодаре́ние	thanksgiving
оста́ться	"to stay, remain"
отче́ство	patronymic
мел	chalk
флома́стер	dry erase marker
ру́чка	pen (writing)
каранда́ш	pencil
чу́до	miracle
кру́то	cool (lit: steeply)
здо́рово	cool (lit: healthily)
ры́нок	(farmer's) market
*** December 2016 (/course/1337896/misc-russian-vocab/3/)	
звезда́	star
голо́дный	hungry
па́хнуть	to smell
за́пах	"smell, scent, odor"
фасо́ль	(green) bean
боб	bean
*** January 2017 (/course/1337896/misc-russian-vocab/4/)	
живо́тное	animal
воспита́ть	to raise (a child)
посеща́ть	to visit
отмеча́ть	to celebrate
гама́к	hammock
одеколо́н	(eau de) cologne
беко́н	bacon
нового́дний	New Year's
заро́к	resolution
Сре́дний Восто́к	The Middle East
барда́к	mess
мо́лния	lightning
потёмки	darkness
партнёр	partner
слог	syllable
ударе́ние	stress
че́реп	skull
сюрпри́з	suprise
оде́жда	clothing
весло́	"oar, paddle"
кра́сить	to paint (something)
лову́шка	trap
осторо́жный	careful (adj.)
кенгуру́	kangaroo
ва́фля	waffle
дру́жба	friendship
сту́лья	chairs
цвета́	colors
свитера́	sweaters
по́вар	cook
повара́	cooks
адреса́	address
учителя́	teachers
здоро́вый	healthy
двойни́к	doppelganger
уда́ча	"luck, success"
*** February 2017 (/course/1337896/misc-russian-vocab/5/)	
мёртвый	dead (adj.)
смерть	death
причи́на	"reason, cause"
плати́ть	to pay
ту́фля	shoe
ты́ква	"pumpkin, squash, gourd"
перево́зка	"shipping, transport"
мышь	mouse
сообщи́ть	to message
зано́с	snowdrift
шу́тка	joke
брак	marriage
обяза́тельство	commitment
на́сморк	(common) cold
выступле́ние	performance
спя́чка	sleepiness
нау́шники (pl.)	earphones
экра́н	(electronic) screen
отлича́ться	to excel; to differ
подде́рживать/поддержа́ть	to support
ортодокса́льный	Orthodox (adj.)
правосла́вие	orthodoxy
рели́гия 	religion
*** March 2017 (/course/1337896/misc-russian-vocab/6/)	
кла́виша	key (on keyboard)
наде́жда	hope
зашифрова́ть	to encode
руль	streering wheel
пусто́й	empty
ме́длить	to stall
испо́лнить*	to fulfill
кно́пка	button
осуществи́ться	to come true
стреми́ться	to strive
ве́ра	"faith, belief"
повторя́ть/повтори́ть	to repeat
мне хочется...	I feel like...
кошма́р	nightmare
вани́льный	vanilla (flavored)
марафо́н	marathon
случа́йно	accidentally
пешко́м	on foot
не стоит	it isn't worth (it)
не стояло	it wasn't worth (it)
*** April 2017 (/course/1337896/misc-russian-vocab/7/)	
босоно́жки	sandals
верблю́д	camel
соблюда́ть	to respect (the law)
моли́тва	prayer
доро́жка	(walking) trail
громкоговорящие	loudspeaker
устро́йство	device
*** May 2017 (/course/1337896/misc-russian-vocab/8/)	
обручённый	engaged
тума́н	fog
искуше́ние	temptation
*** June 2017 (/course/1337896/misc-russian-vocab/9/)	
сала́зки	sleigh
глота́ть	"to gulp, gobble"
жа́реный	"fried, roasted"
проро́к	prophet
жа́ловаться	to complain
зло	evil
жесто́кость	cruelty
наказа́ние	punishment
наси́лие	violence
спасти́	to save
беззако́ние	injustice
страда́ние	hardship
разруше́ние	destruction
рознь	strife
разла́д	disagreement
справедли́вость	fairness
нечестивый	unholy
верх	"front, face"
про́чный	vicious
суд	court (of law)
кра́йний	extreme (adj.)
изуми́ть	to astound
соверши́ть	to perform
неи́стовый	"furious, frenetic"
свире́пый	bloodthirsty
отнима́ть	to steal
жили́ще	(a) dwelling
гро́зный	fearsome
возвели́чивать	to extol
барс	leopard
тьма	darkness
ко́нница	cavalry
мча́ться	to rush
опо́ра	support
орёл	eagle
добы́ча	prey
грабёж	"robbery, heist"
по́лчище	horde
зно́йный	"torrid, scorching"
вихрь	"maelstrom, whirl, gale"
пле́нник	captive
издева́ться	to scoff
повели́тель 	overlord
кре́пость	fortress
насы́пать	to pour
престу́пный 	"criminal (adj.), blameworthy"
и́здревле	"anciently, of old"
веле́ть	"to order, command"
пригово́р	judgment
скала́	rock
кара́ть	"to punish, chastise"
вероло́мный	"faithless, treacherous"
поглоща́ть	"to engulf, devour, absorb"
уподо́бить	to compare
вытя́гивать	"to pull, draw, extract"
крюк	hook
не́вод	trawl (net)
весели́ться	to make merry
торже́ствовать	to triumph
благово́ние	frankincense
жи́рный	fatty
роско́шный	luxurious
засто́лье	feast
опорожня́ть	to empty
жа́лость	pity
истребля́ть	to massacre
стра́жа	guard
открове́ние	revelation
табли́чка	tablet
повсю́ду	everywhere
ве́стник	herald
обману́ть	"to deceive, cheat"
надме́нный	"haughty, arrogant"
ве́рность	faithfulness
горде́ц	bighead
ненасы́тный	"gluttonous, insatiable"
пле́мя	tribe
глуми́ться	to sneer
погово́рка	"saying, proverb"
го́ре	woe
трепета́ть	"to tremble, flutter"
заста́вить	"to force, compel"
заимода́вец	"creditor, lender"
огра́бить	"to rob, loot"
жи́тель	"resident, inhabitant"
гнездо́	nest
ко́готь	"claw, talon"
опозо́рить	"to embarrass, dishonor"
ба́лка	"rafter, girder"
напра́сно	"needlessly, in vain"
бу́рдюк	water-skin
бесче́стье	"disgrace, infamy"
сы́тый	"full (of eating), satiated"
дойти́	"to come, arrive"
позо́р	"shame, ignominy"
затми́ть	"to overshadow, eclipse"
злоде́йство	atrocity
зверь	beast
и́дол	idol
реме́сленник	"craftsman, artisan"
лито́й	"cast, molded"
ста́туя	statue
ложь	"lie, bluff"
оживи́ть	"to revive, animate"
безмо́лвный	"mute, silent"
серебро́	silver
храм	temple (building)
гнев	"rage, wrath"
ми́лостивый	"gracious, merciful"
скры́тый	"concealed, hidden"
боле́знь	disease
ве́чный	eternal
холм	hill
шатёр	tent
прогне́ваться	"to be incensed, angry"
победоно́сный	victorious
колесни́ца	chariot
обнажи́ть	"to expose, reveal, bare"
колча́н	quiver
стрела́	"arrow, dart"
бе́здна 	"abyss, chasm"
блеск	"brightness, splendor"
пята́	"heel, base"
завоева́тель	conqueror
инжи́р	fig (tree)
лоза́	"vine, rod, stick"
заго́н	"pen, stall"
вол	"ox, bullock"
влады́ка	"master, lord"
лань	"deer, hind"
*** July 2017 (/course/1337896/misc-russian-vocab/10/)	
каре́та	carriage
ёж	hedgehog
морско́й ёж	sea urchin
*** August 2017 (/course/1337896/misc-russian-vocab/11/)	
одушевлённый	animate (ling.)
неодушевлённый 	inanimate (ling.)
склоня́ть	to decline (ling.)
мука́	flour
му́ка	"anguish, torture"
флажо́к	pennant
зна́мя	"flag, streamer"
вы́мя	udder
те́мя	tonsure
пла́мя	flame
у́мница	genius
обуче́ние	"instruction, training"
учёба	"studies, learning"
учи́лище	educational institution
заведе́ние	"facility, spot"
вуз	university
вла́жный	humid
у́тка	duck
тигр	tiger
слон	elephant
пра́здновать	to celebrate
зубри́ть	to cram
предпочита́ть	to prefer
я́дерный	nuclear (adj.)
нефть	(crude) oil
скупо́й	stingy
СМИ	mass media
зе́ркало	mirror
стричь	to cut (hair)
и́стинный	"true, actual"
суеве́рие	superstition
предзнаменова́ние	omen
портно́й 	tailor
программи́рование	programming
вари́ть	to boil (food)
благодаря́	thanks to (prep.)
обогатить	to enrich
разви́ть	to develop
зада́ча	(math) problem
изучи́ть	to master (a subject)
заня́ться	to take up (an activity)
го́рдый	proud
*** September 2017 (/course/1337896/misc-russian-vocab/12/)	
байда́рка	"kayak, canoe"
вертолёт	helicopter
электри́чка	short-distance train
автосто́п	hitch-hiking
железнодоро́га	railroad
купе́	compartment
маршру́т	"route, itinerary"
перро́н	(train) platform
шоссе́	highway
авиакомпа́ния	airline
взлёт 	take-off
поса́дка	"boarding, landing"
экипа́ж	crew
га́вань	"harbor, marina"
при́стань	"pier, wharf"
грести́	"to paddle, row"
жечь	to burn
неоднонаправленный	multidirectional
однонаправленный	unidirectional
броди́ть	"to wander, roam, stray"
таска́ть	to drag
ката́ть	to roll
по́лзать	to crawl
гоня́ть	to chase
пар	steam
лу́жа	puddle
го́нка	race
стю́ард	steward
приземля́ться	to (come in to) land
ро́дственник	relative (family member)
яд	"poison, venom"
сбор	"collection, gathering"
собо́р	cathedral
грузови́к	truck
гастроно́м	grocery store
па́мятник	"monument, memorial"
ди́кий	"wild, crazy"
бродя́га	wanderer
рыть	to dig
тюрьма́	"prison, jail"
расстила́ться	to be spread out
сыро́й	"damp, raw"
кандалы́	"chains, shackles"
*** October 2017 (/course/1337896/misc-russian-vocab/13/)	
изба́	cottage
ками́н	fireplace
ло́джия	"balcony, terrace"
перегоро́дка	"partition, wall"
подва́л	"cellar, basement"
прихо́жая/пере́дняя	"entry, foyer"
сану́зел	bathroom
спáльня	bedroom
чердáк	"attic, loft"
чулáн	"closet, pantry"
ве́шалка	(coat) hanger
комóд	dresser
нáволочка	pillowcase
одея́ло	"blanket, cover"
подýшка	pillow
простыня́	(bed)sheet
скáтерть	tablecloth
сунду́к	"chest, box"
ту́мбочка	"nightstand, end table"
вентиля́тор	fan
водопровóд	plumbing
коло́дец	(water) well
пылесо́с	vacuum (cleaner)
посудомóйка	dishwasher
рáковина	(kitchen) sink
суши́лка	dryer
умыва́льник	washbowl
унита́з	restroom (facility)
блю́дце	saucer
бока́л	goblet
кувши́н	"pitcher, jug"
кру́жка	mug
мéльница для перцá	pepper mill
ми́ска	"bowl, dish"
нáбор (чего)	set (of)
поднóс	"tray, platter"
аре́нда	"rent, lease"
комфóртный	comfortable
недви́жимость	"real estate, property"
просто́рный	"spacious, roomy"
ремо́нт	"repair, renovation"
ую́тный	"cozy, homely"
вселя́ться	to move in
выселя́ться	to move out
му́сор	"garbage, trash"
бельё	linen
меня́ть	"to change, exchange"
накрыва́ть	to cover
подмета́ть	to sweep
*** November 2017 (/course/1337896/misc-russian-vocab/14/)	
грýша	pear
ежеви́ка	blackberry (bush)
клубни́ка	strawberry (plant)
клю́ква	cranberry
черéшня	raspberry
баклажáн	eggplant
горо́х	peas
спа́ржа	asparagus
чесно́к	garlic
шпинáт	spinach
теля́тина	veal
ягня́тина	lamb (meat)
осётр	sturgeon (m.)
хрен	horseradish
лапшá	noodles
оли́вка/масли́на	olive
ухá	"chowder, fish soup"
щи	cabbage soup
пельмéни	dumplings
вéнчик	"whisk, beater"
дуршлáг	colander
кастрю́ля	(cooking) pot
лопа́тка	spatula
поло́вник	ladle
сковородá	(frying) pan
тёрка	grater
щипцы́	tongs
