*** Chapter 1 (/course/1296376/troika-all-vocab/1/)	
"актёр, актри́са"	"actor, actress"
арти́ст/ка	artist
астронáвт	astronaut
балери́на	ballerina
баскетболи́ст/ка	basketball player
господи́н	Mr.
госпожá	Ms.
дéти	children
доктор	doctor (in titles)
компози́тор	composer
космонáвт	cosmonaut
пиани́ст/ка	pianist
писáтель (m.)	writer
поэ́т	poet
президéнт	president
профéссор	professor
спортсмéн/ка	athlete
студéнт/ка	student
танцóр	dancer
тенниси́ст/ка	tennis player
тури́ст/ка	tourist
футболи́ст/ка	soccer player
хоккеи́ст/ка	hockey player
шахмати́ст/ка	chess player
америкáнский	American (adj.)
англи́йский	English (adj.)
канáдский	Canadian (adj.)
ру́сский	Russian (m. adj.)
известный	famous
неплохóй	not bad
плохóй	bad
"хорóший, -ая, -ее"	good
как	how
неплóхо	not badly
отли́чно	excellent
óчень	very
плóхо	badly
хорошó	well
меня́	me
тебя́	you (acc.)
егó	him
её	her
нас	us
вас	y'all (acc.)
их	them
кто	who
э́то	this is
а	"and, but"
да	yes
и	and
и́ли	or
не	not (negative within a sentence)
нет	no
спаси́бо	thank you
тóже	also
здрáвствуй/те	hello
привéт	hi
Пока	goodbye
*** Chapter 2 (/course/1296376/troika-all-vocab/2/)	
бáбушка	grandmother
брат	brother
внук	grandson
вну́чка	granddaughter
дéдушка	grandfather
дéти	children
дочь	daughter
дя́дя	uncle
женá	wife
мáма	mom
мать	mother
муж	husband
отéц	father
пáпа	dad
роди́тели	parents
семья́	family
сестрá	sister
сын	son
тётя	aunt
америкáнец	American (n.) (m.)
америкáнка	American (n.) (f.)
канáдец	Canadian (n.) (m.)
канáдка	Canadian (n.) (f.)
ру́сский	Russian (m. adj.)
ру́сская	Russian (f. adj.)
дéвушка	girl
друг	friend (m.)
подру́га	friend (f.)
преподавáтель	teacher (college level)
фотогрáфия	photograph
краси́вый	beautiful
молодóй	young
симпати́чный	nice (looking)
по-англи́йски	in English
по-испáнски	in Spanish
по-китáйски	in Chinese
по-немéтски	in German
по-ру́сски	in Russian
по-францу́зски	in French
по-япóнски	in Japanese
немнóго	a little
плóхо	badly
неплóхо	not badly
свобóдно	fluently
хорошó	well
нехорошó	not well
чуть-чуть	just a little
я	I
ты	you
он	he
онá	she
мы	we
вы	y'all
они́	they
"мой, моя́, моё"	my
"твой, твоя́, твоё"	your
егó	his
её	her
"наш, нáша, нáше"	our
"ваш, вáша, вáше"	y'all's
их	their
говори́ть (II)	to speak
ду́мать (I)	to think
знать (I)	to know
понимáть (I)	to understand
слу́шать (I)	to listen
читá|ть (I)	to read
бы́стро	fast
дóма	at home
ещё	still
и	and
интерéсно	interesting (adv.)
конéчно	of course
мéдленно	slowly
но	but
Ну что ты!	"Oh, come on!"
тáкже	"also, in addition"
тóлько	only
что	that
*** Chapter 3 (/course/1296376/troika-all-vocab/3/)	
газéта	newspaper
журнáл	magazine
кни́га	book
письмó	letter
ромáн	novel
словáрь (m.)	dictionary
учéбник	textbook
видеокáмера	videocamera
домáшний кинотеáтр	home theater
компью́тер	computer
моби́льник	cell phone
ноутбу́к	laptop
плéер	player
при́нтер	printer
рáдио	radio
стереосистéма	stereo system
телеви́зор	television
телефóн	telephone
фотоаппарáт	camera
велосипéд	bicycle
маши́на	car
мотоци́кл	motorcycle
кóшка	cat
лóшадь	horse
собáка	dog
войнá	war
вопрóс	question
дéвушка	girl
дéти	children
мир	peace
прáвда	truth
ребёнок (gen. ребёнка)	child
счáстье (щастье)	happiness
англи́йский	English
испáнский	Spanish
италья́нский	Italian
канáдский	Canadian (adj.)
китáйский	Chinese
мексикáнский	Mexican
немéцкий	German
францу́зский	French
япóнский	Japanese
бéлый	white
голубóй	light blue
жёлтый	yellow
зелёный	green
кои́чневый	brown
крáсный	red
орáнжевый	orange
рóзовый	pink
сéрый	gray
"си́ний, -яя, -ее"	blue
фиолéтовый	purple
чёрный	black
большóй	"big, large"
дешёвый	cheap
дорогóй	expensive (adj.)
еди́нственный	only
интерéсный	interesting (adj.)
какóй	"what, what kind"
краси́вый	beautiful
мáленький	"little, small"
млáдший	"younger, youngest (adj.)"
нóвый	new
ску́чный	"boring, dull (adj.)"
стáрый	old
"хорóший, -ая, -ее"	good
"чей, чья, чьё"	whose
есть	there is
лю́бить (II)	"to like, love"
купи́ть (II)	to buy (pf.)
хотéть	to want
ещё не	not yet
женáт	married (of a man)
зáмужем	married (of a woman)
мóжет быть	"maybe, perhaps"
отвéтьте на вопрóсы	answer the questions
по-мóему	in my opinion
"я соглáсен, -на"	I agree
у меня́ есть	I have
что	what
что такóе	what is
*** Chapter 4 (/course/1296376/troika-all-vocab/4/)	
аптéка	drugstore
банк	bank
библиотéка	library
больни́ца	hospital
гóрод	city
гости́ница	hotel
дом	house
здáние	building
кафé	cafe
кинотеáтр	movie theater
магази́н	store
метрó	subway
музéй	museum
парк	park
плóщадь (f.)	square
пóчта	post office
проспéкт	avenue
ресторáн	restaurant
сад (на саду)	garden
стади́он	stadium
теáтр	theater
у́лица	street
универмáг	department store
университéт	university
цéрковь (f.)	church
шкóла	school
балкóн	balcony
вáнная	bathroom
гарáж	garage
гости́ная	living room
дáча	"dacha, summer house"
дверь	door
дéтская	children's room
кабинéт	office
кварти́ра	apartment
кóмната	room
коридóр	corridor
ку́хня	kitchen
общежи́тие	residence hall
окнó	window
пол	floor
потолóк	ceiling
спáльня	bedroom
стенá	wall
столóвая	dining room
туалéт	toilet
этáж	"floor, level"
дивáн	sofa
икóна	icon
карти́на	painting
ковёр	rug
крéсло	armchair
кровáть	bed
лáмпа	lamp
плакáт	poster
пóлка	shelf
стол	table
стул	chair
шкаф (в шкафу)	cabinet
пи́сьменный	writing (adj.)
пи́сьменный стол	writing desk
кни́жный	book (adj.)
кни́жный шкаф	bookcase
кни́жная пóлка	bookshelf
онó	it
"тот, та, то"	that
те	those
"э́тот, э́та, э́то"	this
э́ти	these
бли́зко	near
где	where
далекó	far
здесь	here
налéво	to the left
напрáво	to the right
потóм	then
пря́мо	straight ahead
слéва	on the left
спрáва	on the right
там	there
в	"in, at"
на	"on, at"
виси́т	is hanging
вися́т	are hanging
жить (I)	to live
лежи́т	is lying
назывáется	is called
нахóдится	is located
стои́т	is standing
иди́те	go!
извини́те	excuse me!
пожáлуйста	"please, you're welcome"
скажи́те	"say!, tell!"
*** Chapter 5 (/course/1296376/troika-all-vocab/5/)	
горá	mountain
гóрод	city
зали́в	gulf
кáрта	map
континéнт	continent
мир	world
мóре	sea
óзеро	lake
океáн	ocean
óстров	island
полуóстров	peninsula
рекá	river
песпу́блика	republic
столи́ца	capital
странá	country
штат	state
востóк	east
зáпад	west
сéвер	north
юг	south
бéрег (на верегу́)	coast
вóздух	air
"год, гóда, лет"	"year, years"
дерéвня	"countryside, village"
жизнь (f.)	life
кли́мат	climate
клуб	club
лес	forest
лю́ди (pl.)	people
мнéние	opinion
тишинá	"quiet, silence"
факт	fact
аркти́ческий	arctic
бы́вший	former
востóчный	eastern
высóкий	tall
глубóкий	deep
дли́нный	long
зáпадный	western
корóткий	short (adj.)
ни́зкий	low (adj.)
сáмый	the most
сéверный	northern
субтропи́ческий	subtropical
чи́стый	clean (adj.)
ю́жный	southern
бóльше	"bigger, more"
вы́ше	"higher, taller (comp.)"
длиннéе	longer
глу́бже	deeper
интерéснее	more interesting
краси́вее	more beautiful
лу́чше	better
мéньше	"smaller, less"
ни́же	lower (comp.)
"старéе, стáрше (comp. of staryi)"	older (comp.)
давнó	for a long time
почему́	why
потому́ что	because
скóлько	"how much, how many"
спокóйно	(it is) peaceful
тепéрь	now
ужé	already
о	about
жить (I)	to live
Азия	Asia
Амéрика	America
Балти́йское мóре	Baltic Sea
Кавкáз	Caucasus
Кавкáзские гóры	Caucasus Mountains
Каспи́йское мóре	Caspian Sea
Ледови́тый океáн	Arctic Ocean
Москвá	Moscow
Росси́я	Russia
Санкт-Петербу́рг	St. Petersburg
Сиби́рь	Siberia
США	U.S.A
Ти́хий океáн	Pacific Ocean
Урáл	Urals
Урáльские гóры	Ural Mountains
Чёрное мóре	Black Sea
всю жизнь	all one's life
свой (possessive)	one's own
чем	than
*** Chapter 6 (/course/1296376/troika-all-vocab/6/)	
архитéктор	architect
бармéн	bartender
библиотéкар	librarian
бизнесмéн	businessman
бухгáлтер	bookkeeper
ветеринáр	veterinarian
врач	physician
дирéктор	director
домохозя́йка	housewife
домрабóтница	maid
журнали́ст	journalist
зубнóй врач	dentist
инженéр	engineer
лаборáнт	laboratory technician
матемáтик	mathematician
медсестрá/медбрáт	nurse
мéнеджер	manager
мехáник	mechanic
ня́ня	nanny
официáнт	waiter
официáнтка	waitress
перевóдчик	translator
писáтель (m.)	writer
преподавáтель (m.)	teacher
программи́ст	programmer
продавéц	salesman
продавщи́ца	saleswoman
профéссия	profession
по профéссии	by profession
секретáрь (m.)	secretary
строи́тель	construction worker
учёный	scientist
учи́тель (m.)	"teacher (elementary, secondary school)"
учи́тельница	teacher
фéрмер	farmer
фи́зик	physicist
хи́мик	chemist
"шкóль/ник, -ница"	student (in elementary and secondary school)
экономи́ст	economist
юри́ст	lawyer
бар	bar
бю́ро	bureau
дóма	at home
завóд (на)	"factory, plant"
институ́т	institute
компáния	company
лаборатóрия	laboratory
óфис	office
поликли́ника	health clinic
стрóийка (на)	construction site
фáбрика (на)	factory (light industry)
фéрма (на)	farm
фи́рма	company
центр	center
торгóвый центр	shopping center
шкóла	school (elementary and secondary)
понедéльник	Monday
втóрник	Tuesday
средá	Wednesday
четвéрг	Thursday
пя́тница	Friday
суббóта	Saturday
воскресéнье	Sunday
áдрес	address
безрабóтный	unemployed
день (m.)	day
жéнщина	woman
и́мя (pl. имена)	"name, first name"
мéсто	place
мужчи́на	man
недéля	week
óтчество	patronymic
пéнсия	pension
на пéнсия	retired
положéние	status
рабóта (на)	"job, work"
реклáма	advertisement
фами́лия	last name
час	hour
городскóй	city (adj.)
госудáрственный	"state, public (adj.)"
жéнский	"women's, female"
медици́нский	medical
музыкáльный	musical
прести́жный	prestigious (adj.)
центрáльный	central
чáстный	private
рабóтать	to work
уч|и́ться (II)	to study (at a place)
женáт	married (of a man)
зáмужем	married (of a woman)
не зáмужем	single (of a woman)
разведён	divorced
хóлост	single (of a man)
вéчером	in the evening
днём	in the afternoon
иногдá	sometimes
кáждый день	every day
когдá	when
обы́чно	usually
полови́на	half
полторá часá	one and one half hours
полчасá	half an hour
сегóдня	today
скóлько часóв	how many hours
у́тром	in the morning
и...и	both...and
ещё	still
нигдé	nowhere
ничегó	nothing
ужé	already
уже нé	not any more
*** Chapter 7 (/course/1296376/troika-all-vocab/7/)	
врéмя	time
мéсяц	month
недéля	week
переры́в	break
"раз, рáза"	time (counting)
зáвтрак	breakfast
обéд	"lunch, dinner"
у́жин	supper
веб-сáйт	website
душ	shower
заня́тие (на)	class session
кинó (indecl.)	cinema
концéрт (на)	concert
лéкция (на)	lecture
му́зыка	music
посу́да	dish(es)
посудомóечная маши́на	dishwasher
рабóта (на)	work
распоря́док дня	daily schedule
СМС	SMS (text message)
сосéд/ка по кóмнате	roommate
столóвая	cafeteria
упражнéние	exercise
урóк	lesson (homework)
фи́тнес-зал	fitness center (/room)
фи́тнес-клуб	fitness club
часы́ (pl.)	watch
кáждый	every
москóвский	Moscow (adj.)
росси́йский	Russian (adj.)
всегдá	always
ежеднéвно	every day
иногдá	sometimes
наконéц	finally
обы́чно	usually
опя́ть	again
пóздно	late
(по)пóзже	later
потóм	then
рáно	early
рáньше	earlier
рéдко	seldom
сейчáс	now
сначáла	at first
чáсто	often
бы́стро	fast
вмéсте	together
домóй	(to) home
кудá	where (to)
мéдленно	slowly
никогдá	never
никудá	(to) nowhere
нормáльно	okay
почему́	why
прекрáсно	wonderful
Во скóлько?	at what time?
вся семья́	the whole family
Котóрый час?	what time is it?
ноль (m.)	zero
по телеви́зору	on TV
по телефóну	on the telephone
Скóлько сейчáс врéмени?	What time is it?
води́ть (II)	to drive
вста|вáть (I)	to get up
готóв|ить (II)	"to prepare (dinner, etc.)"
гуля́|ть (I)	"to be out playing, walking, strolling"
дéла|ть (I)	to do
зáвтрака|ть (I)	to eat breakfast
занимá|ться (I)	"to study, to do homework"
идти́ (I)	"to go, to be going (on foot)"
лежáть (II)	to lie
ложи́ться (II)	to lie down
мыть (I)	to wash
обéда|ть (I)	to eat lunch/dinner
одевá|ться (I)	to get dressed
опáздывать (I)	to be late (for)
писáть (I)	to write
помогá|ть (I)	"to help, aid"
принимá|ть (I)	to take (e.g. a shower)
проводи́ть (II)	to spend (time)
просмáтрива|ть (I)	to browse
раздевá|ть (II)	to get undressed
сидéть (II)	to sit
слу́ша|ть (I)	to listen
смотр|éть (II)	"to watch, look"
сп|ать (II)	to sleep
стирá|ть (I)	to do laundry
сто|я́ть (II)	to stand
тренировáться (I)	"to train, exercise"
убирá|ть (I)	to clean
у́жина|ть (I)	to eat supper
умывá|ться (I)	to wash (oneself)
ход|и́ть (II)	to go
читá|ть (I)	to read
*** Chapter 8 (/course/1296376/troika-all-vocab/8/)	
балалáйка	balalaika
барабáн	drum
виолончéль (f.)	cello
гармóшка	accordion
гитáра	guitar
гобóй	oboe
кларнéт	clarinet
пиани́но	piano
роя́ль (m.)	grand piano
саксофóн	saxophone
скри́пка	violin
тромбóн	trombone
трубá	trumpet
флéйта	flute
гитари́ст/ка	guitarist
пиани́ст/ка	pianist
скрипáч/ка	violinist
флейти́ст/ка	flutist
балéт	ballet
джаз	jazz
инструмéнт	instrument
му́зыка	music
óпера	opera
оркéстр	orchestra
певéц (m.) (f. певица)	singer
пéсня	song
рок-гру́ппа	rock group
рок-му́зыка	rock music
америкáнский футбóл	football
атлéтика	athletics
аэрóбика	aerobics
баскетбóл	basketball
бег	running
бейсбóл	baseball
бодиби́лдинг	bodybuilding
бокс	boxing
волейбóл	volleyball
гимнáстика	gymnastics
гольф	golf
дáйвинг	diving
дзюдó	judo
йóга	yoga
каратэ́	karate
плáвание	swimming
тéннис	tennis
футбóл	soccer
ходьбá	walking
хоккéй	hockey
шáхматы	chess
бейсболи́ст/ка	baseball player
волейболи́ст/ка	volleyball player
вратáрь (m.)	goalkeeper
гимнáст/ка	gymnast
тенниси́ст/ка	tennis player
фигури́ст/ка	figure skater
хоккеи́ст/ка	hockey player
шахмати́ст/ка	chess player
вид спóрта	kind (category) of sport
комáнда	team
спорт	sport
шáйба	puck
балери́на	ballerina
детекти́вы (pl.)	detective novels
иску́сство	art
литерату́ра	literature
поэ́зия	poetry
скáзка	fairy tale
танцóр	dancer
фантáстика	science fiction
худóжник	"artist, painter"
баскетбóльный	basketball (adj.)
бейсбóльный	baseball (adj.)
велосипéдный	bicycle (adj.)
лы́жный	ski(ing) (adj.)
спорти́вный	sport (adj.)
футбóльный	football (adj.)
хоккéйный	hockey (adj.)
дéтский	children's
класси́ческий	classical
лёгкий	light
люби́мый	favorite
нарóдный	folk
настóльный	table (adj.)
популя́рный	popular
совремéнный	"modern, contemporary"
игрá|ть (I)	to play
люб|и́ть (II)	"to like, love"
петь (I)	to sing
рис|овá|ть (I)	to draw
танц|евá|ть (I)	to dance
бóльше	more
конéчно	of course
осóбенно	especially
*** Chapter 9 (/course/1296376/troika-all-vocab/9/)	
веснá	spring
врéмя (pl. временá)	time
врéмя гóда	season
свобóдное врéмя	"free time, leisure time"
зимá	winter
лéто	summer
óсень (f.)	"fall, autumn"
почтóвые мáрки (pl.)	stamps
матрёшка	Russian nesting doll
самовáр	samovar
сувени́р	souvenir
шáпка	"cap, hat"
бáня	bath-house
бéрег (на верегу́)	coast
водá	water
вóздух	air
гриб	mushroom
кáтер	motorboat
костёр	campfire
лес (лесу́)	forest
лóдка	boat
лю́ди (pl.)	people
мéсто (pl. местá)	place
моги́ла	grave
ры́ба	fish
снег	snow
ценá (pl. цéны)	price
черни́ка	blueberry
я́года	berry
другóй	other
котóрый	"who, which, that"
меховóй	fur (adj.)
мнóгие (pl. only)	many
настоя́щий	real
пáрусный	sail (adj.)
свобóдный	free
специáльный	special (adj.)
холóдный	cold (adj.)
бéга|ть (I)	to run
быть	to be
éздить	"to go, to travel by vehicle (round-trip)"
éэдить верхóм	to ride on horseback
катá|ться (I)	"to roll, to ride"
катá|ться (I) на вóдных лы́жах	to water-ski
катá|ться (I) на кáтере	to ride a motorboat
катá|ться (I) на конкáх	to ice-skate
катá|ться (I) на лóдке	to ride in a rowboat
катá|ться (I) на лы́жах	to ski
катá|ться (I) на рóликах	to roller-skate
катá|ться (I) на сноубóрде	to snowboard
купи́ть (II)	to buy (pf.)
лови́ть (I)	to catch
лови́ть (I) ры́бу	to fish
отдыхá|ть (I)	to rest
плáва|ть (I)	to swim
проводи́ть (II)	to spend (time)
разговáрива|ть (I)	to chat
собирá|ть (I)	to collect
умé|ть (I)	"to be able, to know how"
фотографи́р|ова|ть	to take photos
вéсело	fun
нéсколько	"some, a few"
почему́	why
почти	almost
поэ́тому	therefore
прóсто	simply (adv.)
тудá	(to) there
шу́мно	noisy
в прóшлом году́	last year
веснóй	in spring
вчерá	yesterday
дóлго	for a long time
зимóй	in winter
лéтом	in summer
назáд	ago (adv.)
óсенью	in fall
рáньше	"before, earlier"
дáже	even (adv.)
зá город	out of town
мóжно	one can/may; it is possible
так как	because
я устáл(/а)	I was tired
мы устáли	we were tired
*** Chapter 10 (/course/1296376/troika-all-vocab/10/)	
антрополóгия	anthropology
архитекту́ра	architecture
биолóгия	biology
геогрáфия	geography
геомéтрия	geometry
журнали́стика	journalism
истóрия	history
коммуникáция	communication
компьютерная тéхника	computer science
лингви́стика	linguistics
литерату́ра	literature
матемáтика	mathematics
медици́на	medicine
междунарóдные отношéния	international relations
мéнеджмент	management
нау́ка	science
океанолóгия	marine science
письмó	writing
политолóгия	political science
предмéт	subject
психолóгия	psychology
социолóгия	sociology
стати́стика	statistics
стрновéдение	area studies
физкульту́ра	physical education
филолóгия	philology
филосóфия	philosophy
финáнсы	finance
фи́зика	physics
хи́мия	chemistry
чтéние	reading
эконóмика	economics
юриспрудéнция	law
язы́к	language
двóйка	D (a failing grade)
зачёт	credit
контрóльная рабóта	quiz
отмéтка	grade
пятёрка	A (grade)
сéссия	exam period
трóйка	C (grade)
четвёрка	B (grade)
экзáмен	exam
акадéмия	academy
аспиранту́ра	(post) graduate program
вуз (вы́сшее учéбное заведéние)	higher education institution
заня́тие (на)	class session
кáфедра	department
класс	class
консерватóрия	conservatory
кóлледж	in Russia: junior college
курс	year level
лицéй	lyceum
лéкция	lecture
магистрату́ра	master's program
отделéние	division
семинáр	seminar
тéхникум	technical college
учи́лище	vocational college
факултéт	department
аспирáнт/ка	graduate student
бакалáвр	bachelor's degree
выпускни́к	high school graduate
доцéнт	"docent, assistant professor"
кандидáт	candidate
коллéга	colleague
маги́стр	master's degree
одноклáссник	classmate (in schools)
одноку́рсник	classmate (in universities)
репети́тор	tutor
специали́ст	specialist
"уче|ни́к, -ни́ца"	pupil
"шкóль|ник, -ница"	"schoolboy, -girl"
аттестáт	diploma (high school)
билéт	ticket
вопрóс	question
диплóм	diploma (university)
диплóмная рабóта	thesis
доклáд	"presentation, paper"
ЕГЭ́ (еди́ный госудáрственный экзáмен)	high school exit exam
задáние	assignment
кани́кулы (pl.)	school holidays
кóнкурс	competition
образовáние	education
прóпуск	ID card
семéстр	semester
сочинéние	essay
специáльность	"specialty, major"
упражнéние	exercise
автомехáник	auto mechanic
дежу́рный/дежу́рная	person on duty
дипломáт	diplomat
косметóлог	cosmetologist
охрáнник	security guard
скрипáч/ка	violinist
дéньги (pl. only)	money
чéтверть (f.)	quarter
биологи́ческий	biology (adj.)
госудáрственный	state (adj.)
истори́ческий	history (adj.)
математи́ческий	mathematics (adj.)
медици́нский	medical (adj.)
физи́ческий	physics (adj.)
филологи́ческий	philology (adj.)
филосóфский	philosophy (adj.)
хими́ческий	chemistry (adj.)
экономи́ческий	economics (adj.)
арáбский	Arabic (adj.)
инострáнный	foreign
корéйский	Korean  (adj.)
пóльский	Polish (adj.)
португáльский	Portuguese (adj.)
роднóй	native (adj.)
украи́нский	Ukrainian (adj.)
пéрвый	first
вторóй	second
трéтий	third
четвёртый	fourth
пя́тый	fifth
шестóй	sixth
седьмóй	seventh
восьмóй	eighth
девя́тый	ninth
деся́тый	tenth
оди́ннадцатый	eleventh
двенáдцатый	twelfth
весéнний	"spring, vernal"
зи́мний	winter (adj.)
лéтний	summer (adj.)
осéнний	"fall, autumnal"
бу́дущий	future
вы́сший	higher (adj.)
вступи́тельный	entrance (adj.)
выпускнóй	exit
другóй	other
контрáктный	contract (adj.)
обязáтельный	"required, compulsory"
пи́сьменный	written
пóлный	full
стáрший	"older, oldest (higher) (adj.)"
студéнческий	student (adj.)
тру́дный	difficult (adj.)
у́чистный	oral
учéбный	study (adj.)
бывá|ть (I)	to be (frequently)
выбирá|ть (I)	to choose
"да|вáть, *дать"	to give
изучá|ть (I)	to study (a subject)
кончá|ться (I)	to end
начинá|ться (I)	to begin
отвечá|ть (I)	to answer
писáть (I)	to write
получá|ть (I)	to receive
поступи́ть (II)	"to get in (a school, university)"
препода|вáть (I)	to teach
проводи́ться (II)	to conduct
продолжá|ть (I)	to continue
снимá|ть (I)	to rent
уч|и́ться (II)	to study (at a place)
чу́вств|ова|ть (I) себя́	to feel
Ни пу́ха ни перá!	Good Luck!
К чёрту!	Go to hell!
Желáю тебé/вам удáчи!	I wish you luck!
дёшево	cheap
дóрого	expensive (adv.)
крóме	except
ли́чно	personally
намнóго	a lot more (with comp.)
напримéр	for example
по-другóму	in another way
потому́ что	because
почему́	why
с роди́телями	with parents
"сáм, самá, сáми"	#NAME?
себя́	oneself
ти́хо	quietly (adv.)
тру́дно	difficult (adv.)
хотя́	although
шу́мно	noisy
*** Chapter 11 (/course/1296376/troika-all-vocab/11/)	
апельси́н	orange (fruit)
банáн	banana
ветчинá	ham
винегрéт	"Russian salad (with beets, etc.)"
винó	wine
виногрáд (collect.)	grapes
водá	water
водкá	vodka
джем	jam
икрá	caviar
капу́ста	cabbage
квáшеная капу́ста	sauerkraut
цветнáя капу́ста	cauliflower
картóфель (m.)	potatoes
колбасá	sausage
кóфе	coffee
ку́рица	chicken
лавáш	flatbread
лимонáд	lemonade
лук	onion
маргари́н	margarine
мáсло	"butter, oil"
расти́телное мáсло	vegetable oil
молокó	milk
моркóвь (f. collect.)	carrot
морóженое (subst. adj.)	ice cream
мя́со	meat
óвощи (pl.)	vegetables
огурéц (pl. огурцы́)	cucumber
пи́во	beer
плов	pilaf
помидóр	tomato
проду́кты (pl.)	produce
пти́ца	"bird, poultry"
рис	rice
ры́ба	fish
салáт	salad
сметáна	sour cream
сок	juice
сыр	cheese
торт	cake
фрукт	fruit
хлеб	bread
чай	tea
шампáнское (subst. adj.)	champagne
шоколáд	chocolate
я́блоко (pl. я́блоки)	apple
яйцó (pl. я́йца)	egg
ларёк (pl. ларьки́)	kiosk
кулинари́я	delicatessen
супермáркет	supermarket
гастронóм	food store
ры́нок (на ры́нке)	farmer's market
бáнка	"can, jar"
буты́лка	bottle
бухáнка	loaf
грамм	gram
килогрáмм	kilogram
корóбка	box
кусóк	piece
литр	liter
пакéт	carton
пáчка	package
полкилó	half a kilo
пол-ли́тра	half a liter
аллерги́я	allergy
вéник	broom
дéвушка	"young woman, girl"
дéньги (pl. only)	money
дóллар	dollar
копéйка	kopeck
кофевáрка	coffeemaker
креди́тная кáрточка	credit card
микроволнóвая печь	microwave oven
морози́льник	freezer
напи́ток (pl. напи́тки)	drink
плитá	stove
посудомóечная маши́на	dishwasher
пылéсос	vacuum cleaner
ру́бль (m.)	ruble
совóк	dustpan
стирáльная маши́на	(clothes) washer
тóстер	toaster
холоди́льник	refrigerator
цент	cent
чáйник	teakettle
человéк	person
молодóй человéк	young man
апельси́новый	orange (fruit) (adj.)
грузи́нский	Georgian (country)
дешёвый	"cheap, cheaper"
"дорогóй, дорóже"	"expensive, more expensive"
колумби́йский	Colombian
минерáлный	mineral (adj.)
молóчный	"milk, milky"
молóчные проду́кты	dairy produce
слáдкий	sweet
стекля́нный	glass (adj.)
швéдский	Swedish
бóльше	more
дёшево	cheap
дóрого	expensive (adv.)
достáточно	enough
мáло	little
мéньше	less
мнóго	a lot
навéрно(е)	probably (adv.)
нáдо	"must, need"
ну́жно	need
скóлько	how much
сли́шком	"too (much, etc.)"
тогдá	"then, in that case"
взять (I)	to take (pf)
есть	to eat
купи́ть (II)	to buy (pf.)
пить (I)	to drink
прода|вáть (I)	to sell
стóить	to cost
нарéзать	to slice
плати́ть	to pay (with cash)
на вся́кий слу́чай	just in case
*** Chapter 12 (/course/1296376/troika-all-vocab/12/)	
билéт	ticket
боеви́к	action film
буди́льник	alarm clock
вход	entrance
вы́ставка	exhibit
канáл	channel
кáсса	box office
катóк	skating rink
клуб	club
концéрт	concert
матч	game (sports event)
мину́та	minute
мину́т(оч)ка (dim.)	minute (dim.)
передáча	TV or radio broadcast
пéсня	song
полчасá	half an hour
портфéль	briefcase
приглашéние	invitation
прогрáмма	program
реферáт	"report, paper"
сеáнс	show (in movie theaters)
спи́сок	list
су́мка	"bag, purse"
глáвный	main
домáшний	home (adj.)
ли́шний	extra
театрáльный	theater (adj.)
дóлго	for a long time
ещё	still
ещё не	not yet
никáк	no way
ти́хо	quietly (adv.)
тогдá	"then, in that case"
тóчно	exactly
ужé	already
"весь, вся, всё, все"	all
весь день	all day
"ему́, ей"	"him, her (indirect object)"
тебé	you (indirect object)
что-нибудь	something
за (+acc.)	"in, within (a period of time)"
пóсле (+gen.)	after
у (+gen.)	"by, at"
брать	to take (imf)
ви́деть (II)	to see
встречá|ть(ся) (I)	to meet
встрéтимся	let's meet
готóв|ить (II)	"to prepare (dinner, etc.)"
готóв|иться	to prepare for an exam
"да|вáть, *дать"	to give
дéла|ть	to do
éхать (I)	"to go, travel*"
зáвтрака|ть (I)	to eat breakfast
закáнчива|ться	to end
звон|и́ть	to call on the telephone
класть	(imperf.) to put
купи́ть (II)	to buy (pf.)
мочь	to be able to
мыть	to wash
начáть	to begin (to do something)
начинá|ться (I)	to begin
обéда|ть (I)	to eat lunch/dinner
опáздывать (I)	to be late (for)
отвечá|ть (I)	to answer
отдыхá|ть (I)	to rest
открывáть (I)	to open (impf)
передáть	"to convey, pass"
петь (I)	to sing
писáть (I)	to write
пить (I)	to drink
поéхать (I)	"to go, leave (by vehicle)"
пойти́	"to go, leave (on foot)"
позови́те	call!
покáзывать	to show
покупáть	to buy (impf.)
положи́ть (II)	to put
получá|ть (I)	to receive
приглашáть	to invite
прийти́	to arrive (on foot)
принимá|ть (I)	to take (e.g. a shower)
просну́ться	to wake up
сдавáть	to take (an exam)
сдать	to pass (an exam)
смотр|éть (II)	"to watch, look"
стирá|ть (I)	to do laundry
танц|евá|ть (I)	to dance
убирá|ть (I)	to clean
у́жина|ть (I)	to eat supper
узнáть (I)	"to recognize, find out"
улыбáться	to smile
хотéть	to want
читá|ть (I)	to read
Всегó хорошéго!	All the best!
давáй пойдём/поéдем	let's go
давáй посмóтрим	let's watch
договори́лись	agreed
зá город	out of town
к сожалéнию	unfortunately
лáдно	all right
мне нáдо	I have to
Молодéц!	Well done!
нé за что	"you are welcome, don't mention it"
прóдан	sold out
с удовóльствием	with pleasure
со мнóй	with me
я устáл(/а)	I was tired
*** Chapter 13 (/course/1296376/troika-all-vocab/13/)	
галстук	necktie
духи́	perfume
игру́шка	toy
кольцó (pl. кóльца)	ring
ку́кла	doll
ми́шка m.	teddy bear
"подáрок, pl. подáрки"	"gift, present"
самолёт	airplane
сви́тер	sweater
серёжка	earring
су́мка	"bag, purse"
цветы́	flowers
часы́ (pl.)	watch
шарф	scarf
вечери́нка	party
восьмóе мáрта	Int'l Women's Day
дед морóз	Grandfather Frost
день рождéния	birthday
пáсха	Easter
прáздник	"celebration, holiday"
рождествó	Christmas
снегу́рочка	snow maiden
"январь, в январé"	January
февраль (é)	February
март	March
апрель	April
май	May
июнь	June
июль	July
август	August
сентябрь (é)	September
октябрь (é)	October
ноябрь (é)	November
декабрь (é)	December
млáдший	"younger, youngest (adj.)"
молóже (comp. of molodoi)	younger
"старéе, стáрше (comp. of staryi)"	older (comp.)
стáрший	"older, oldest (higher) (adj.)"
бóльше всегó	most of all
скóро	soon (adv.)
кому́	for whom
мне	for me
тебé	for you
ему́	for him
ей	for her
нам	for us
вам	for y'all
им	for them
свой (possessive)	one's own
к + dat.	"to, toward"
от + dat.	from
"да|вáть, *дать"	to give
"дари́ть, *подари́ть"	to give (as a present)
"нрáвиться, *понрáвиться"	"to like, please"
"покупáть, *купи́ть"	to buy
"получáть, *получи́ть"	"to get, to recieve"
"помогáть, *помочь"	"to help, aid"
*пригласи́ть	to invite (perf.)
приходи́те	arrive (imperative)
"роди́лся, родилáсь, родились"	to be born (perf.past.)
"совéтовать, *посовéтовать"	"to give advice, to advise"
"у́мер, умерлá, у́мерли"	to die (perf. past)
с днём рождéния	Happy Birthday
с нóвым годóм	Happy New Year
с прáздником	Happy holiday!
*** Chapter 14 (/course/1296376/troika-all-vocab/14/)	
ветер	wind
влажность	humidity
воздух	air
градус	degree
гроза	thunderstorm
дождь	rain
кли́мат	climate
мороз	frost
погода	weather
прогноз	forecast
снег	snow
температура	temperature
Фаренгейт	Fahrenheit
по Фаренгейту	on the Fahrenheit scale
Цельсий	Celsius
по Цельсию	on the Celsius scale
берёза	birch
дерево	tree
деревья	trees
звезда	star
звёзды	stars
земля	"ground, land"
луна	moon
небо	sky
облако	cloud
облака	clouds
природа	nature
пти́ца	"bird, poultry"
солнце	sun
трава	grass
цветы́	flowers
цвето́к	flower
варежки	mittens (pl.)
куртка	jacket
майка	sleeveless T-shirt
пальто (indecl.)	overcoat
перчатки	gloves (pl.)
плащ	raincoat
сапоги	boots
сви́тер	sweater
футболка	t-shirt
шáпка	"cap, hat"
шарф	scarf
шорты	shorts
зоопарк	zoo
пляж	beach
весёлый	"happy, fun-loving (adj.)"
весело	"happy, fun-loving (adv.)"
высокий	"high, tall (adj.)"
высоко	"high, tall (adv.)"
вы́ше	"higher, taller (comp.)"
жаркий	hot (adj.)
жарко	hot (adv.)
жарче	hot (comp.)
корóткий	short (adj.)
коротко	short (adv.)
короче	short (comp.)
ни́же	lower (comp.)
ни́зкий	low (adj.)
низко	low (adv.)
облачный	cloudy (adj.)
облачно	cloudy (adv.)
пасмурно	overcast (adv.)
прекрасный	wonderful (adj.)
прохладный	cool (adj.)
прохладно	cool (adv.)
светлый	light (adj.)
светло	light (adv.)
сильный	strong (adj.)
сильно	strong (adv.)
ску́чный	"boring, dull (adj.)"
скучно	"boring, dull (adv.)"
слабый	weak (adj.)
слабо	weak (adv.)
солнечный	sunny (adj.)
солнечно	sunny (adv.)
такой	"so, such (adj.)"
так	"so, such (adv.)"
тёмный	dark (adj.)
темно	dark (adv.)
тёплый	warm (adj.)
тепло	warm (adv.)
холóдный	cold (adj.)
холодно	cold (adv.)
яркий	bright (adj.)
ярко	bright (adv.)
ярче	bright (comp.)
ясный	clear (adj.)
ясно	clear (adv.)
бывá|ть (I)	to be (frequently)
надевать (I)	to put on (clothes) (imperfective)
надеть	to put on (clothes) (perfective)
разговаривать (I)	"to talk, to chat"
светит	is shining
снимать (I)	to take off (clothes) (imperfective)
снять (I)	to take off (clothes) (perfective)
довольно	"fairly, rather (adv.)"
если	if
минус	"minus, below zero"
намного	"by far, much (adv.)"
ноль (m.)	zero
нуль	zero
плюс	"plus, above zero"
почти	almost
разве	I wonder (if)
тогдá	"then, in that case"
*** Chapter 15 (/course/1296376/troika-all-vocab/15/)	
автобус	bus
аэропорт	airport
билет	ticket
виза	visa (travel document)
вокзал	railway station
граница	border
за граница	abroad
за границу	(to) abroad
из-за границы	from abroad
дéньги (pl. only)	money
дорога	"road, trip"
достопримечательность (f.)	tourist sight
креди́тная кáрточка	credit card
номер	hotel room
отдых	"rest, vacation"
пансионат	resort hotel
паспорт	passport
поезд	train
поездка	trip
полёт	flight
проводник	train conductor (m.)
проводница	train conductor (f.)
рейс	"flight, route"
самолёт	airplane
санаторий	health spa
станция	metro station
трамвай	street car
троллейбус	trolleybus
чемодан	suitcase
адаптер	adapter (for outlets)
аспирин	aspirin
бритва	razor
брюки	pants
галстук	necktie
джинсы	jeans
зонт(ик)	umbrella
костюм	suit
кофта (кофточка)	women's top
кроссовки	athletic shoes
купальник	swimsuit
куртка	jacket
носки	socks
очки	glasses
солнечные очки	sunglasses
пальто	coat
паста	paste
зубная паста	toothpaste
перчатки	gloves
плавки	men's swimsuit
платье	dress
рубашка	(men's) shirt
рюкзак	backpack
сапоги	boots
сви́тер	sweater
су́мка	"bag, purse"
трусы (трусики)	men's/women's underwear
туфли	shoes
футболка	t-shirt
шáпка	"cap, hat"
шарф	scarf
шорты	shorts
щётка	brush
зубная щётка	toothbrush
юбка	skirt
в следующем году	next year
конец	end
в конец	at the end
начало	beginning
в начале	at the beginning
середина	middle
в середине	in the middle
по вечерам	in the evenings
полгода	half a year
срок	period of time
на какой срок	for how long
альпинизм	mountain climbing
бéрег (на верегу́)	coast
воздух	air
дурак	fool (m.)
дура	fool (f.)
заня́тие (на)	activity
иностранец	foreigner
карман	pocket
ключ	key
кран	faucet
курорт	resort
лампочка	lightbulb
лестница	staircase
лифт	elevator
одеяло	blanket
палатка	tent
подушка	pillow
полотенце	towel
поход	hiking
сад (на саду)	garden
скалолазание	rock-climbing
стоимость	"cost, price"
шкаф (в шкафу)	closet
этаж	"floor, level, story"
горячий	hot (about liquids) (adj.)
дальний	far (adj.)
двухместный	double (room) (adj.)
культурный	cultural (adj.)
"нужен (нужна, нужно, нужны)"	needed (adj.)
одноместный	single (room) (adj.)
отдельный	separate (adj.)
пассивный	passive (adj.)
пляжный	beach (adj.)
разный	various (adj.)
следующий	next (adj.)
средний	"middle, central (adj.)"
счастливый	happy (adj.)
Счастливого пути!	Have a nice trip!
быстро	fast (adv.)
громко	loudly (adv.)
гормче	louder (comp.)
медленно	slowly (adv.)
назáд	ago (adv.)
осторожно	carefully (adv.)
откуда	where from
ти́хо	quietly (adv.)
тише	quieter (comp.)
тудá	(to) there
из (+ gen.)	from
через (+ acc.)	in (in time expressions)
на (+ acc.)	for (a period of time)
бояться (II)	to be afraid
взять (I)	to take (pf)
возвращаться (I)	to return
вернуться (I)	to return*
éхать (I)	"to go, travel*"
забывать (I)	to forget
забыть (I)	to forget*
загорать (I)	to sunbathe
закрывать (I)	"to shut, to close"
закрыть (I)	"to shut, to close*"
заниматься (I) альпинизмом	to climb mountains
купаться (I)	"to swim, to bathe (play)"
лазать по скалам	to climb rocks
летать (I)	to fly?
лететь (II)	to fly
отдыхá|ть (I)	to rest
открывáть (I)	to open (impf)
открыть (I)	to open (pf)
поéхать (I)	"to go, leave (by vehicle)"
положи́ть (II)	to put
потерять	to lose*
предпочитать (I)	to prefer
приехать (I)	to arrive*
путешествовать (I)	to travel
уехать (I)	to go away (by vehicle)*
украсть	to steal*
включи(те)	"turn on (the light, an appliance)"
не волнуйся(тесь)	Don't worry
встань(те)	stand up
выключи(те)	"turn off (the light, an appliance)"
останови(те)сь	stop
поверни(те)	turn
(подо)жди(те)	wait
помолчи(те)	be quiet
сади(те)сь	have a seat
если	if
"ну, что ж"	"oh, well"
стоп	stop
*** Chapter 16 (/course/1296376/troika-all-vocab/16/)	
ананáс	pineapple
арбу́з	watermelon
барáнина	lamb
батóн	loaf (French bread)
блины́	Russian pancakes
бу́блик	bagel
бу́лка	white bread
бу́лочка	bun
бутербрóд	sandwich
барéнье	"jam, jelly"
батру́шка	Russian cheese pastry
гáмбургер	hamburger
говя́дина	beef
горчи́ца	mustard
гру́ша	pear
квас	kvas (fermented drink)
кéтчуп	ketchup
кефи́р	buttermilk
клубни́ка	strawberry
лёд (со льдом; бéзо льда)	ice
лимóн	lemon
лук	onion
майонéз	mayonnaise
макарóны	macaroni
мали́на	raspberry
мёд	honey
мукá	flour
напи́ток (pl. напи́тки)	drink
огурéц (pl. огурцы́)	cucumber
пéр(е)ц	pepper
пéрсик	peach
петру́шка	parsley
печéнье	cookie
"пирóг, пирож(ó)к"	"pie, pastry"
пирóжное	pastry
пи́цца	pizza
помидóр	tomato
пóнчик	doughnut
припрáвы	"spices, condiments"
пря́ник	gingerbread cookie
рис	rice
сáхар	sugar
свёкла	beet
свини́на	pork
селёдка	herring
сельдь (f.)	herring (f.)
сли́вки (pl. only)	cream
соль (f.)	salt
соси́ски	sausage links
спагéтти	spaghetti
твóрог	Russian cottage cheese
тéсто	dough
соси́ски в тéсте	pigs in a blanket
укрóп	dill
у́ксус	vinegar
фарш	ground beef
хлóпья (pl.)	cereal
черни́ка	blueberry
чеснóк	garlic
шашлы́к	shish kebab
блю́до	dish
блю́дце	saucer
бокáл	wineglass
ви́лка	fork
десéрт	dessert
едá	"food, meal"
эакáз	order
заку́ска	"snack, appetizer"
креди́тная кáрточка	credit card
кру́жка	mug
лóжка	spoon
столóвая лóжка	tablespoon
чáйная лóжка	teaspoon
меню́ (indecl.)	menu
метрдотéль (m.)	maitre d'
нож	knife
нáлочки (pl.)	chopsticks
пóрция	portion
рю́мка	shot glass
тарéлка	plate
салфéтка	napkin
скáтерть	tablecloth
стакáн	glass
стóлик	table (dim.)
стóпка	shot glass
счёт	check
тост	toast (drink)
чаевы́е (subst. adj. pl.)	tip
чáшка	cup
бли́нная	pancake house
бу́лочная	bakery
буфéт	buffet
столóвая	"dining hall, cafeteria"
шашлы́чная	shish-kebab house
аппети́т	appetite
вегетариáн|(е)ц (вегетариáн)	vegetarian
вечери́нка	party
встрéча	meeting
главá	head (of a table)
диéта	diet
дру́жба	friendship
здорóвье	health
знакóмство	acquaintance
ингредиéнт	ingredient
пимáние	nutrition
проду́кты	produce
рецéпт	recipe
рукá (pl. руки)	hand
"хозя́ин, хозя́йка"	"host, hostess"
вку́сный	delicious
газирóванная водá	carbonated water
горя́чий	hot (temperature of food)
гря́зный	dirty
закры́т (short adj.)	closed
зáнят (short adj.)	"occupied, busy"
откры́т (short adj.)	open (adj.)
полéзный	good (for health)
свéжий	fresh
свобóден	"free, vacant"
слáдкий	sweet
сухóй	dry
фи́рменное блю́до	house special
чи́стый	clean (adj.)
зарáнее	in advance
(по)пóзже	later
тудá	there (direction)
без (+ gen.)	without
для (+gen.)	for
за (+acc.)	"to, for"
мéжду (+instr.)	between
ря́дом с (+instr.)	next to
с (+instr.)	with
подо/ждáть (I)	to wait
держ|áть (II)	to hold
закáзыва|ть (I)	"to order, reserve"
заку́сыва|ть (I)	to snack
корм|и́ть (II)	to feed
перепу́та|ть (I)	to mix up
положи́ть (II)	to put
попáсть	to get in
принимá|ть (I)	to take (here: credit cards)
давáй встрéтимся...	Let's meet...
давáть/*дать на чай	to give (a tip)
До вéчера тогдá.	See you tonight then.
До днá!	Bottoms up!
договори́лись	agreed
Прия́тного аппети́та!	Bon appetit!
"Передáйте, пожáлуйста,..."	"Please, pass..."
"Принеси́те, пожáлуйста,..."	Please bring me...
Проходи́те	Come in
Сади́тесь!	Sit down! Have a seat!
с удовóльствием	with pleasure
нельзя́	may not
двóе (collect. num.)	two
трóе (collect. num.)	three
чéтеро (collect. num.)	four
пя́теро (collect. num.)	five
*** Chapter 17 (/course/1296376/troika-all-vocab/17/)	
брак	marriage
дворец	palace
Дворец бракосочетания	marriage palace
девочка	(little) girl
жених	bridegroom
ЗАГС (Отдел записи актов гражданского состояния)	civil registry office
и́мя (pl. имена)	"name, first name"
кольцó (pl. кóльца)	ring
любовь (f.) (gen. любви)	love
мальчик	(little) boy
молодожёны	newly weds
невеста	bride
ребёнок (gen. ребёнка)	child
рождение	birth
свадьба	wedding
свидетель (m.)	witness
смерть (f.)	death
церемония	ceremony
церковь (f.) (в церкви)	church
образование	education
обучение	"schooling, teaching"
окончание	finishing
план	plan
спецшкола	special school
филфак (филологический факультет)	department of languages and literatures
военный	soldier (subst. adj.)
дипломат	diplomat
кинорежиссёр	movie director
лётчик	pilot
певéц (m.) (f. певица)	singer
пожарный	firefighter (subst. adj.)
полицейский	police officer (subst. adj.)
психиатр	psychiatrist
разведчик	intelligence officer
рок-музыкант	rock musician
солдат	soldier
хирург	surgeon
бег	running
бодибилдинг	bodybuilding
борьба	wrestling
велосипедный спорт	cycling
верховая езда	horseback riding
фехтование	fencing
физкультура	physical education
ходьбá	walking
армия	army
будущее	the future
ВВС (Военно-воздушные силы)	Air Force
ВМС (Военно-морские силы)	Navy
возраст	age
интерес	interest
каравай	a round bread (for ceremonies)
мечта	dream
миллионер	millionnaire
опрос	survey
отношение	relation(ship)
парень (m.)	guy
вы́сший	highest (here: college level) (adj.)
"доволен (довольна, довольны + instr.)"	satisfied with (adj.)
знаменитый	"famous, well-known (adj.)"
легко	(it's) easy (adj.)
лы́жный	ski(ing) (adj.)
международный	international (adj.)
модный	fashionable (adj.)
прести́жный	prestigious (adj.)
ранний	early (soft. adj.)
сложный	complicated (adj.)
довольно	"fairly, rather (adv.)"
скóро	soon (adv.)
только что	just (adv.)
тóчно	exactly
друг друга	each other
оба (m. & n.) (f. обе)	both
"сáм (самá, сáми)"	#NAME?
*** Chapter 18 (/course/1296376/troika-all-vocab/18/)	
аллерги́я	allergy
ангина	strep throat
аппендицит	appendicitis
астма	asthma
бессонница	insomnia
грипп	flu
кашель (m.)	cough
насморк	"runny, stuffy nose, head cold"
похмелье	hangover
простуда	cold
ревматизм	rheumatism
стресс	stress
борода	beard
бровь (f.)	eyebrow
веснушка	freckle
волосы	hair
глаз (pl. глаза)	eye
голова	head
горло	throat
грудь (f.)	"breast, chest"
губа (pl. губы)	lip
живот	stomach
зуб	tooth
кожа	skin
кость (f.)	bone
кровь (f.)	blood
лёгкие [лёхкие]	lungs
лицо (pl. лица)	face
лоб (на луб)	forehead
мозг	brain
нерв	nerve
нога (pl. ноги)	"foot, leg"
нос	nose
палец (pl. пальцы)	"finger, toe"
плечо (pl. плечи)	shoulder
подбородок (подбородк-)	chin
попа (colloq.)	butt
ресницы	eyelashes
рост	"height, growth"
рот (во рту)	mouth
рукá (pl. руки)	hand
сердце [серце]	heart
слеза (pl. слёзы)	tear
спина	back
тело	body
усы	mustache
ухо (pl. уши)	ear
фигура	figure
чёлка	bangs
шея	neck
шека (pl. шёки)	cheeks
ягодицы	buttocks
язык	tongue
аппарат	gadget
слуховой аппарат	hearing aid
аспирин	aspirin
банник	bath-house spirit
баня	"banya, Russian bath house"
больной (subst. adj.)	patient
веник	broom; here: a bundle of birch twigs
витамин	vitamin
диагноз	diagnosis
душа	soul
зал	hall
здорóвье	health
здравоохранение	health care
значение	meaning
зрение	vision
кабинет	office
курение	smoking
куртка	jacket
лекарство	medicine
линза	lens
контактные линзы	contact lens
охлаждение	cooling
очищение	cleaning
парилка	steam room
пачка	package
питание	nutrition
победа	victory
повторение	repetition
пожар	fire
поликли́ника	health clinic
полис	policy
полиция	police
помощь (f.)	help
скорая помощь	"ambulance, emergency medical service"
привычка	habit
расслабление	relaxation
рецéпт	prescription
род(ильные) дом	maternity ward
сигарета	cigarette
снотворное	sleeping pill
страхование (медицинское~)	insurance (medical)
таблетка	pill
термометр	thermometer
угол (в/на углу)	corner
укрепление	strengthening
фаза	phase
бедный	poor (adj.)
берёзовый	(made of) birch-tree (adj.)
беременна (беременны)	pregnant (adj.)
близорукий	nearsighted (adj.)
"болен (больна, больны)"	sick (adj.)
важный	important (adj.)
весёлый	cheerful (adj.)
"виноват (виновата, виноваты)"	guilty (adj.)
"влюблён (влюблена, влюблены)"	in love (adj.)
волнистый	wavy (hair) (adj.)
вредный	"harmful, bad for you (adj.)"
высокий	"high, tall (adj.)"
глухой	deaf (adj.)
горбатый	"aquiline, eagle's (of a nose) (adj.)"
горячий	hot (of liquid) (adj.)
грустный	sad (adj.)
"здоров (здорова, здоровы)"	well (not sick) (adj.)
"карий (-яя, -ее, -ие)"	brown (of eyes) (adj.)
крепкий	strong (adj.)
кожаный	(made of) leather (adj.)
круглый	round (adj.)
кудрявый	curly (adj.)
курносый	pug(-nosed) (adj.)
ленивый	lazy (adj.)
немой	mute (adj.)
овальный	oval (adj.)
полный	"full, full-figured, plump (adj.)"
"похож (похожа, похожи (на + acc.))"	"similar, resembling (adj.)"
прямой	straight (adj.)
регулярный	regular (adj.)
русый	dark blond (adj.)
рыжий	red (of hair) (adj.)
светлый	light(-colored) (adj.)
седой	gray (of hair) (adj.)
серьёзный	serious (adj.)
слабый	weak (adj.)
слепой	blind (adj.)
скорый	fast (adj.)
средний	"average, middle (adj.)"
страшный	"awful, horrible, scary (adj.)"
стройный	slim (adj.)
такой же	same kind (adj.)
тёмный	dark (adj.)
узкий	narrow (adj.)
чи́стый	clean (adj.)
винзу	downstairs (adv.)
глубоко	deeply (adv.)
дáже	even (adv.)
навéрно(е)	probably (adv.)
(dat +) нельзя	"must not, cannot (adv.)"
прóсто	simply (adv.)
так себе	so-so (adv.)
"беспокоить (II) (беспокою, беспокоишь, беспокоят)"	"to worry, to disturb"
болеть (I)	to be sick
заболеть (I)	to be sick*
"болеть (II) (болит, болят)"	to hurt
"бросить (II) (брошу, бросишь, бросят)"	"to throw, to quit*"
"видеть (II) (вижу, видишь, видят)"	to see
"выглядеть (II) (выгляжу, выглядишь, выглядят)"	to look (of appearance)
вызывать (I)	to call
"вызвать (I) (вызову, вызовешь, вызовут)"	to call*
"дышать (II) (дышу, дышишь, дышат)"	to breathe
"жаловаться (I) (на + acc.) (жалуюсь, жалуешься, жалуются)"	to complain
"измерить (II) (измерю, измеришь, измерят)"	to measure*
казаться (dat. +) (кажется)	to seem
мне кажется	it seems to me
"курить (II) (курю, куришь, курят)"	to smoke
набрать	to dial (a telephone number)
"носить (II) (ношу, носишь, носят)"	"to wear, to carry"
поправляться (I)	to get well; here: to gain weight
"поправиться (поправлюсь, поправишься, поправятся)"	to get well; here: to gain weight*
"попробовать (I) (пробую, пробуешь, пробуют)"	to try*
принимá|ть (I)	to take; also: to receive patients
"принять (I) (приму, примешь, примут)"	to take; also: to receive patients*
"простудиться (II) (простужусь, простудишься, простудятся)"	to catch a cold*
"слышать (II) (слышу, слышишь, слышат)"	to hear
снять стресс	to reduce stress
узнáть (I)	"to recognize, find out"
"уставать (I) (устаю. устаёшь, устают)"	to get tired
"устать (past: устал, устала, устали)"	to be tired*
похудеть	to lose weight*
"чувствовать себя (I) (чувствую, чувствуешь, чувствуют)"	to feel
почувствовать себя	to feel*
Возьми(те) себя в руки!	Get a grip on yourself!
Mне жаль тебя (dat. + жаль + acc.)	I feel sorry for you
Не беспокойся (беспокойтесь)	Don't worry
Не падай(те) духом	Do not lose hope!
Поправляйся (поправляйтесь)	Get well!
Mне не спится (dat. + спится)	I can't sleep!
Mеня тошнит (acc. + тошнит)	I feel nauseated.
Успокойся (успокойтесь)	Calm down!
Mне хочется есть (dat. + хочется)	I want to eat; I am hungry
Что случилось?	What happened?
Что с тобой?	What is wrong with you?
Бесняжка	Poor thing!
С лёгким паром!	Enjoy your bath!
