*** 1 - 10 (/course/187382/spanish-adverbs-7/1/)	
no	"no, not"
más	"most, more, other"
también	"also, too, as well"
muy	"very, too, much"
ya	"already, now"
sólo	"only, just, alone"
bien	"well, good, properly"
tanto	"so much, so often"
tan	"so, this, that"
así	"so, thus, thereby, like this"
*** 11 - 20 (/course/187382/spanish-adverbs-7/2/)	
hoy	"today, now, nowadays"
ahora	"now, these days, right now"
menos	"less, least, minus"
siempre	"always, ever, forever"
entonces	"then, now, so"
luego	"then, later, next"
aquí	"here, now"
poco	"little, few, moderately"
aún	"even, still, yet"
además	"besides, in addition, furthermore"
*** 21 - 30 (/course/187382/spanish-adverbs-7/3/)	
casi	"nearly, almost, quasi"
mucho	"lot, a lot, much"
después	"after, then, afterwards"
allí	"there, then"
nunca	"never, ever"
ayer	yesterday
incluso	"even, including"
antes	"before, formerly, rather"
todavía	"yet, still, even so"
sí	yes
*** 31 - 40 (/course/187382/spanish-adverbs-7/4/)	
como	"like, as, how"
especialmente	"especially, specially, particularly"
actualmente	"now, nowadays, actually"
pronto	"soon, early, quickly"
tarde	late
cuanto	as soon as
finalmente	"finally, at last, last"
bastante	"enough, quite, rather"
demasiado	"too much, too, overly"
tampoco	"either, neither, nor"
*** 41 - 50 (/course/187382/spanish-adverbs-7/5/)	
allá	"there, over there, sometime"
realmente	"really, truly, actually"
apenas	"just, hardly, scarcely"
posteriormente	"later, afterwards, subsequently"
principalmente	"mostly, principally, mainly"
solamente	"only, alone, solely"
aun	"even, still, yet"
adelante	"forward, ahead, onward"
asimismo	"additionally, also, as well"
siquiera	"at least, even"
*** 51 - 60 (/course/187382/spanish-adverbs-7/6/)	
quizá	"perhaps, maybe"
precisamente	"precisely, just, accurately"
totalmente	"completely, entirely, totally"
completamente	"fully, completely, full"
ahí	"there, then"
simplemente	"simply, merely"
jamás	"never, ever"
ni	neither
directamente	"directly, right, straight"
probablemente	"probably, likely, presumably"
*** 61 - 70 (/course/187382/spanish-adverbs-7/7/)	
claramente	"clear, clearly, plainly"
aproximadamente	"approximately, roughly, about"
atrás	"behind, back, ago"
rápidamente	"quickly, rapidly, swiftly"
únicamente	"only, solely, just"
generalmente	generally
arriba	"up, above, upstairs"
inmediatamente	"immediately, at once, straight away"
lejos	"far, away, afar"
abajo	"down, downstairs, downwards"
*** 71 - 80 (/course/187382/spanish-adverbs-7/8/)	
quizás	"maybe, perhaps, possibly"
igualmente	"equally, likewise"
prácticamente	"virtually, practically, in reality"
recientemente	"recently, newly, lately"
nuevamente	"again, once again"
naturalmente	naturally
acaso	"perhaps, maybe"
encima	"over, above, overhead"
absolutamente	"quite, absolutely, utterly"
normalmente	"normally, as normal, as usual"
*** 81 - 90 (/course/187382/spanish-adverbs-7/9/)	
anteriormente	"previously, formerly, beforehand"
cierto	certainly
cerca	"nearby, near, close"
exactamente	"exactly, right, quite"
plenamente	"thoroughly, fully, to the fullest"
particularmente	"personally, particularly, especially"
respectivamente	respectively
fácilmente	"readily, easy, easily"
cuando	"when, whenever, as"
dentro	"inside, within, in"
*** 91 - 100 (/course/187382/spanish-adverbs-7/10/)	
seguramente	"surely, safely, probably"
oficialmente	"officially, formally"
efectivamente	"indeed, really"
recién	"just, freshly, recently"
relativamente	"relatively, comparatively, fairly"
definitivamente	"for good, permanently, definitely"
inicialmente	initially
posiblemente	"maybe, possibly, perhaps"
delante	"before, in front, opposite"
originalmente	originally
*** 101 - 110 (/course/187382/spanish-adverbs-7/11/)	
verdaderamente	"truly, really, genuinely"
suficientemente	"sufficiently, enough, adequately"
profundamente	"deep, deeply, profoundly"
hasta	"up, even, through"
frecuentemente	frequently
ciertamente	"certainly, surely"
evidentemente	"obviously, evidently, patently"
fundamentalmente	"fundamentally, basically, principally"
constantemente	"constantly, continually"
*** 111 - 120 (/course/187382/spanish-adverbs-7/12/)	
necesariamente	necessarily
concretamente	"specifically, in particular"
alrededor	"around, round"
lentamente	slow
personalmente	personally
previamente	previously
anoche	last night
extremadamente	"extremely, exceedingly"
aparentemente	"seemingly, apparently, ostensibly"
sumamente	"highly, extremely, most"
*** 121 - 130 (/course/187382/spanish-adverbs-7/13/)	
pues	"well, then"
acá	"here, hither, now"
ligeramente	"slightly, lightly, light"
parcialmente	"partly, partially"
ampliamente	"thoroughly, totally"
justamente	"just, justly, fairly"
supuestamente	"supposedly, presumably, allegedly"
básicamente	basically
conjuntamente	"jointly, together"
sencillamente	"simply, modestly"
*** 131 - 140 (/course/187382/spanish-adverbs-7/14/)	
fuertemente	"heavily, strongly"
tradicionalmente	traditionally
habitualmente	"habitually, usually"
temprano	"early, soon"
independientemente	"independently, regardless of"
específicamente	specifically
altamente	"highly, extremely, exceedingly"
lamentablemente	"regrettably, pitifully, lamentably"
comúnmente	"commonly, customarily, usually"
continuamente	"continually, continuously, steadily"
*** 141 - 150 (/course/187382/spanish-adverbs-7/15/)	
propiamente	"properly, exactly, correctly"
correctamente	"correctly, properly, rightly"
aparte	"apart, aside, apart from"
libremente	"freely, boldy, audaciously"
esencialmente	essentially
afuera	"outside, out"
considerablemente	considerably
puramente	purely
enteramente	"entirely, fully, quite"
públicamente	publically
*** 151 - 160 (/course/187382/spanish-adverbs-7/16/)	
simultáneamente	"simultaneously, at the same time"
brevemente	"briefly, succinctly, shortly"
enseguida	"immediately, promptly, directly"
seriamente	"seriously, sternly, gravely"
cuán	"how, as"
políticamente	politically
detrás	"behind, back, after"
activamente	actively
literalmente	"literally, verbatim, exactly"
desgraciadamente	"unfortunately, sadly"
*** 161 - 170 (/course/187382/spanish-adverbs-7/17/)	
firmemente	"firmly, steadily"
obviamente	obviously
adentro	"in, indoors"
formalmente	formally
estrictamente	strictly
estrechamente	"intimately, closely, painstakingly"
enormemente	"enormously, immensely, hugely"
despacio	"slowly, slow, gently"
expresamente	"expressly, specifically, on purpose"
abiertamente	"openly, outright, overtly"
*** 171 - 180 (/course/187382/spanish-adverbs-7/18/)	
usualmente	usually
gravemente	"gravely, seriously, badly"
anualmente	"annually, yearly"
permanentemente	permanently
cuidadosamente	"carefully, attentively, heedfully"
enfrente	"opposite, across from, facing"
antiguamente	"once, formerly, in the past"
notablemente	"markedly, notably, noticeably"
donde	"where, wherein"
históricamente	historically
*** 181 - 190 (/course/187382/spanish-adverbs-7/19/)	
económicamente	economically
gradualmente	gradually
buena	"well, so, OK"
sinceramente	"sincerely, heartily, genuinely"
últimamente	"lately, recently, of late"
adecuadamente	"suitably, adequately, appropriately"
debidamente	"due, properly, duly"
difícilmente	"hardly, barely, with difficulty"
eventualmente	"eventually, fortuitously, by chance"
automáticamente	automatically
*** 191 - 200 (/course/187382/spanish-adverbs-7/20/)	
legalmente	legally
mutuamente	"mutually, reciprocally"
antemano	"beforehand, ahead of time, in advance"
excesivamente	"excessively, exceedingly, unduly"
entretanto	"meantime, meanwhile, in the meantime"
extraordinariamente	"extraordinarily, remarkably, uncommonly"
mayoritariamente	"mainly, chiefly, by majority"
sucesivamente	"successively, in turn, in succession"
diariamente	"daily, every day, on a daily basis"
suavemente	"gently, smoothly, softly"
*** 201 - 210 (/course/187382/spanish-adverbs-7/21/)	
indudablemente	"certainly, undoubtedly, doubtlessly"
progresivamente	progressively
regularmente	"regularly, on a regular basis, normally"
afortunadamente	"fortunately, happily, luckily"
temporalmente	"temporarily, temporally"
meramente	"merely, simply"
ocasionalmente	occasionally
paralelamente	concurrently
radicalmente	radically
lógicamente	logically
*** 211 - 220 (/course/187382/spanish-adverbs-7/22/)	
voluntariamente	voluntarily
indirectamente	indirectly
íntegramente	entirely
típicamente	typically
físicamente	physically
popularmente	popularly
fuera	"out, outside, away"
positivamente	positively
francamente	"frankly, bluntly, plainly"
curiosamente	"curiously, with curiosity, curiously enough"
*** 221 - 230 (/course/187382/spanish-adverbs-7/23/)	
ende	"therefore, as a result, consequently"
inevitablemente	inevitably
significativamente	significantly
tranquilamente	"quietly, calmly, serenely"
explícitamente	explicitly
debajo	"below, beneath, under"
bruscamente	"suddenly, sharply, brusquely"
internacionalmente	internationally
intensamente	intensely
sistemáticamente	systematically
*** 231 - 240 (/course/187382/spanish-adverbs-7/24/)	
atentamente	"attentively, carefully, Yours Sincerely"
socialmente	socially
eternamente	"eternally, evermore"
repentinamente	suddenly
mejor	"best, better"
duramente	"harshly, hardly, hard"
primeramente	"first, firstly, first of all"
eficazmente	effectively
mayormente	"mainly, predominantly, principally"
diario	"daily, every day, everyday"
*** 241 - 250 (/course/187382/spanish-adverbs-7/25/)	
técnicamente	technically
gratis	"free, gratis"
raramente	"rarely, seldom"
paulatinamente	"gradually, little by little"
igual	"maybe, perhaps"
antaño	"yesteryear, in the past, formerly"
decididamente	decidedly
favorablemente	favorably
urgentemente	urgently
sustancialmente	substantially
*** 251 - 260 (/course/187382/spanish-adverbs-7/26/)	
súbitamente	suddenly
violentamente	violently
presuntamente	"allegedly, supposedly, presumably"
deliberadamente	"deliberately, intentionally"
enérgicamente	"energetically, strongly, forcibly"
infinitamente	"indefinitely, for ever, again and again"
periódicamente	periodically
adicionalmente	"additionally, further"
alegremente	"happily, joyfully, merrily"
íntimamente	"face to face, thick, inward, closer"
*** 261 - 270 (/course/187382/spanish-adverbs-7/27/)	
cual	as
negativamente	"negatively, adversely, in the negative"
ilegalmente	illegally
potencialmente	potentially
repetidamente	"repeatedly, time and time again"
fijamente	"fixedly, steadily, steadfastly"
próximamente	"shortly, soon"
detenidamente	"carefully, thoroughly, at length"
acertadamente	"opportunely, fitly"
jurídicamente	juridically
*** 271 - 280 (/course/187382/spanish-adverbs-7/28/)	
nada	"at all, nothing at all"
desafortunadamente	unfortunately
consecuentemente	"consequently, consistently, accordingly"
largamente	"long, largely, at length"
tristemente	"gloomily, sadly, sorrowfully"
deprisa	"quickly, rapidly, fast"
erróneamente	"erroneously, mistakenly"
levemente	"lightly, gently"
individualmente	"individually, singly"
seguidamente	"next, straightaway"
*** 281 - 290 (/course/187382/spanish-adverbs-7/29/)	
mentalmente	"mentally, by heart, from memory"
vivamente	"vividly, lively"
forzosamente	"necessarily, perforce, by force"
preferentemente	"preferentially, preferably"
juntamente	"jointly, at the same time, conjunctively"
eminentemente	eminently
excepcionalmente	exceptionally
alternativamente	"alternately, alternatively"
conscientemente	consciously
oportunamente	"at the appropriate time, opportunely, when opportune"
*** 291 - 300 (/course/187382/spanish-adverbs-7/30/)	
desesperadamente	"desperately, despairingly"
severamente	"severely, harshly, sharply"
espontáneamente	spontaneously
mundialmente	"globally, worldwide"
terriblemente	"terribly, deadly, frightfully"
contrariamente	contrary
felizmente	"happily, luckily, fortunately"
vagamente	vaguely
fielmente	"faithfully, truly"
indefinidamente	indefinitely
*** 301 - 310 (/course/187382/spanish-adverbs-7/31/)	
drásticamente	drastically
presumiblemente	presumably
inútilmente	"uselessly, needlessly, vainly"
reiteradamente	"repeatedly, reiteratedly"
secretamente	secretly
predominantemente	predominantly
teóricamente	theoretically
moralmente	morally
artificialmente	artificially
accidentalmente	"accidentally, unintentionally"
*** 311 - 320 (/course/187382/spanish-adverbs-7/32/)	
previsiblemente	predictedly
sobremanera	"exceedingly, extremely, greatly"
razonablemente	reasonably
gratuitamente	"free, for free, free of charge"
paradójicamente	paradoxically
virtualmente	virtually
rotundamente	"roundly, emphatically, completely"
visiblemente	visibly
brutalmente	"brutally, roughly"
administrativamente	administratively
*** 321 - 330 (/course/187382/spanish-adverbs-7/33/)	
originariamente	originally
sensiblemente	"noticeably, sorely, grievously"
unánimemente	unanimously
tremendamente	tremendously
internamente	internally
injustamente	"unfairly, unjustly"
localmente	locally
irónicamente	ironically
geográficamente	geographically
pacíficamente	"peaceably, pacifically, peacefully"
*** 331 - 340 (/course/187382/spanish-adverbs-7/34/)	
precipitadamente	"hastily, headlong"
detalladamente	"in detail, down to the last detail"
generosamente	generously
casualmente	by chance
instantáneamente	"instantly, immediately"
solemnemente	solemnly
convenientemente	"conveniently, suitably"
momentáneamente	"momentarily, for a moment"
netamente	clearly
militarmente	militarily
*** 341 - 350 (/course/187382/spanish-adverbs-7/35/)	
científicamente	scientifically
extensamente	"widely, extensively, wide"
increíblemente	incredibly
rigurosamente	firmly
sexualmente	sexually
escasamente	"scarcely, sparingly, barely"
masivamente	"on a massive scale, en masse"
provisionalmente	provisionally
sorprendentemente	surprisingly
apresuradamente	"hurriedly, hastily"
*** 351 - 360 (/course/187382/spanish-adverbs-7/36/)	
derecho	"right, straight"
minuciosamente	"meticulously, minutely"
objetivamente	"objectively, factually"
universalmente	universally
unilateralmente	unilaterally
dulcemente	"gently, sweetly, softly"
discretamente	discreetly
satisfactoriamente	satisfactorily
globalmente	globally
encarecidamente	"insistently, urgently"
*** 361 - 370 (/course/187382/spanish-adverbs-7/37/)	
extrañamente	"oddly, strangely"
inesperadamente	"unexpectedly, suddenly"
inconscientemente	"unconsciously, unwittingly"
grandemente	greatly
comercialmente	commercially
profesionalmente	professionally
doquier	"all around, everywhere"
genéticamente	genetically
silenciosamente	"silently, quietly, soundlessly"
pesadamente	heavily
*** 371 - 380 (/course/187382/spanish-adverbs-7/38/)	
respetuosamente	respectfully
invariablemente	invariably
recíprocamente	reciprocally
puntualmente	"promptly, duly, punctually"
instintivamente	"instinctively, naturally"
colectivamente	collectively
anteayer	"day before yesterday, the day before yesterday"
dondequiera	"anywhere, wherever"
incesantemente	"incessantly, unceasingly"
textualmente	literally
*** 381 - 390 (/course/187382/spanish-adverbs-7/39/)	
cuan	"as, how"
manifiestamente	manifestly
primordialmente	"basically, fundamentally"
cómodamente	"comfortably, snugly, in comfort"
simbólicamente	symbolically
involuntariamente	involuntarily
ricamente	richly
doblemente	doubly
singularmente	"singularly, peculiarly, oddly"
amargamente	bitterly
*** 391 - 400 (/course/187382/spanish-adverbs-7/40/)	
culturalmente	culturally
débilmente	weakly
máxime	"principally, especially, all the more since"
tímidamente	"timidly, shyly"
resueltamente	resolutely
sabiendas	"knowingly, wittingly, in the full knowledge that"
decisivamente	decisively
democráticamente	democratically
mal	"wrong, ill, poorly"
pocas	"moderately, fairly, somewhat"
*** 401 - 410 (/course/187382/spanish-adverbs-7/41/)	
indistintamente	"equally, indistinctly"
legítimamente	"legitimately, rightfully"
poderosamente	"powerfully, mightily"
admirablemente	admirably
implícitamente	implicitly
hábilmente	"skilfully, skillfully, ably"
allende	"beyond, on the other side"
misteriosamente	"mysteriously, darkly"
cruelmente	"cruelly, viciously"
otrora	"formerly, in bygone days"
*** 411 - 420 (/course/187382/spanish-adverbs-7/42/)	
densamente	"heavily, densely"
separadamente	"separately, severally, apart"
peligrosamente	dangerously
interiormente	"inwardly, internally, inward"
amablemente	"kindly, nicely, amiably"
irremediablemente	inevitably
obligatoriamente	"obligatory, mandatorily"
fríamente	"coldly, stiffly"
milagrosamente	miraculously
mortalmente	"mortally, deadly, fatally"
*** 421 - 430 (/course/187382/spanish-adverbs-7/43/)	
falsamente	falsely
prematuramente	prematurely
materialmente	materially
musicalmente	musically
exitosamente	successfully
marcadamente	markedly
verticalmente	"plumb, endlong, uprightly"
espiritualmente	spiritually
auténticamente	"truly, authentically, genuinely"
categóricamente	"definitely, flatly, positively"
*** 431 - 440 (/course/187382/spanish-adverbs-7/44/)	
aprisa	"quickly, apace, hurriedly"
cariñosamente	"lovingly, dearly, kindly"
proporcionalmente	"proportionately, proportionally"
cabalmente	"exactly, properly, fully"
velozmente	"fast, quickly, swiftly"
inmensamente	"immensely, hugely"
ordinariamente	ordinarily
pacientemente	patiently
arbitrariamente	arbitrarily
maravillosamente	"marvellously, wonderfully, beautifully"
*** 441 - 450 (/course/187382/spanish-adverbs-7/45/)	
matemáticamente	mathematically
humildemente	"humbly, lowly, plainly"
prontamente	"promptly, speedily"
furiosamente	"madly, fiercely"
penosamente	"painfully, arduously, with difficulty"
judicialmente	judicially
clandestinamente	"stealthily, underground"
cierta	certainly
mecánicamente	mechanically
afirmativamente	"affirmatively, positively"
*** 451 - 460 (/course/187382/spanish-adverbs-7/46/)	
horriblemente	"horribly, appallingly, frightfully"
dignamente	"worthily, fittingly, properly"
profusamente	"profusely, lavishly"
abruptamente	abruptly
artísticamente	artistically
financieramente	financially
notoriamente	notoriously
verbalmente	verbally
ciegamente	blindly
inequívocamente	unequivocally
*** 461 - 470 (/course/187382/spanish-adverbs-7/47/)	
moderadamente	moderately
escrupulosamente	scrupulously
indebidamente	"improperly, wrongfully, illegally"
medianamente	"moderately, middingly, meanly"
estadísticamente	statistically
frontalmente	frontally
vulgarmente	vulgarly
intencionadamente	intentionally
insistentemente	insistently
uniformemente	uniformly
*** 471 - 480 (/course/187382/spanish-adverbs-7/48/)	
innecesariamente	unnecessarily
semanalmente	"weekly, every week, each week"
maquinalmente	mechanically
sabiamente	"wisely, knowingly, learnedly"
llanamente	"straightforwardly, simply, adv"
impunemente	with impunity
cautelosamente	"cautiously, gingerly, guardedly"
emocionalmente	emotionally
cordialmente	"cordially, heartily, warmly"
remotamente	"vaguely, slightly, remotely"
*** 481 - 490 (/course/187382/spanish-adverbs-7/49/)	
cronológicamente	chronologically
ininterrumpidamente	"uninterruptedly, continuously"
constitucionalmente	constitutionally
mil	"thousand, one thousand"
ingenuamente	"ingenuously, naively"
vigorosamente	"strongly, vigorously, robustly"
tiernamente	"gently, kindly"
desdeñosamente	"scornfully, contemptuously"
dramáticamente	dramatically
dolorosamente	"painfully, distressingly"
*** 491 - 500 (/course/187382/spanish-adverbs-7/50/)	
visualmente	visually
incondicionalmente	"unconditionally, unreservedly"
manualmente	"manually, by hand"
esporádicamente	sporadically
horizontalmente	horizontally
sobradamente	"excessively, to excess, more than necessary"
abundantemente	"abundantly, lavishly, amply"
equitativamente	equitably
inteligentemente	intelligently
majestuosamente	majestically
*** 501 - 510 (/course/187382/spanish-adverbs-7/51/)	
ultranza	"to the death, to the end"
comparativamente	comparatively
inversamente	inversely
fatalmente	fatally
finamente	finely
indiscutiblemente	"indisputably, undeniably"
tempranamente	"early, prematurely"
incorrectamente	"incorrectly, improperly, wrong"
apasionadamente	"passionately, intensely, fervently"
gustosamente	"tastefully, gladly, acceptably"
*** 511 - 520 (/course/187382/spanish-adverbs-7/52/)	
tácitamente	tacitly
secamente	"dryly, morosely, crabbedly, peevishly"
intelectualmente	intellectually
sólidamente	"solidly, soundly"
superficialmente	"superficially, perfunctorily"
inexorablemente	inexorably
coloquialmente	colloquially
exteriormente	"externally, outward, outwards"
intrínsecamente	intrinsically
racionalmente	rationally
*** 521 - 530 (/course/187382/spanish-adverbs-7/53/)	
tecnológicamente	technologically
preferiblemente	preferably
tajantemente	"sharply, incisively, emphatically"
diametralmente	diametrically
regañadientes	reluctantly
torpemente	"awkwardly, clumsily"
gráficamente	"graphically, pictorially"
ruidosamente	"slapbang, obstreperously"
calurosamente	"warmly, ardently, hotly"
críticamente	critically
*** 531 - 540 (/course/187382/spanish-adverbs-7/54/)	
hondamente	"deeply, profoundly"
equivocadamente	"mistakenly, wrong, misguidedly"
análogamente	analogously
consiguientemente	consequently
cortésmente	"courteously, politely"
honestamente	honestly
eficientemente	efficiently
valientemente	"bravely, courageously, boldly"
ideológicamente	ideologically
apropiadamente	"appropriately, properly, suitably"
*** 541 - 550 (/course/187382/spanish-adverbs-7/55/)	
mensualmente	"monthly, every month, once a month"
modestamente	modestly
estratégicamente	strategically
genuinamente	genuinely
nominalmente	nominally
psicológicamente	psychologically
ansiosamente	"anxiously, hungrily"
anticipadamente	in advance
experimentalmente	experimentally
confusamente	"confusedly, vaguely"
*** 551 - 560 (/course/187382/spanish-adverbs-7/56/)	
despacito	slowly
orgullosamente	proudly
incansablemente	"tirelessly, untiringly"
humanamente	"humanely, humanly"
perpetuamente	perpetually
bruces	with the face to the ground
genéricamente	generically
groseramente	"rudely, vulgarly, nastily"
espléndidamente	splendidly
bajo	"down, low, below"
*** 561 - 570 (/course/187382/spanish-adverbs-7/57/)	
externamente	"externally, outwardly"
verbigracia	"for example, such as"
brillantemente	"brightly, bright"
exageradamente	exaggeratedly
delicadamente	"delicately, softly"
magníficamente	"magnificently, royally, splendidly"
seguro	"sure, for sure, for certain"
sorpresivamente	surprisingly
insensiblemente	insensibly
aisladamente	isolately
*** 571 - 580 (/course/187382/spanish-adverbs-7/58/)	
químicamente	chemically
exhaustivamente	"exhaustively, comprehensively, thoroughly"
ostensiblemente	ostensibly
asiduamente	assiduously
ávidamente	"hungrily, greedily"
intencionalmente	intentionally
ferozmente	"ferociously, fiercely"
descaradamente	"brazenly, shamelessly, openly"
estructuralmente	structurally
informalmente	informally
*** 581 - 590 (/course/187382/spanish-adverbs-7/59/)	
lateralmente	"laterally, sideways"
celosamente	"zealously, eagerly, fervently"
locamente	"madly, immoderately, extravagantly"
comoquiera	however
tardíamente	"late, belatedly"
lastimosamente	"pitifully, pathetically"
pobremente	poorly
prudentemente	prudently
graciosamente	"graciously, gracefully, amusingly"
cualitativamente	qualitatively
*** 591 - 600 (/course/187382/spanish-adverbs-7/60/)	
furtivamente	furtively
etimológicamente	etymologically
mínimamente	minimally
estrepitosamente	"deafeningly, noisily, loudly"
sutilmente	subtly
ardientemente	"ardently, hot, fervently"
magistralmente	masterfully
infructuosamente	"fruitlessly, unsuccessfully, unprofitably"
idealmente	ideally
asombrosamente	"amazingly, astonishingly"
*** 601 - 610 (/course/187382/spanish-adverbs-7/61/)	
frenéticamente	"frantically, frenziedly, furiously"
amistosamente	"friendly, amicably"
honradamente	"honorably, honestly"
oralmente	orally
sigilosamente	"stealthily, secretly, on the sly"
cuclillas	"squatting, crouch"
vilo	"in the air, up in the air, in suspense"
nerviosamente	nervously
tenazmente	tenaciously
terminantemente	strictly
*** 611 - 620 (/course/187382/spanish-adverbs-7/62/)	
cero	zero
deliciosamente	"delightfully, lovely"
trágicamente	tragically
agradablemente	"pleasantly, nicely, agreeably"
obstinadamente	obstinately
indefectiblemente	inevitably
inexplicablemente	inexplicably
quirúrgicamente	surgically
primariamente	primarily
afectuosamente	"affectionately, fondly"
*** 621 - 630 (/course/187382/spanish-adverbs-7/63/)	
perdidamente	"madly, hopelessly in love"
infaliblemente	"infallibly, surely"
familiarmente	familiarly
numéricamente	numerically
serenamente	serenely
toscamente	"roughly, crudely"
espectacularmente	spectacularly
funcionalmente	functionally
prioritariamente	priority
modernamente	modern
*** 631 - 640 (/course/187382/spanish-adverbs-7/64/)	
incomparablemente	"incomparably, beyond compare"
adrede	"intentionally, on purpose"
concienzudamente	thoroughly
desmesuradamente	"disproportionately, excessively"
cotidianamente	daily
irremisiblemente	"irremissibly, irretrievably"
consecutivamente	consecutively
fervientemente	fervently
herméticamente	"hermetically, tightly, tight"
definidamente	definitely
*** 641 - 650 (/course/187382/spanish-adverbs-7/65/)	
interinamente	temporarily
vertiginosamente	"dizzily, giddily"
trabajosamente	laboriously
acullá	"over there, yonder"
primitivamente	"primitively, at first"
hurtadillas	"sneak in, sneak out, sneak around"
conceptualmente	conceptually
intuitivamente	intuitively
peor	"worse, worst"
religiosamente	religiously
*** 651 - 660 (/course/187382/spanish-adverbs-7/66/)	
inusualmente	unusually
empíricamente	empirically
despectivamente	"pejoratively, contemptuously, scornfully"
triunfalmente	triumphantly
cuantitativamente	quantitatively
eléctricamente	electrically
irregularmente	irregularly
amorosamente	"lovingly, affectionately"
similarmente	similarly
salvajemente	"savagely, wildly"
*** 661 - 670 (/course/187382/spanish-adverbs-7/67/)	
miserablemente	miserably
elegantemente	"stylishly, fashionably"
territorialmente	territorially
fugazmente	"briefly, fleetingly"
divinamente	divinely
indiscriminadamente	indiscriminately
meticulosamente	"meticulously, precisely"
reglamentariamente	"in due form, according to the rules"
doquiera	wherever
distintamente	distinctly
*** 671 - 680 (/course/187382/spanish-adverbs-7/68/)	
victoriosamente	victoriously
ordenadamente	orderly
distraídamente	absent-mindedly
aleatoriamente	randomly
heroicamente	heroically
convencionalmente	conventionally
poca	"moderately, fairly, somewhat"
insuficientemente	insufficiently
afablemente	"affably, genially"
bellamente	beautifully
*** 681 - 690 (/course/187382/spanish-adverbs-7/69/)	
disimuladamente	"covertly, secretly"
pasivamente	passively
lindamente	"prettily, daintily"
limpiamente	cleanly
maliciosamente	"maliciously, spitefully, mischievously"
perpendicularmente	perpendicularly
solidariamente	"jointly, mutually"
crecientemente	increasingly
imperiosamente	"imperiously, urgently"
implacablemente	"implacably, relentlessly"
*** 691 - 700 (/course/187382/spanish-adverbs-7/70/)	
pocos	"moderately, fairly, somewhat"
rítmicamente	rhythmically
estúpidamente	stupidly
lealmente	"loyally, faithfully"
substancialmente	substantially
institucionalmente	institutionally
metafóricamente	metaphorically
prestamente	"speedily, promptly, quickly"
digitalmente	digitally
seguido	"directly, straight, frequently"
*** 701 - 710 (/course/187382/spanish-adverbs-7/71/)	
transitoriamente	transitorily
despiadadamente	"cruelly, mercilessly, relentlessly"
vanamente	"vainly, idly"
imperceptiblemente	imperceptibly
contra	against
subrepticiamente	surreptitiously
ulteriormente	"further, beyond"
subsidiariamente	in a subsidiary manner
indisolublemente	indissolubly
industrialmente	industrially
*** 711 - 720 (/course/187382/spanish-adverbs-7/72/)	
penalmente	criminally
filosóficamente	philosophically
incidentalmente	incidentally
quemarropa	at point blank range
biológicamente	biologically
cumplidamente	"completely, complimentally"
enfáticamente	emphatically
rectamente	"aright, fairly, uprightly"
recien	"freshly, recently, newly"
nítidamente	"clearly, sharply"
*** 721 - 730 (/course/187382/spanish-adverbs-7/73/)	
clínicamente	clinically
valerosamente	"bravely, valiantly, courageously"
longitudinalmente	"longitudinally, lengthwise, lengthways"
estupendamente	"terrifically, marvellously, wonderfully"
electoralmente	electorally
pésimamente	"awfully, dreadfully"
gratamente	"graciously, gratefully"
sordamente	"dully, in a muffled way"
extensivamente	extensively
rígidamente	"rigidly, stiffly"
*** 731 - 740 (/course/187382/spanish-adverbs-7/74/)	
calladamente	"quietly, silently"
pausadamente	"slowly, easy, gently"
oblicuamente	"obliquely, slantwise, aslant"
arduamente	arduously
convulsivamente	convulsively
ridículamente	ridiculously
linealmente	linearly
corrientemente	currently
diligentemente	diligently
étnicamente	ethnically
*** 741 - 750 (/course/187382/spanish-adverbs-7/75/)	
transversalmente	"transversely, across"
estéticamente	"aesthetically, esthetically"
exponencialmente	exponentially
electrónicamente	electronically
benévolamente	benevolently
constructivamente	constructively
geológicamente	geologically
inadvertidamente	inadvertently
justificadamente	justifiably
derechamente	"straightly, directly"
*** 751 - 760 (/course/187382/spanish-adverbs-7/76/)	
coherentemente	coherently
copiosamente	"copiously, abundantly, plentifully"
perezosamente	"indolently, lazily"
sentimentalmente	sentimentally
señaladamente	"clearly, distinctly, especially"
aceleradamente	"rapidly, hastily"
ocultamente	"secretly, mysteriously, stealthily"
subjetivamente	subjectively
absurdamente	absurdly
malamente	badly
*** 761 - 770 (/course/187382/spanish-adverbs-7/77/)	
metódicamente	methodically
plácidamente	placidly
anormalmente	abnormally
piadosamente	"mercifully, piously"
lento	"slowly, slow"
vehementemente	"vehemently, fervently, forcibly"
espantosamente	"frightfully, shockingly, terrifyingly"
lastimeramente	"sadly, sorrowfully"
morfológicamente	morphologically
buenamente	"easily, without difficulty, willingly"
*** 771 - 780 (/course/187382/spanish-adverbs-7/78/)	
quedamente	quietly
mágicamente	magically
livianamente	"in a fickle way, frivolously, lewdly"
inherentemente	inherently
melancólicamente	"melancholically, gloomily, moodily"
exquisitamente	exquisitely
afanosamente	"diligently, feverishly"
retrospectivamente	retrospectively
bravamente	"bravely, gamely"
agudamente	"sharply, lively, keenly"
*** 781 - 790 (/course/187382/spanish-adverbs-7/79/)	
excelentemente	excellently
dinámicamente	dynamically
apaciblemente	"mildly, gently"
simétricamente	symmetrically
desproporcionadamente	disproportionately
intermitentemente	intermittently
sumariamente	summarily
astutamente	"astutely, craftily"
fieramente	fiercely
abrumadoramente	"crushingly, overwhelmingly"
*** 791 - 800 (/course/187382/spanish-adverbs-7/80/)	
efusivamente	effusively
lingüísticamente	linguistically
devotamente	devoutly
prodigiosamente	prodigiously
cercanamente	"closely, close"
sucintamente	succinctly
denodadamente	"boldly, dauntlessly, intrepidly"
agresivamente	aggressively
febrilmente	"feverishly, hectically"
literariamente	literary
*** 801 - 810 (/course/187382/spanish-adverbs-7/81/)	
estilísticamente	stylistically
amigablemente	amicably
imprudentemente	"unwisely, imprudently"
armoniosamente	harmoniously
impecablemente	"impeccably, faultlessly"
animadamente	"animatedly, lively"
selectivamente	selectively
canónicamente	canonically
privadamente	privately
espacialmente	spatially
*** 811 - 820 (/course/187382/spanish-adverbs-7/82/)	
mansamente	"gently, meekly"
burlonamente	mockingly
noblemente	nobly
bocajarro	"point-blank, straight out"
válidamente	validly
clásicamente	classically
ecológicamente	ecologically
desordenadamente	disorderly
oscuramente	obscurely
escandalosamente	scandalously
*** 821 - 830 (/course/187382/spanish-adverbs-7/83/)	
anónimamente	anonymously
someramente	superficially
éticamente	ethically
jerárquicamente	hierarchically
irrevocablemente	irrevocably
fehacientemente	reliably
responsablemente	responsibly
armónicamente	harmonically
diestramente	"skilfully, nimbly, neatly"
desigualmente	unequally
*** 831 - 840 (/course/187382/spanish-adverbs-7/84/)	
holgadamente	"comfortably, loosely"
ambientalmente	environmentally
laboriosamente	industriously
fiscalmente	fiscally
dócilmente	"meekly, obediently, gently"
rabiosamente	rabidly
rudamente	roughly
salvo	"unless, excepting if"
consistentemente	consistently
horcajadas	"astride, straddling"
*** 841 - 850 (/course/187382/spanish-adverbs-7/85/)	
nacionalmente	nationally
decentemente	"respectably, decently"
cínicamente	cynically
tontamente	"foolishly, stupidly"
incomprensiblemente	incomprehensibly
prolijamente	"neatly, long-windedly"
poéticamente	poetically
destiempo	"late, at the wrong time"
académicamente	academically
cobardemente	cowardly
*** 851 - 860 (/course/187382/spanish-adverbs-7/86/)	
atrozmente	"atrociously, outrageously"
gramaticalmente	grammatically
imperfectamente	imperfectly
lujosamente	"luxuriously, lavishly"
desinteresadamente	"disinterestedly, with disinterest"
indiferentemente	indifferently
secundariamente	secondarily
tácticamente	tactically
precozmente	"early, prematurely"
gloriosamente	gloriously
*** 861 - 870 (/course/187382/spanish-adverbs-7/87/)	
atropelladamente	"hastily, hurriedly, in a rush"
intensivamente	intensively
buenas	"well, so, OK"
tenuemente	slightly
audazmente	"boldly, audaciously"
documentalmente	documentary
interminablemente	"endlessly, interminably"
alternadamente	alternately
característicamente	characteristically
desagradablemente	disagreeably
*** 871 - 880 (/course/187382/spanish-adverbs-7/88/)	
certeramente	accurately
elocuentemente	"eloquently, glibly"
perceptiblemente	"perceptibly, noticeably"
pretendidamente	"supposedly, allegedly"
sobre	about
confidencialmente	confidentially
geométricamente	geometrically
fonéticamente	phonetically
ásperamente	"roughly, harshly, acidly"
ventajosamente	"advantageously, profitably"
*** 881 - 890 (/course/187382/spanish-adverbs-7/89/)	
confiadamente	confidently
hipócritamente	hypocritically
atinadamente	"rightly, correctly"
diversamente	diversely
evolutivamente	evolutionarily
extremamente	extremely
ahorita	"right away, at once, straight away"
correlativamente	correspondingly
crudamente	crudely
ineludiblemente	inescapably
*** 891 - 900 (/course/187382/spanish-adverbs-7/90/)	
inopinadamente	"unexpectedly, unawares"
extraoficialmente	"unofficially, informally"
sosegadamente	"quietly, calmly, gently"
merecidamente	deservedly
fervorosamente	fervently
injustificadamente	unjustifiably
alfabéticamente	alphabetically
contundentemente	"cogently, forcefully, forcibly"
contemporáneamente	contemporaneously
anímicamente	emotionally
*** 901 - 910 (/course/187382/spanish-adverbs-7/91/)	
psíquicamente	psychically
sospechosamente	suspiciously
impetuosamente	impetuously
deportivamente	"athletically, sportingly"
diagonalmente	diagonally
integralmente	integrally
peculiarmente	peculiarly
lacónicamente	laconically
escuetamente	"plainly, baldly"
reciamente	"strongly, intensely"
*** 911 - 920 (/course/187382/spanish-adverbs-7/92/)	
cíclicamente	cyclically
temerariamente	"recklessly, rashly"
sintéticamente	synthetically
sarcásticamente	sarcastically
imperativamente	imperatively
inseparablemente	inseparably
útilmente	usefully
airadamente	angrily
iguales	"maybe, perhaps"
pomposamente	pompously
*** 921 - 930 (/course/187382/spanish-adverbs-7/93/)	
analíticamente	analytically
tercamente	"stubbornly, obstinately"
vilmente	vilely
lejanamente	distantly
impropiamente	"improperly, amiss"
secuencialmente	sequentially
telepáticamente	telepathically
muy	"very, too, much"
acaloradamente	"warmly, with vehemency"
ejemplarmente	in exemplary fashion
*** 931 - 940 (/course/187382/spanish-adverbs-7/94/)	
artesanalmente	handmade
preventivamente	preventively
ritualmente	ritually
sombríamente	"sombrely, darkly"
hermosamente	"beautifully, lovely"
compulsivamente	compulsively
diferentemente	differently
retroactivamente	retroactively
sensatamente	sensibly
descuidadamente	carelessly
*** 941 - 950 (/course/187382/spanish-adverbs-7/95/)	
fraudulentamente	fraudulently
desfavorablemente	unfavourably
defensivamente	defensively
obsesivamente	obsessively
oficiosamente	officiously
esquemáticamente	schematically
semánticamente	semantically
buenos	"well, so, OK"
gozosamente	joyfully
lánguidamente	languidly
*** 951 - 960 (/course/187382/spanish-adverbs-7/96/)	
médicamente	medically
precariamente	precariously
incuestionablemente	unquestionably
fisiológicamente	physiologically
circunstancialmente	circumstantially
comprensiblemente	comprehensibly
ingeniosamente	"ingeniously, cleverly, wittily"
innegablemente	undeniably
provisoriamente	temporarily
cristianamente	christianly
*** 961 - 970 (/course/187382/spanish-adverbs-7/97/)	
convincentemente	convincingly
encarnizadamente	"fiercely, bloodily"
impacientemente	impatiently
despreocupadamente	"nonchalantly, in a carefree way"
rutinariamente	routinely
coordinadamente	coordinately
premeditadamente	deliberately
irresponsablemente	irresponsibly
taxativamente	"specifically, in a restricted sense"
abreviadamente	"brief, succinctly"
*** 971 - 980 (/course/187382/spanish-adverbs-7/98/)	
diplomáticamente	diplomatically
grotescamente	grotesquely
arquitectónicamente	architecturally
abstractamente	abstractedly
autónomamente	autonomously
ceremoniosamente	ceremoniously
aceptablemente	acceptably
ilícitamente	illicitly
veladamente	in a veiled way
irreversiblemente	irreversibly
*** 981 - 990 (/course/187382/spanish-adverbs-7/99/)	
negligentemente	negligently
bárbaramente	barbarously
centralmente	centrally
corporalmente	"corporally, bodily"
energéticamente	energetically
fraternalmente	"fraternally, brotherly"
santamente	holy
llamativamente	strikingly
contrapelo	"against, in the opposite direction to that in which the hair grows, the wrong way"
angustiosamente	"distressingly, in an anguished voice"
*** 991 - 1000 (/course/187382/spanish-adverbs-7/100/)	
persistentemente	persistently
apreciablemente	appreciably
creativamente	creatively
inadecuadamente	inadequately
férreamente	tightly
demográficamente	demographically
racialmente	racially
avante	"ahead, forward"
entrañablemente	"dearly, deeply"
ágilmente	"lightly, nimbly"
*** 1001 - 1010 (/course/187382/spanish-adverbs-7/101/)	
insoportablemente	"unbearably, intolerably"
bondadosamente	"kindly, good-naturedly"
servilmente	slavishly
anatómicamente	anatomically
cómicamente	"comically, funnily"
educadamente	educatedly
gallardamente	"gracefully, gallantly, dashingly"
idénticamente	identically
desaforadamente	outrageously
perennemente	perennially
*** 1011 - 1020 (/course/187382/spanish-adverbs-7/102/)	
afectivamente	affectively
ignominiosamente	ignominiously
verosímilmente	in a likely way
estoicamente	stoically
amenazadoramente	threateningly
complementariamente	complementarily
contradictoriamente	contradictorily
desconsoladamente	disconsolately
fortuitamente	fortuitously
marginalmente	marginally
*** 1021 - 1030 (/course/187382/spanish-adverbs-7/103/)	
neciamente	"foolishly, stupidly"
porcentualmente	"in a percentage terms, percentage-wise"
insólitamente	"unusually, unwontedly"
indignamente	"unworthily, contemptibly, meanly"
dificultosamente	with difficulty
juiciosamente	judiciously
obligadamente	obligatorily
cuerdamente	"sanely, wisely, sensibly"
tangencialmente	tangentially
abusivamente	abusively
*** 1031 - 1040 (/course/187382/spanish-adverbs-7/104/)	
pulcramente	"neatly, nattily, tidily"
semejantemente	"similarly, likewise"
arqueológicamente	archaeologically
calmadamente	calmly
fluidamente	"fluently, articulately"
trimestralmente	quarterly
equivalentemente	equivalently
forzadamente	forcibly
regionalmente	regionally
inusitadamente	unusually
*** 1041 - 1050 (/course/187382/spanish-adverbs-7/105/)	
vitalmente	vitally
intramuros	"within the city, within the walls"
animosamente	"bravely, with spirit, in lively fashion"
lúgubremente	gloomily
jocosamente	"humorously, comically, jokingly"
jovialmente	jovially
obedientemente	obediently
fantásticamente	fantastically
aposta	"on purpose, deliberately"
sonoramente	sonorously
*** 1051 - 1060 (/course/187382/spanish-adverbs-7/106/)	
subsiguientemente	subsequently
apretadamente	tightly
imparcialmente	impartially
tentativamente	tentatively
desdichadamente	unhappily
flagrantemente	flagrantly
liberalmente	liberally
ofensivamente	offensively
ilimitadamente	unlimited
artificiosamente	artificially
*** 1061 - 1070 (/course/187382/spanish-adverbs-7/107/)	
civilmente	civilly
correspondientemente	correspondingly
laboralmente	occupationally
agriamente	sourly; with asperity or harshness.
térmicamente	thermally
esmeradamente	"carefully, neatly, elegantly"
figuradamente	figuratively
insolentemente	insolently
magnéticamente	magnetically
fanáticamente	fanatically
*** 1071 - 1080 (/course/187382/spanish-adverbs-7/108/)	
indolentemente	indolently
dichosamente	"luckily, fortunately"
patéticamente	pathetically
alarmantemente	alarmingly
bonitamente	"nicely, neatly, craftily"
óptimamente	optimally
teatralmente	theatrically
coincidentemente	coincidentally
criminalmente	criminally
monstruosamente	monstrously
*** 1081 - 1090 (/course/187382/spanish-adverbs-7/109/)	
plásticamente	plastically
reflexivamente	reflexively
perversamente	wickedly
cautamente	cautiously
perentoriamente	peremptorily
fotográficamente	photographically
radialmente	radially
deficientemente	deficiently
burdamente	grossly
declaradamente	"professedly, openly"
*** 1091 - 1100 (/course/187382/spanish-adverbs-7/110/)	
voluptuosamente	voluptuously
fragmentariamente	fragmentarily
olímpicamente	loftily
reverentemente	reverently
románticamente	romantically
infatigablemente	"tirelessly, untiringly"
unitariamente	unitarily
ventralmente	ventrally
clamorosamente	clamorously
compasivamente	compassionately
*** 1101 - 1110 (/course/187382/spanish-adverbs-7/111/)	
peyorativamente	pejoratively
pertinentemente	pertinently
estatutariamente	statutorily
causalmente	causally
extrajudicialmente	extrajudicially
honrosamente	honorably
qué	how
fatigosamente	"painfully, with difficulty"
filogenéticamente	phylogenetically
pragmáticamente	pragmatically
*** 1111 - 1120 (/course/187382/spanish-adverbs-7/112/)	
traidoramente	treacherously
solapadamente	"underhandedly, slyly, sneakily"
desmedidamente	disproportionately
ostentosamente	ostentatiously
sobriamente	soberly
incómodamente	"uncomfortably, inconveniently"
confortablemente	comfortably
dudosamente	doubtfully
eufemísticamente	euphemistically
impulsivamente	impulsively
*** 1121 - 1130 (/course/187382/spanish-adverbs-7/113/)	
siniestramente	"sinistrously, perversely"
supremamente	supremely
estruendosamente	"thunderously, noisily, uproariously"
provechosamente	"usefully, advantageously, beneficially"
cándidamente	candidly
temerosamente	fearfully
tumultuosamente	tumultuously
infortunadamente	unfortunately
diabólicamente	diabolically
dogmáticamente	dogmatically
*** 1131 - 1140 (/course/187382/spanish-adverbs-7/114/)	
placenteramente	"pleasingly, tastefully, agreeably"
razonadamente	reasonably
resignadamente	resignedly
metafísicamente	metaphysically
sentenciosamente	sententiously
desvergonzadamente	shamelessly
indeciblemente	"unspeakably, indescribably"
vocalmente	vocally
encubiertamente	"covertly, secretly, deceitfully"
benignamente	"kindly, benignly"
*** 1141 - 1150 (/course/187382/spanish-adverbs-7/115/)	
preponderantemente	preponderantly
semestralmente	"semiannually, half-yearly"
sociológicamente	sociologically
asexualmente	asexually
dialécticamente	dialectically
inconcebiblemente	inconceivably
paternalmente	paternally
irreflexivamente	"thoughtlessly, unthinkingly"
insensatamente	"thoughtlessly, wildly"
impensadamente	unexpectedly
*** 1151 - 1160 (/course/187382/spanish-adverbs-7/116/)	
osadamente	"boldly, daringly"
engañosamente	"deceitfully, fraud-fully, guilefully"
monótonamente	droningly
galantemente	"gallantly, charmingly, attentively"
irracionalmente	irrationally
malignamente	malignantly
presurosamente	"quickly, promptly, hastily"
retóricamente	rhetorically
alevosamente	"treacherously, guilefuly"
sangrientamente	"bloodily, cruelly"
*** 1161 - 1170 (/course/187382/spanish-adverbs-7/117/)	
circularmente	circularly
concurrentemente	concurrently
místicamente	mystically
escalonadamente	"stepwise, step by step"
ardorosamente	ardently
discrecionalmente	discretionally
sanamente	healthily
roncamente	"huskily, raucously"
mediatamente	mediately
agitadamente	nervously
*** 1171 - 1180 (/course/187382/spanish-adverbs-7/118/)	
palpablemente	palpably
sagazmente	sagaciously
sumisamente	"submissively, obediently"
suntuosamente	"sumptuously, richly"
fallidamente	unsuccessfully
solitariamente	"alone, lonely"
ambiguamente	ambiguously
despóticamente	despotically
genialmente	"ingeniously, brilliantly"
irreparablemente	irreparably
*** 1181 - 1190 (/course/187382/spanish-adverbs-7/119/)	
limitadamente	limitedly
operativamente	operatively
palmariamente	"plainly, clearly"
providencialmente	providentially
sensualmente	sensually
soberbiamente	supremely
rematadamente	"terribly, hopelessly"
resumidamente	briefly
desastrosamente	disastrously
enigmáticamente	enigmatically
*** 1191 - 1200 (/course/187382/spanish-adverbs-7/120/)	
festivamente	festively
airosamente	"gracefully, elegantly"
indispensablemente	indispensably
menudamente	minutely
sintácticamente	syntactically
termodinámicamente	thermodynamically
inconfundiblemente	unmistakably
infantilmente	childishly
expresivamente	expressly
mancomunadamente	"jointly, together, by common consent"
*** 1201 - 1210 (/course/187382/spanish-adverbs-7/121/)	
jubilosamente	"jubilantly, joyfully"
ópticamente	optically
pasablemente	"passably, tolerably"
acompasadamente	rhythmically
mucha	"ages, long, a lot"
arrogantemente	arrogantly
condenadamente	"damned, darned"
decorosamente	decorously
homogéneamente	homogeneously
imaginariamente	imaginatively
*** 1211 - 1220 (/course/187382/spanish-adverbs-7/122/)	
ajustadamente	"justly, rightly"
lícitamente	"lawfully, justly"
revolucionariamente	revolutionary
subterráneamente	subterraneously
cinematográficamente	cinematically
esforzadamente	"enterprisingly, vigorously"
intrépidamente	"intrepidly, fearlessly"
secularmente	secularly
infelizmente	"unluckily, unhappily, unfortunately"
autoritariamente	authoritatively
*** 1221 - 1230 (/course/187382/spanish-adverbs-7/123/)	
castamente	"chastely, purely"
dorsalmente	dorsally
horrorosamente	"dreadfully, terribly"
honorablemente	honorably
aparatosamente	"ostentatiously, showily, pretentiously"
subconscientemente	subconsciously
adondequiera	"wherever, wheresoever"
doctrinalmente	doctrinally
ahincadamente	earnestly
egoístamente	"egoistically, egotistically"
*** 1231 - 1240 (/course/187382/spanish-adverbs-7/124/)	
impresionantemente	impressively
inhumanamente	inhumanly
lúcidamente	lucidly
patentemente	patently
procesalmente	procedurally
reservadamente	reservedly
superiormente	superiorly
imprevistamente	unexpectedly
alocadamente	"wildly, crazily, recklessly"
continuadamente	continuously
*** 1241 - 1250 (/course/187382/spanish-adverbs-7/125/)	
altivamente	"haughtily, arrogantly"
candorosamente	"innocently, guiltlessly, simply"
inicuamente	inquitously
cortamente	"sparingly, frugally, scantily"
cuál	as
concluyentemente	conclusively
defectuosamente	defectively
vivencialmente	experientially
inexcusablemente	inexcusably
legislativamente	legislatively
*** 1251 - 1260 (/course/187382/spanish-adverbs-7/126/)	
prolongadamente	lengthily
líricamente	lyrically
estáticamente	statically
acústicamente	acoustically
clarísimamente	clarismatically
difusamente	diffusely
efímeramente	ephemerally
ficticiamente	fictitiously
histéricamente	hysterically
entrecortadamente	"in a laboured way, falteringly, hesitatingly"
*** 1261 - 1270 (/course/187382/spanish-adverbs-7/127/)	
pérfidamente	"perfidiously, treacherously"
trivialmente	trivially
vistosamente	"brightly, colourfully"
caritativamente	charitably
encantadoramente	"charmingly, delightfully"
redondamente	circularly
insidiosamente	insidiously
parsimoniosamente	parsimoniously
policialmente	policed
ancestralmente	ancestrally
*** 1271 - 1280 (/course/187382/spanish-adverbs-7/128/)	
carnalmente	carnally
precavidamente	cautiously
crónicamente	chronically
competentemente	"efficiently, competently"
ociosamente	idly
indeleblemente	indelibly
solícitamente	"solicitously, diligently"
telegráficamente	telegraphically
tendencialmente	tendentially
visceralmente	viscerally
*** 1281 - 1290 (/course/187382/spanish-adverbs-7/129/)	
apicalmente	apically
discutiblemente	arguably
evasivamente	evasively
instrumentalmente	instrumentally
invenciblemente	invincibly
metodológicamente	methodologically
vorazmente	voraciously
disciplinadamente	with discipline
ilusoriamente	illusory
muellemente	"softly, tenderly, gently"
*** 1291 - 1300 (/course/187382/spanish-adverbs-7/130/)	
torrencialmente	torrentially
puerilmente	childishly
constitutivamente	constitutively
explosivamente	explosively
informativamente	informationally
acusadamente	markedly
preceptivamente	preceptively
escénicamente	scenically
calmosamente	"calmly, slowly, sluggishly"
arteramente	"cunningly, artfully"
*** 1301 - 1310 (/course/187382/spanish-adverbs-7/131/)	
desapasionadamente	dispassionately
inquietantemente	disturbingly
emotivamente	emotionally
formidablemente	formidably
torvamente	grimly
intolerablemente	intolerably
irrefutablemente	irrefutably
pródigamente	"lavishly, unsparingly"
comprensivamente	patiently
pedagógicamente	pedagogically
*** 1311 - 1320 (/course/187382/spanish-adverbs-7/132/)	
preciosamente	"richly, lovely"
improvisadamente	"unexpectedly, suddenly"
desenfrenadamente	"wildly, in an uncontrolled way"
ácidamente	acidly
elásticamente	elastically
entusiastamente	enthusiastically
exprofeso	"expressly, on purpose, deliberately"
fabulosamente	fabulously
indescriptiblemente	indescribably
logísticamente	logistically
*** 1321 - 1330 (/course/187382/spanish-adverbs-7/133/)	
platónicamente	platonically
insepulto	unburied
flojamente	"weakly, feebly"
cansinamente	"wearily, lifelessly"
astronómicamente	astronomically
coyunturalmente	circumstantially
indiscretamente	"indiscreetly, tactlessly"
inflexiblemente	inflexibly
sicológicamente	psychologically
restrictivamente	restrictively
*** 1331 - 1340 (/course/187382/spanish-adverbs-7/134/)	
virtuosamente	virtuously
condicionalmente	conditionally
cooperativamente	cooperatively
distintivamente	distinctly
duraderamente	durably
existencialmente	existentially
erradamente	"mistakenly, amiss"
pictóricamente	pictorially
sensorialmente	sensory
espasmódicamente	spasmodically
*** 1341 - 1350 (/course/187382/spanish-adverbs-7/135/)	
anecdóticamente	anecdotally
basalmente	basally
comunalmente	communally
concomitantemente	concomitantly
covalentemente	covalently
equívocamente	equivocally
imaginativamente	imaginatively
impúdicamente	impudently
interrogativamente	interrogatively
farmacológicamente	pharmacologically
*** 1351 - 1360 (/course/187382/spanish-adverbs-7/136/)	
reposadamente	"quietly, gently, restfully"
acremente	"sharply, bitterly"
establemente	stably
sincrónicamente	synchronously
verazmente	truthfully
endiabladamente	"uglily, abominably, devlishly"
incautamente	"unwarily, incautiously"
expertamente	"adeptly, skillfully"
argumentalmente	arguably
famosamente	famously
*** 1361 - 1370 (/course/187382/spanish-adverbs-7/137/)	
ineluctablemente	ineluctably
inviolablemente	inviolably
ontológicamente	ontologically
patológicamente	pathologically
regiamente	"royally, regally, kingly"
vanidosamente	vainly
anchamente	"broadly, widely"
calculadamente	calculatedly
hidrológicamente	hydrologically
invisiblemente	invisibly
*** 1371 - 1380 (/course/187382/spanish-adverbs-7/138/)	
medicinalmente	medicinally
obscenamente	obscenely
parlamentariamente	"parliamentary, congressionally"
temblorosamente	shakily
arrebatadamente	"suddenly, violently, headlong"
tiránicamente	tyrannically
cansadamente	"wearily, in a tired way"
disparatadamente	"absurdly, nonsensically"
asquerosamente	"disgustingly, nauseatingly, foully"
saludablemente	healthily
*** 1381 - 1390 (/course/187382/spanish-adverbs-7/139/)	
incompletamente	incompletely
luminosamente	luminously
maduramente	maturely
máximamente	maximally
ominosamente	ominously
procesionalmente	processionally
proverbialmente	proverbially
inapropiadamente	inappropriately
inefablemente	ineffably
insaciablemente	insatiably
*** 1391 - 1400 (/course/187382/spanish-adverbs-7/140/)	
potentemente	potently
colegiadamente	collegially
dictatorialmente	dictatorially
ignorantemente	ignorantly
privativamente	privatively
rústicamente	rustically
supersticiosamente	superstitiously
ambiciosamente	ambitiously
antier	day before yesterday
didácticamente	didactically
*** 1401 - 1410 (/course/187382/spanish-adverbs-7/141/)	
catastróficamente	disastrously
parejamente	"evenly, equally"
falazmente	fallaciously
pavorosamente	"frighteningly, terringly"
geopolíticamente	geopolitically
hospitalariamente	hospitably
inmaculadamente	immaculately
imperturbablemente	imperturbably
conocidamente	"knowingly, evidently, confessedly"
opuestamente	oppositely
*** 1411 - 1420 (/course/187382/spanish-adverbs-7/142/)	
milimétricamente	"precisely, minutely"
preferencialmente	preferentially
aturdidamente	"recklessly, thought-lessly"
concertadamente	"regularly, orderly, methodically"
reproductivamente	reproductively
tópicamente	topically
accesoriamente	accessorily
muchas	"ages, long, a lot"
antropológicamente	anthropologically
caballerosamente	cavalierly
*** 1421 - 1430 (/course/187382/spanish-adverbs-7/143/)	
coactivamente	coercively
deslealmente	"disloyally, unfairly"
relajadamente	"dissolutely, licentiously"
frívolamente	frivolously
inminentemente	imminently
maternalmente	"maternally, motherly"
metabólicamente	metabolically
parcamente	"sparingly, frugally"
conmovedoramente	"touchingly, movingly"
analógicamente	analogically
*** 1431 - 1440 (/course/187382/spanish-adverbs-7/144/)	
deshonestamente	"dishonourably, disgracefully"
entusiásticamente	enthusiastically
igualitariamente	equally
gravísimamente	grievously
feamente	"hideously, terribly"
mesuradamente	measurably
misericordiosamente	mercifully
mudamente	"mutely, silently, tacitly"
seductoramente	seductively
impasiblemente	"stolidly, stoically, insensibly"
*** 1441 - 1450 (/course/187382/spanish-adverbs-7/145/)	
subliminalmente	subliminally
junto	"together, alongside, beside"
acríticamente	uncritically
premonitoriamente	as a warning
astrológicamente	astrologically
corriendo	"at a run, at the double"
publicitariamente	by advertising
notarialmente	by legal process
desgaire	"carelessly, slovenliness"
desatinadamente	foolishly
*** 1451 - 1460 (/course/187382/spanish-adverbs-7/146/)	
grandiosamente	grandiosely
inconsideradamente	inconsiderately
monetariamente	monetarily
quietamente	quietly
congruentemente	congruently
destructivamente	destructively
periodísticamente	journalistically
virilmente	manfully
multitudinariamente	multitudinously
obsequiosamente	obsequiously
*** 1461 - 1470 (/course/187382/spanish-adverbs-7/147/)	
arrolladoramente	overwhelmingly
escondidamente	"secretly, privately, hiddenly"
significantemente	significantly
sobrenaturalmente	supernaturally
incontrolablemente	uncontrollably
beatíficamente	beatifically
recatadamente	"cautiously, prudently, modestly"
demagógicamente	demagogically
discursivamente	discursively
elementalmente	elementally
*** 1471 - 1480 (/course/187382/spanish-adverbs-7/148/)	
frugalmente	frugally
incoherentemente	incoherently
irreprochablemente	irreproachably
malévolamente	just for spite
marcialmente	martially
pudorosamente	"modestly, shyly"
nostálgicamente	nostalgically
pálidamente	palely
sabrosamente	"pleasantly, tastefully"
atolondradamente	recklessly
*** 1481 - 1490 (/course/187382/spanish-adverbs-7/149/)	
inquietamente	"restlessly, anxiously, worriedly"
sacramentalmente	sacramentally
sesgadamente	"slantwise, slopwise, slopingly"
traicioneramente	treacherously
insospechadamente	"unexpectedly, surprisingly"
elogiosamente	with warm approval
abominablemente	"abominably, detestably, execrably"
bajamente	"basely, meanly, abjectly"
culpablemente	culpably
educativamente	educationally
*** 1491 - 1500 (/course/187382/spanish-adverbs-7/150/)	
épicamente	epically
horrendamente	horrendously
importantemente	importantly
complacientemente	indulgently
regocijadamente	"merrily, joyfully, gleefully"
pertinazmente	"pertinaciously, contumaciously"
mediocremente	poorly
sacrílegamente	sacrilegiously
sinuosamente	sinuously
espectralmente	spectrally
*** 1501 - 1510 (/course/187382/spanish-adverbs-7/151/)	
especulativamente	speculatively
sublimemente	sublimely
simpáticamente	sympathetically
indubitablemente	undoubtedly
facultativamente	"according to the principles, rules, or axioms of a science or art"
austeramente	"austerely, sternly"
deductivamente	deductively
distantemente	distantly
pasajeramente	fleetingly
aterradoramente	frighteningly
*** 1511 - 1520 (/course/187382/spanish-adverbs-7/152/)	
insuperablemente	insuperably
irreverentemente	irreverently
doctamente	learnedly
magnánimamente	magnanimously
nutricionalmente	nutritionally
polémicamente	polemically
rudimentariamente	rudimentary
terapéuticamente	therapeutically
desmayadamente	"weakly, dejectedly"
mordazmente	"acrimoniously, nippingly"
*** 1521 - 1530 (/course/187382/spanish-adverbs-7/153/)	
analmente	anally
calumniosamente	"calumniously, slanderously"
empeñosamente	desperately
empresarialmente	entrepreneurially
medrosamente	"faint-heartedly, timorously, fearfully"
borrosamente	"fuzzily, dimly"
golosamente	greedily
hiperbólicamente	hyperbolically
torcidamente	"in a twisted way, crookedly"
indecentemente	indecently
*** 1531 - 1540 (/course/187382/spanish-adverbs-7/154/)	
inductivamente	inductively
intrincadamente	intricately
meritoriamente	meritoriously
miméticamente	mimetically
mezquinamente	"miserably, avariciously"
morosamente	morosely
patrimonialmente	patrimonially
presuntuosamente	presumptuously
prosaicamente	prosaically
sardónicamente	sardonically
*** 1541 - 1550 (/course/187382/spanish-adverbs-7/155/)	
sinérgicamente	synergistically
tensamente	"tensely, greatly"
triplemente	triply
juvenilmente	"youthfully, junior, early"
pasmosamente	"amazingly, astonishingly, wonderfully"
axialmente	axially
venturosamente	"blissfully, happily"
erráticamente	erratically
sempiternamente	"everlastingly, eternally"
azarosamente	"hazardously, eventfully"
*** 1551 - 1560 (/course/187382/spanish-adverbs-7/156/)	
desganadamente	in a desultory fashion
incipientemente	incipiently
incongruentemente	incongruously
ineficazmente	inefficiently
fastuosamente	"magnificently, splendidly, lavishly"
varonilmente	"manfully, valiantly, courageously"
plausiblemente	plausibly
prudencialmente	prudentially
radiactivamente	radioactively
descarnadamente	"starkly, brutally"
*** 1561 - 1570 (/course/187382/spanish-adverbs-7/157/)	
tolerablemente	tolerably
inalterablemente	unalterably
abismalmente	abysmally
auditivamente	aurally
aburridamente	boringly
regaladamente	"delicately, pleasantly, daintily"
irrespetuosamente	disrespectfully
elaboradamente	elaborately
exaltadamente	exaltedly
honoríficamente	honorably
*** 1571 - 1580 (/course/187382/spanish-adverbs-7/158/)	
incrédulamente	incredulously
insultantemente	insultingly
irreductiblemente	irreducibly
lascivamente	"lasciviously, lustfully, libidninously"
míseramente	miserly
satíricamente	satirically
ladinamente	"sidewise, artfully, sagaciously"
sintomáticamente	symptomatically
tortuosamente	tortuously
descomunalmente	"uncommonly, immoderately, extraordinarily"
*** 1581 - 1590 (/course/187382/spanish-adverbs-7/159/)	
infundadamente	"unreasonably, groundlessly"
apremiantemente	"urgently, immediately"
vaginalmente	vaginally
admirativamente	admiringly
corporativamente	corporately
desoladoramente	desolately
costosamente	expensively
mentirosamente	"falsely, deceitfully, lyingly"
humanitariamente	humanely
impersonalmente	impersonally
*** 1591 - 1600 (/course/187382/spanish-adverbs-7/160/)	
civilizadamente	in a civilized way
incalculablemente	incalculably
desconsideradamente	inconsiderately
incorregiblemente	incorrigibly
infernalmente	infernally
lucidamente	lucidly
nebulosamente	nebulously
turbiamente	"obscurely, confusedly"
fenomenalmente	phenomenally
síquicamente	psychically
*** 1601 - 1610 (/course/187382/spanish-adverbs-7/161/)	
rencorosamente	"resentfully, bitterly, spitefully"
estudiadamente	studiously
superlativamente	superlatively
inimaginablemente	unimaginably
vividamente	vividly
malvadamente	"wickedly, naughtily, mischievously"
apreciativamente	appreciatively
católicamente	catholically
ceremonialmente	ceremonially
expeditivamente	expeditiously
*** 1611 - 1620 (/course/187382/spanish-adverbs-7/162/)	
inmoderadamente	immoderately
estentóreamente	in a stentorian voice
inexpresivamente	"inexpressively, blankly"
intracelularmente	intracellularly
introspectivamente	introspectively
pícaramente	"knavishly, roguishly"
melodiosamente	melodiously
memorablemente	memorably
monumentalmente	monumentally
bulliciosamente	"noisily, boisterously, busily"
*** 1621 - 1630 (/course/187382/spanish-adverbs-7/163/)	
fenomenológicamente	phenomenologically
problemáticamente	problematically
repetitivamente	repetitively
vacilantemente	tentatively
imperdonablemente	"unforgivably, unpardonably, inexcusably"
variablemente	variably
malísimamente	"very badly, dreadfully"
virulentamente	virulently
fastidiosamente	"annoyingly, painfully"
anómalamente	anomalously
*** 1631 - 1640 (/course/187382/spanish-adverbs-7/164/)	
clarividentemente	clairvoyantly
decorativamente	decoratively
demostrablemente	demonstrably
perdurablemente	"eternally, perpetually"
hegemónicamente	hegemonically
inmortalmente	immortally
indecorosamente	"indecorously, indecently"
indeterminadamente	indeterminately
inexactamente	"inexactly, inaccurately"
inteligiblemente	intelligibly
*** 1641 - 1650 (/course/187382/spanish-adverbs-7/165/)	
numerosamente	numerously
obscuramente	obscurely
opresivamente	oppressively
portentosamente	portentously
preliminarmente	preliminarily
proporcionadamente	proportionately
rechupete	"splendidly, jolly well"
empecinadamente	"stubbornly, pig-headedly"
traumáticamente	traumatically
inciertamente	uncertainly
*** 1651 - 1660 (/course/187382/spanish-adverbs-7/166/)	
incontroladamente	uncontrollably
imprevisiblemente	unpredictably
urbanamente	urbanely
vectorialmente	vectorially
donosamente	"wittily, amusingly"
acumulativamente	accumulatively
angelicalmente	angelically
aristocráticamente	aristocratically
cruentamente	"bloodily, with effusion of blood"
desesperantemente	desperately
*** 1661 - 1670 (/course/187382/spanish-adverbs-7/167/)	
desconfiadamente	"diffidently, mistrustfully"
suciamente	"dirtily, filthily"
desconcertantemente	disconcertingly
inmejorablemente	"excellently, superbly"
fructíferamente	fruitfully
fructuosamente	fruitfully
genealógicamente	genealogically
grácilmente	gracefully
privilegiadamente	in a privileged manner
validamente	in a solid or binding manner
*** 1671 - 1680 (/course/187382/spanish-adverbs-7/168/)	
testimonialmente	in testimony
irrisoriamente	laughably
malintencionadamente	maliciously
matrimonialmente	maritally
metálicamente	metallically
desacertadamente	"mistakenly, erroneously, wrongly"
perspicazmente	perceptively
reconociblemente	recognizably
respetablemente	respectably
tumultuariamente	tumultuously
*** 1681 - 1690 (/course/187382/spanish-adverbs-7/169/)	
desusadamente	"unusually, out of use, contrary to custom"
viciosamente	viciously
apáticamente	apathetically
arcaicamente	archaically
audiblemente	audibly
embarazosamente	"awkwardly, inconveniently"
capciosamente	captiously
colosalmente	colossally
contingentemente	contingently
delirantemente	deliriously
*** 1691 - 1700 (/course/187382/spanish-adverbs-7/170/)	
egregiamente	egregiously
eróticamente	erotically
eruditamente	eruditely
chistosamente	"facetiously, wittily, merrily"
fácticamente	factually
femeninamente	femininely
guagua	"free, for nothing"
glacialmente	"icily, stonily, frostily"
inmutablemente	immutably
utópicamente	in a utopian way
*** 1701 - 1710 (/course/187382/spanish-adverbs-7/171/)	
destempladamente	intemperately
maniáticamente	maniacally
posicionalmente	positionally
pretenciosamente	pretentiously
sofisticadamente	sophisticatedly
ingratamente	ungratefully
irrazonablemente	unreasonably
vicariamente	vicariously
volublemente	volubly
anacrónicamente	anachronistically
*** 1711 - 1720 (/course/187382/spanish-adverbs-7/172/)	
climatológicamente	climatologically
conformemente	conformally
congénitamente	congenitally
consumadamente	consummately
contiguamente	contiguously
criogénicamente	cryogenically
diacrónicamente	diachronically
dispersamente	dispersedly
exóticamente	exotically
guturalmente	gutturally
*** 1721 - 1730 (/course/187382/spanish-adverbs-7/173/)	
humillantemente	humiliatingly
idiotamente	idiotically
impertinentemente	impertinently
sectariamente	in a sectarian way
letalmente	lethally
neutralmente	neutrally
servicialmente	"obsequiously, serviceably"
pastoralmente	pastorally
pecuniariamente	pecuniary
perseverantemente	perseveringly
*** 1731 - 1740 (/course/187382/spanish-adverbs-7/174/)	
promiscuamente	promiscuously
radiantemente	radiantly
residualmente	residually
sentidamente	"sincerely, with great feeling, regretfully"
superfluamente	superfluously
táctilmente	tactilely
venenosamente	venomously
articuladamente	articulately
autodidácticamente	autodidactically
barrocamente	baroquely
*** 1741 - 1750 (/course/187382/spanish-adverbs-7/175/)	
lisamente	"evenly, smoothly"
desorbitadamente	exorbitantly
frescamente	"freshly, recently, lately"
incestuosamente	incestuously
intersubjetivamente	intersubjectively
litúrgicamente	liturgically
omnipotentemente	omnipotently
escépticamente	skeptically
espaciosamente	spaciously
voluntariosamente	"spontaneously, selfishly"
*** 1751 - 1760 (/course/187382/spanish-adverbs-7/176/)	
sibilinamente	subtly
tangiblemente	tangibly
vacuamente	vacuously
rapidísimamente	very rapidly
volcánicamente	volcanically
axiomáticamente	axiomatically
biográficamente	biographically
cerebralmente	cerebrally
complejamente	complexly
desafiantemente	defiantly
*** 1761 - 1770 (/course/187382/spanish-adverbs-7/177/)	
discontinuamente	discontinuously
epistolarmente	epistolary
eufóricamente	euphorically
exorbitantemente	exorbitantly
célebremente	famously
grandilocuentemente	grandiloquently
crasamente	"grossly, rudely"
hipnóticamente	hypnotically
inmoralmente	immorally
imposiblemente	impossibly
*** 1771 - 1780 (/course/187382/spanish-adverbs-7/178/)	
caricaturescamente	in a caricatured way
industriosamente	industriously
injuriosamente	injuriously
jesuíticamente	jesuitically
lozanamente	luxuriantly
meteorológicamente	meteorologically
opulentamente	opulently
paradigmáticamente	paradigmatically
pedantescamente	pedantically
perniciosamente	perniciously
*** 1781 - 1790 (/course/187382/spanish-adverbs-7/179/)	
predeciblemente	predictably
vengativamente	revengefully
tempestuosamente	stormily
estudiosamente	studiously
subordinadamente	subordinately
superabundantemente	superabundantly
sobrehumanamente	superhumanly
testamentariamente	testamentary
unidamente	unitedly
virginalmente	virginally
*** 1791 - 1800 (/course/187382/spanish-adverbs-7/180/)	
augustamente	augustly
bienalmente	biennially
conyugalmente	conjugally
contemplativamente	contemplatively
corruptamente	corruptly
deleitosamente	delightfully
ergonómicamente	ergonomically
escatológicamente	eschatologically
lisonjeramente	flattering
fugitivamente	fleetingly
*** 1801 - 1810 (/course/187382/spanish-adverbs-7/181/)	
generacionalmente	generationally
fantasmalmente	ghostly
gnoseológicamente	gnoseologically
hambrientamente	hungrily
inmodestamente	immodestly
inmunológicamente	immunologically
totalitariamente	in a totalitarian way
ineptamente	ineptly
inercialmente	inertially
inseguramente	insecurely
*** 1811 - 1820 (/course/187382/spanish-adverbs-7/182/)	
instructivamente	instructively
interpretativamente	interpretively
magnificamente	"magnificently, splendidly, royally"
sesudamente	"maturely, wisely, prudently"
melodramáticamente	melodramatically
militantemente	militantly
funestamente	mournfully
nocturnamente	nocturnally
pasionalmente	passionately
permisivamente	permissively
*** 1821 - 1830 (/course/187382/spanish-adverbs-7/183/)	
postreramente	posthumously
presencialmente	presently
principescamente	princely
profanamente	profanely
robustamente	robustly
sensacionalmente	sensationally
desapaciblemente	"sharply, disagreeably"
sintagmáticamente	syntagmatically
indeliberadamente	unintentionally
aberrantemente	aberrantly
*** 1831 - 1840 (/course/187382/spanish-adverbs-7/184/)	
biométricamente	biometrically
capazmente	"capaciously, amply"
gruesamente	"coarsely, grossly"
dedicadamente	devotedly
diminutamente	dimunitively
excéntricamente	eccentrically
ecuménicamente	ecumenically
electroquímicamente	electrochemically
ejecutivamente	executively
incidentemente	incidentally
*** 1841 - 1850 (/course/187382/spanish-adverbs-7/185/)	
indivisiblemente	indivisibly
novelescamente	novelistically
ocularmente	ocularly
opacamente	opaquely
petulantemente	petulantly
preocupadamente	prejudicedly
quijotescamente	quixotically
reversiblemente	reversibly
tempestivamente	"seasonably, opportunely"
especularmente	specularly
*** 1851 - 1860 (/course/187382/spanish-adverbs-7/186/)	
acérrimamente	strenuously
desventuradamente	"unhappily, unfortunately"
improbablemente	unlikely
antinaturalmente	unnaturally
viscosamente	viscously
encendidamente	"vividly, ardently, efficaciously"
antagónicamente	antagonistically
asexuadamente	asexually
descompuestamente	"audaciously, impudently, insolently"
autorizadamente	authoritatively
*** 1861 - 1870 (/course/187382/spanish-adverbs-7/187/)	
malas	"badly, poorly, wrong"
cáusticamente	caustically
celestialmente	celestially
carismáticamente	charismatically
connaturalmente	connaturally
empáticamente	empathically
fascinantemente	fascinatingly
líquidamente	fluidly
lustrosamente	glossily
hipostáticamente	hypostatically
*** 1871 - 1880 (/course/187382/spanish-adverbs-7/188/)	
simuladamente	in a dissembling or hypocritical manner
incontinentemente	incontinently
inspiradamente	inspirationally
inválidamente	invalidly
libidinosamente	libidinously
lujuriosamente	"lustfully, lecherously"
onomatopéyicamente	onomatopoeiaticly
fálicamente	phallically
farisaicamente	pharisaically
prenatalmente	prenatally
*** 1881 - 1890 (/course/187382/spanish-adverbs-7/189/)	
lucrativamente	"profitably, lucratively"
reducidamente	reductively
turbulentamente	restlessly
descomedidamente	"rudely, coarsely, unmannerly"
suculentamente	succulently
llorosamente	"tearfully, weepingly"
triangularmente	triangularly
umbilicalmente	umbilically
infielmente	unfaithfully
modestísimamente	very modestly
*** 1891 - 1900 (/course/187382/spanish-adverbs-7/190/)	
flacamente	"weakly, languidly"
acusatoriamente	accusingly
anafóricamente	anaphorically
aspectualmente	aspectually
asfixiantemente	asphyxiatingly
corresponsablemente	co-responsibility
contentamente	contentedly
demoníacamente	demonically
expectantemente	expectantly
floridamente	floridly
*** 1901 - 1910 (/course/187382/spanish-adverbs-7/191/)	
galvánicamente	galvanically
gubernativamente	governmentally
titubeantemente	"haltingly, hesitantly"
esclarecidamente	"illustriously, conspicuously"
impuramente	impurely
folclóricamente	in a folkloric way
inaccesiblemente	inaccessibly
indómitamente	indomitably
infaustamente	infamously
insanamente	insanely
*** 1911 - 1920 (/course/187382/spanish-adverbs-7/192/)	
insustancialmente	insubstantially
insufriblemente	insufferably
irredimiblemente	irredeemably
maestramente	masterfully
melifluamente	mellifluously
ministerialmente	ministerially
orientalmente	orientally
posesivamente	possessively
presuntivamente	presumptively
proteolíticamente	proteolytically
*** 1921 - 1930 (/course/187382/spanish-adverbs-7/193/)	
quejosamente	querulously
cuestionablemente	questionably
andrajosamente	raggedly
resolutamente	resolutely
resonantemente	resonantly
escabrosamente	"salaciously, naughtily, obscenely"
sepulcralmente	sepulchrally
quedo	"softly, quietly"
sórdidamente	sordidly
afligidamente	"sorrowfully, grievously"
*** 1931 - 1940 (/course/187382/spanish-adverbs-7/194/)	
empeñadamente	strenuously
subcutáneamente	subcutaneously
venerablemente	venerably
venialmente	venially
aventureramente	adventurously
alostéricamente	allosterically
anticiclónicamente	anticyclonically
amén	as well as
sosamente	"blandly, insipidly, tastelessly"
circunferencialmente	circumferentially
*** 1941 - 1950 (/course/187382/spanish-adverbs-7/195/)	
clericalmente	clerically
cosméticamente	cosmetically
decimalmente	decimally
diatónicamente	diatonically
disyuntivamente	disjunctively
fiduciariamente	fiduciary
fraccionariamente	fractionally
imponderablemente	imponderably
cacofónicamente	in a cacophonic way
incesablemente	incessantly
*** 1951 - 1960 (/course/187382/spanish-adverbs-7/196/)	
inclusivamente	inclusively
inocuamente	innocuously
recomendablemente	laudably
laudablemente	laudably
medicalmente	medically
metalingüísticamente	metalinguistically
medidamente	moderately
operatoriamente	operatively
ostensivamente	ostensively
fisiopatológicamente	pathophysiological
*** 1961 - 1970 (/course/187382/spanish-adverbs-7/197/)	
perplejamente	perplexingly
pontificalmente	pontifically
precipitosamente	precipitously
prescriptivamente	prescriptively
propiciamente	propitioiusly
psiquiátricamente	psychiatrically
reaccionariamente	reactionary
resolutivamente	resolutely
ruralmente	rurally
sismológicamente	seismically
*** 1971 - 1978 (/course/187382/spanish-adverbs-7/198/)	
sobreabundantemente	super-abundantly
suspicazmente	suspiciously
triunfantemente	triumphantly
truculentamente	truculently
explicablemente	understandably
vociferantemente	vociferously
blancamente	whitely
zoológicamente	zoological
