*** 1 - 10 (/course/185945/spanish-adjectives/1/)	
primero	primary
nuevo	"new, novel"
gran	"great, large, big"
último	"ultimate, last, latest"
político	"political, in-law"
segundo	second
español	Spanish
grande	"great, big, large"
bueno	good
europeo	European
*** 11 - 20 (/course/185945/spanish-adjectives/2/)	
solo	"alone, single, one"
principal	principal
único	"unique, sole"
alto	"tall, high, loud"
externo	external
económico	"economic, economical"
llamado	"called, named, so-called"
necesario	necessary
público	public
conocido	"known, noted, familiar"
*** 21 - 30 (/course/185945/spanish-adjectives/3/)	
nacional	"national, domestic"
antiguo	"ancient, former, old"
largo	"long, lengthy"
internacional	international
próximo	"near, next, forthcoming"
humano	"human, humane"
propio	"own, proper, oneself"
tercero	third
común	"common, mutual, communal"
anterior	"anterior, previous, prior"
*** 31 - 40 (/course/185945/spanish-adjectives/4/)	
militar	military
pasado	"past, last, old-fashioned"
francés	French
especial	"special, particular, fussy"
fuerte	"strong, hard, powerful"
menor	"minor, less, smaller"
total	"total, entire, overall"
real	"real, royal, actual, true"
libre	free; unoccupied
oficial	"official, formal, time-served"
*** 41 - 50 (/course/185945/spanish-adjectives/5/)	
escrito	"written, composed"
local	local
particular	"particular, individual, special"
hecho	done
verdadero	"true, real, actual"
viejo	"old, aged, worn out"
negro	"black, brown"
práctico	"practical, handy, useful"
blanco	"white, target, pale"
alemán	German
*** 51 - 60 (/course/185945/spanish-adjectives/6/)	
situado	"situated, located"
numeroso	"numerous, large"
bajo	"low, lower, bass"
superior	"superior, higher, upper"
central	"central, main, principal"
histórico	"historical, historic"
máximo	"maximum, top, most"
británico	British
seguro	"secure, sure, safe"
completo	"complete, full, thorough"
*** 61 - 70 (/course/185945/spanish-adjectives/7/)	
financiero	"financial, financier, financing"
diferente	"different, distinct, strange"
capaz	"capable, able, apt"
joven	"young, youthful, youth"
abierto	"open, opened, ending in a vowel"
malo	"bad, wrong, evil"
comercial	"commercial, trade, trading"
amplio	"large, wide, widespread"
grave	"grave, serious, severe"
religioso	religious
*** 71 - 80 (/course/185945/spanish-adjectives/8/)	
privado	"private, deprived"
cultural	cultural
relativo	"relative, relating, minor"
relacionado	"related, associated, connected"
determinado	"determinate, determined, specific"
directo	"direct, straight, non-stop"
original	"original, un-dubbed, innovative"
similar	similar
basado	based
exterior	"external, exterior, outer"
*** 81 - 90 (/course/185945/spanish-adjectives/9/)	
concreto	"concrete, particular, actual"
moderno	"modern, trendy, latest"
claro	"light, clear, bright"
famoso	"famous, renowned, celebrated"
lleno	"filled, full, packed"
positivo	"positive, (plus), affirmative"
suficiente	"sufficient, ample, enough"
jurídico	"legal, juridical"
comunitario	"community (related), of the European Community, joint"
profundo	"profound, deep"
*** 91 - 100 (/course/185945/spanish-adjectives/10/)	
interno	"internal, inside, intern"
rápido	"rapid, fast, quick"
incluido	included
absoluto	"absolute, complete, utter"
dispuesto	"disposed/disponible, ready, prepared"
justo	"just, righteous, right"
corto	"short, brief, hard of hearing"
final	"final, end, ultimate"
muerto	"dead, deceased, lifeless"
creado	created
*** 101 - 110 (/course/185945/spanish-adjectives/11/)	
simple	"simple, plain, mere"
considerado	"considered, considerate, thoughtful"
adecuado	"adequate, suitable, appropriate"
formado	"formed, trained"
menudo	"small, thin, slight"
activo	active
duro	"hard, difficult, harsh"
publicado	"published, released, issued"
previsto	"scheduled, provided, predicted"
fácil	"easy, simple, likely"
*** 111 - 120 (/course/185945/spanish-adjectives/12/)	
rico	"rich, wealthy, delicious"
capital	"capital, mortal, seminal"
realizado	"realised, fulfilled, rewarded"
médico	medical
pleno	"full, plenary, complete"
junto	"together, joined, joined together"
ruso	Russian
municipal	"municipal, town/city (related)"
serio	"serious, severe, earnest"
democrático	democratic
*** 121 - 130 (/course/185945/spanish-adjectives/13/)	
listo	"ready, clever, set"
destinado	"destined, bound"
preciso	"precise, necessary, accurate"
sencillo	"simple, easy, straightforward"
específico	specific
cercano	"close, near, nearby"
posterior	"posterior, later/after, subsequent"
mexicano	Mexican
reciente	"recent, new, fresh"
dirigido	"guided/directed at, remote controlled"
*** 131 - 140 (/course/185945/spanish-adjectives/14/)	
responsable	"responsible, liable, in charge"
dicho	"already said, already stated, said"
básico	basic
hermoso	"beautiful, lovely, handsome"
elevado	"elevated, high, lofty"
argentino	"Argentinean, argentine, Argentinian"
excelente	"excellent, superb, wonderful"
mínimo	"minimal, minimum, least"
parlamentario	"parliamentary, parliamentarian"
inmediato	"immediate, instant, near"
*** 141 - 150 (/course/185945/spanish-adjectives/15/)	
clásico	"classical, classic, traditional"
inferior	"inferior, lower, less"
vasco	Basque
fiscal	"fiscal, tax, financial"
urbano	urban; courteous
compuesto	"composite, composed, compound"
griego	"Greek, Grecian"
judicial	"judicial, judiciary"
extranjero	foreign
romano	Roman
*** 151 - 160 (/course/185945/spanish-adjectives/16/)	
cerrado	"closed, shut, close"
establecido	"established, set"
puesto	"placed, set"
cristiano	Christian
administrativo	"administrative, managerial, office"
definitivo	"definitive, final, ultimate"
fundado	"founded, based, established"
rojo	red
oscuro	"obscure, dim, dark"
breve	"brief, short, dainty"
*** 161 - 170 (/course/185945/spanish-adjectives/17/)	
científico	scientific
entero	"entire, whole, complete"
nombrado	"famous, noted, with a name"
puro	"pure, fresh, raw"
técnico	technical
constante	"constant, continual, persevering"
extraño	"strange, weird, odd"
evidente	"evident, obvious, apparent"
construido	"constructed, built"
eléctrico	"electrical, electric, highly-strung"
*** 171 - 180 (/course/185945/spanish-adjectives/18/)	
electrónico	"electronic, electron, electric"
chileno	Chilean
occidental	"western, occidental, west"
previo	"previous, prior, initial"
poderoso	"powerful, mighty, potent"
cubierto	"covered, overcast"
italiano	Italian
azul	blue
inglés	"English, English-style, Englishwoman"
eficaz	"effective, efficient, efficacious"
*** 181 - 190 (/course/185945/spanish-adjectives/19/)	
obligado	"obliged, bound"
izquierdo	"leftist, left, left-hand"
peligroso	"dangerous, hazardous, perilous"
global	global
literario	literary
útil	"utile, useful, usable"
norteamericano	"North American, American, US"
laboral	"labour-related, working, occupational"
artístico	artistic
deportivo	"sports-related, sporty, sporting"
*** 191 - 200 (/course/185945/spanish-adjectives/20/)	
correcto	"correct, proper, right"
diario	"daily, everyday, day-to-day"
armado	"armed, equipped"
americano	American
destacado	"outstanding, prominent, important"
habitual	"habitual, regular, usual"
terrible	terrible
colectivo	collective
noble	noble
disponible	"available, disposable, free to use"
*** 201 - 210 (/course/185945/spanish-adjectives/21/)	
organizado	organized
citado	cited
rural	rural
falso	"fake, false"
autónomo	"autonomous, freelance"
extraordinario	extraordinary
significativo	"significant, meaningful,"
desconocido	"unknown, strange, unfamiliar"
israelí	Israeli
legislativo	legislative
*** 211 - 220 (/course/185945/spanish-adjectives/22/)	
unido	"united, attached, joined"
continuo	"continuous, continuing"
espiritual	spiritual
notable	"notable, remarkable, noticeable"
parecido	"similar, alike, such"
firme	"firm, steady, strong"
débil	"weak, faint, feeble"
dado	"given, inclined, prone"
femenino	"female, feminine, effeminate"
bello	"beautiful, fair, handsome"
*** 221 - 230 (/course/185945/spanish-adjectives/23/)	
ligero	"lightweight, light, faint"
triste	"sad, dreary, unhappy"
afectado	"affected, influenced, damaged"
loco	crazy; crazed
japonés	Japanese
universal	universal
terrorista	"terrorist, terrorising"
perfecto	perfect; complete
divino	divine
celebrado	"celebrated, famous"
*** 231 - 240 (/course/185945/spanish-adjectives/24/)	
químico	chemical
integrado	integrated
seco	"dry, dried, blank"
supuesto	"supposed, alleged, assumed"
ilegal	"illegal, unlawful"
sentado	"seated, sitting"
limitado	"limited, restricted"
típico	typical
dedicado	"dedicated, devoted"
intenso	"intense, intensive, fierce"
*** 241 - 250 (/course/185945/spanish-adjectives/25/)	
católico	Catholic
efectivo	"effective, actual"
convencido	convinced
presentado	"presented, displayed"
secundario	"secondary, supporting"
fijo	"fixed, regular, permanent"
ocupado	"occupied, busy, engaged"
inmenso	immense
auténtico	"authentic, real, true"
infantil	"infantile, childish"
*** 251 - 260 (/course/185945/spanish-adjectives/26/)	
mental	mental
frecuente	"frequent, prevalent, common"
brillante	"brilliant, bright"
palestino	Palestinian
violento	violent
tranquilo	"tranquil; quiet, calm"
reconocido	"recognised, famous, grateful"
energético	energetic
presupuestario	budgetary
tomado	taken; drunk; upset
*** 261 - 270 (/course/185945/spanish-adjectives/27/)	
productor	producing
múltiple	"multiple, numerous, manifold"
raro	"rare, odd, unusual"
enemigo	"enemy, opposing, adversarial"
digno	"worthy, deserving, dignified"
educativo	"educational, educative, education"
alternativo	"alternative, alternating"
pesado	"heavyweight, heavy, burdensome"
sanitario	sanitary
oculto	"occult, hidden"
*** 271 - 280 (/course/185945/spanish-adjectives/28/)	
ancho	"wide, broad, large"
usado	"used, worn out, tired"
dividido	"divided, split"
titulado	"graduate, qualified, entitled"
seguido	"continued, followed, non-stop"
territorial	territorial
conservador	conservative
negativo	"negative, adverse"
presidencial	presidential
creciente	"growing, increasing, rising"
*** 281 - 290 (/course/185945/spanish-adjectives/29/)	
favorable	"favorable, pro, advantageous"
futuro	future
portugués	Portuguese
probable	"probable, likely, probable"
asociado	"associate, associated"
frío	"cold, chilly, cool"
estratégico	strategic
definido	"defined, definite"
geográfico	"geographical, geographic"
debido	"due, owing"
*** 291 - 300 (/course/185945/spanish-adjectives/30/)	
institucional	institutional
eterno	"eternal, everlasting"
dulce	"sweet; gentle, tender"
primario	"primary, prime, number one"
universitario	"university(related), academic"
medio	"average, mid, middle"
masivo	"massive, huge"
considerable	"considerable, substantial; sizeable"
estructural	structural
brasileño	Brazilian
*** 301 - 310 (/course/185945/spanish-adjectives/31/)	
variable	"variable, moody, changeable"
aéreo	"aerial, air, overhead"
decisivo	"decisive, vital, deciding"
peruano	Peruvian
ejemplar	"exemplary, admonitory, model"
cuarto	fourth
ajeno	"alien, unaware, ignorant"
medioambiental	environmental
marcado	"marked, strong, sharp"
vital	"vital, life, full of life"
*** 311 - 320 (/course/185945/spanish-adjectives/32/)	
solitario	"lonely, solitary, alone"
desarrollado	"developed, industrialised"
rodeado	surrounded
integrante	"integral, built-in, member"
diplomático	"diplomatic, politic, tactful"
digital	"digital, finger"
extra	"high quality, extra"
satisfecho	"satisfied, pleased, content"
matemático	mathematical
escaso	"scarce, low, sparse"
*** 321 - 330 (/course/185945/spanish-adjectives/33/)	
cubano	Cuban
respectivo	"respective, corresponding"
cuadrado	"square, stocky, brawny"
paralelo	"parallel, similar"
turístico	"tourist, tour"
condenado	"condemned, convicted, doomed"
lento	"slow, sluggish"
académico	academic
revolucionario	revolutionary
operativo	"operational, operating"
*** 331 - 340 (/course/185945/spanish-adjectives/34/)	
colombiano	Colombian
fiel	"true, loyal, faithful"
maestro	master
magnífico	"magnificent, marvelous, grand"
especializado	"specialized, specialist, trained"
musulmán	"Moslem, Muslim, Mussulman"
extenso	"extensive, vast, large"
enviado	sent
separado	"separate, detached, separated"
tecnológico	technological
*** 341 - 350 (/course/185945/spanish-adjectives/35/)	
perdido	"lost, missing, libertine"
comunista	communist
preparado	"ready, prepared, trained"
opuesto	"opposite, opposed, contrary"
sagrado	"holy, sacred, sanctuary"
interesado	"interested, concerned, self-interested"
elaborado	"elaborated, elaborate, thorough"
africano	African
masculino	"male, masculine, manly"
exacto	"accurate, precise, exact"
*** 351 - 360 (/course/185945/spanish-adjectives/36/)	
casado	"married, wedded"
delicado	"delicate, subtle, dainty"
fino	"fine, thin, slender"
abandonado	"abandoned, deserted, derelict"
detenido	"detained, arrested, thorough"
inútil	"useless, pointless, helpless"
liberal	"liberal, open"
derivado	"derived, derivative, secondary"
suave	"soft, mild, gentle"
lejano	"far, distant, farther"
*** 361 - 370 (/course/185945/spanish-adjectives/37/)	
extremo	"extreme, end, far"
parcial	"partial, part, biased"
estricto	"strict, severe, tight"
estrecho	"close, narrow, small"
contemporáneo	"contemporary, contemporaneous, modern"
sueco	"Swedish, Swede"
catalán	"Catalan, Catalonian"
protegido	"protected, sheltered"
mero	"mere, sheer, pure"
excesivo	"excessive, unreasonable, undue"
*** 371 - 380 (/course/185945/spanish-adjectives/38/)	
gubernamental	"governmental, loyalist"
inteligente	"intelligent, smart, clever"
vigente	"in force, valid, current"
presunto	"alleged, presumed, presumptive"
voluntario	"voluntary, gladly, willingly"
sensible	"sensitive, sentient, feeling"
vano	"vain, idle, empty"
humanitario	"humanitarian, humane"
complejo	"complex, composed of various (or: multiple) parts, complicated"
desnudo	"bare, naked, nude"
*** 381 - 390 (/course/185945/spanish-adjectives/39/)	
aplicado	"applied, diligent, dedicated"
turco	Turkish
oportuno	"timely, opportune, appropriate"
herido	"wounded, injured"
registrado	registered
gris	"gray, mediocre, uninteresting"
secreto	"secret, hidden"
aislado	"isolated, secluded, insulated"
autonómico	"autonomic, autonomous"
doméstico	"domestic, household, home"
*** 391 - 400 (/course/185945/spanish-adjectives/40/)	
apropiado	"proper, appropriate, suitable"
fresco	"cool, fresh, crisp"
curioso	"curious, inquisitive, intriguing"
limpio	"clean, fair, clear"
avanzado	"advanced, modern, forward-thinking"
dirigente	"leading, ruling, managing"
uniforme	"even, uniformed, uniform"
climático	"climatic, weather, climate"
célebre	"celebrated, famous, notorious"
indígena	"native, indigenous, Indian"
*** 401 - 410 (/course/185945/spanish-adjectives/41/)	
gráfico	"graphic, graphical"
mortal	"fatal, mortal, deadly"
urgente	"urgent, pressing, imperative"
republicano	republican
localizado	located
sólido	"solid, strong, sound"
amarillo	"yellow, yellowy"
santo	"saint, holy, saintly"
dramático	dramatic
venezolano	Venezuelan
*** 411 - 420 (/course/185945/spanish-adjectives/42/)	
estable	"stable, steady, set"
consumidor	consuming
provincial	provincial
soviético	Soviet
mediano	"medium, median, average"
obligatorio	"obligatory, binding, mandatory"
criminal	"criminal, crime"
conjunto	"whole, joint"
semejante	"similar, like, such"
expuesto	"exposed, displayed, dangerous"
*** 421 - 430 (/course/185945/spanish-adjectives/43/)	
animado	"lively, animated, upbeat"
preso	"overcome, blinded, overwhelmed"
empresarial	"corporate, company, business"
productivo	"productive, of production, fruitful"
dorado	"golden, gilt, gilded"
electo	"selected, -elect"
espacial	"spatial, space"
ciego	"blind, blocked"
obrero	"working class, worker"
polaco	"Polish, polaco, Polack"
*** 431 - 440 (/course/185945/spanish-adjectives/44/)	
filosófico	"philosophical, philosophic"
propuesto	proposed
variado	"varied, mixed, diverse"
franco	"frank, blunt, honest"
artificial	"artificial, unnatural, stiff"
medieval	"medieval, mediaeval"
nervioso	"nervous, nerve, jittery"
poético	"poetic, poetical, beautiful"
misterioso	"mysterious, uncanny, eerie"
legítimo	"legitimate, rightful, genuine"
*** 441 - 450 (/course/185945/spanish-adjectives/45/)	
propietario	proprietor
reducido	"reduced, narrow, limited"
convertido	"converted, turned"
mecánico	"mechanic, mechanical"
partidario	"partisan, follower, supportive"
orgulloso	"proud, prideful, vain"
cotidiano	"daily, quotidian, everyday"
vendido	sold
lógico	"logic, logical, logician"
prohibido	"prohibited, forbidden, barred"
*** 451 - 460 (/course/185945/spanish-adjectives/46/)	
equivalente	"equivalent, tantamount, equal"
inocente	"innocent, blameless, guiltless"
intermedio	"intermediate, middle, medium"
latino	"Latin, lateen, Lazian"
agudo	"sharp, acute, high"
mágico	"magical, magic, magician"
íntimo	"close, intimate, personal"
sano	"healthy, wholesome, good"
mutuo	"mutual, reciprocal"
consecutivo	"consecutive, successive, sequential"
*** 461 - 470 (/course/185945/spanish-adjectives/47/)	
favorito	"favorite, favourite"
ecológico	"ecological, ecologic, organic"
pasajero	"temporary, fleeting"
conveniente	"convenient, suitable, appropriate"
bonito	"beautiful, nice, pretty"
combustible	combustible
humilde	"humble, poor, low"
genético	"genetic, geneticist"
pacífico	"Pacific, peaceful, peaceable"
indispensable	"essential, indispensable, necessary"
*** 471 - 480 (/course/185945/spanish-adjectives/48/)	
grueso	"thick, coarse, heavy"
pesquero	"fishing boat, fishing"
egipcio	Egyptian
cruel	"cruel, heartless, brutal"
exitoso	successful
colocado	"laid, located, settled"
juvenil	"juvenile, youthful, young"
étnico	ethnic
ordinario	"ordinary, regular, coarse"
marroquí	Moroccan
*** 481 - 490 (/course/185945/spanish-adjectives/49/)	
diverso	"miscellaneous, different, diverse"
inspirado	inspired
cansado	"tired, wearing, weary"
arqueológico	"archeological, archaeological"
idéntico	"identical, same, like"
preocupado	"worried, concerned, troubled"
recibido	"received, taken"
cuerdo	"sane, right, rational"
mediterráneo	"Mediterranean, landlocked, mediterranean"
biológico	"biological, biologic, organic"
*** 491 - 500 (/course/185945/spanish-adjectives/50/)	
expresado	voiced
húmedo	"moist, wet, humid"
emitido	issued
dotado	"gifted, talented, equipped"
entregado	"delivered, dedicated, zealous"
exclusivo	"exclusive, sole, unique"
nocturno	"night, nocturnal, nightly"
lateral	"lateral, side, sideways"
oral	oral
severo	"severe, hard, stern"
*** 501 - 510 (/course/185945/spanish-adjectives/51/)	
natal	"native, natal, home"
culpable	"guilty, culpable, responsible"
orgánico	organic
transparente	"transparent, clear, blind"
generoso	"generous, bountiful, rich"
originario	"original, native to, primary"
psicológico	"psychological, psychologic"
excepcional	"exceptional, outstanding, extraordinary"
fronterizo	"border, frontier"
convocado	"announce, call, convene"
*** 511 - 520 (/course/185945/spanish-adjectives/52/)	
competitivo	competitive
monetario	"monetary, financial"
rechazado	"rejected, dismissed"
madrileño	Madrilenian
teórico	"theoretician, theoretical"
alado	winged
supremo	"supreme, paramount, last"
séptimo	seventh
precioso	"lovely, precious, beautiful"
maravilloso	"wonderful, amazing, marvelous"
*** 521 - 530 (/course/185945/spanish-adjectives/53/)	
cinematográfico	"cinematographic, cinematic, film"
valioso	"valuable, useful, appreciated"
válido	"valid, available, favorite"
irregular	"irregular, uneven, changeable"
ferroviario	"railway, rail"
latinoamericano	"Latin American, Latin-American"
absurdo	"absurd, ridiculous, nonsensical"
gigante	"giant, gigantic, huge"
informativo	"informative, news, information"
simbólico	"symbolic, symbolical, token"
*** 531 - 540 (/course/185945/spanish-adjectives/54/)	
gratuito	"free, gratuitous, free of charge"
islámico	Islamic
infinito	"infinite, endless, boundless"
vertical	"vertical, upright"
cargado	"loaded, laden, heavy"
metálico	"metallic, metal"
visual	visual
primo	prime
progresivo	"progressive, forward, gradual"
recogido	"isolated, withdrawn, gathered together"
*** 541 - 550 (/course/185945/spanish-adjectives/55/)	
belga	Belgian
ligado	"tied, bound, attached"
destruido	destroyed
rebelde	"rebellious, refractory, insurgent"
representativo	"representative, emblematic, characteristic"
alejado	"distant, remote, far"
sucesivo	"successive, following"
liberado	"released, liberated, freed"
gordo	"fat, thick, plump"
envuelto	"wrapped, involved, shrouded"
*** 551 - 560 (/course/185945/spanish-adjectives/56/)	
detallado	"detailed, full, in-depth"
pálido	"pale, white, pallid"
ideológico	ideological
crucial	"crucial, key, cruciform"
telefónico	"telephone, telephonic"
atractivo	"sexy, attractive, alluring"
encontrado	"opposite, facing each other, mixed"
nativo	"native, indigenous, local"
delantero	"forward, front, leading"
lanzado	"hurled, bold, impetuous"
*** 561 - 570 (/course/185945/spanish-adjectives/57/)	
feo	"ugly, unsightly, nasty"
concedido	granted
racional	"rational, logical, sensible"
coherente	"coherent, consistent"
asiático	"Asian, Asiatic"
sincero	"sincere, honest, candid"
constructivo	"constructive, structural"
marino	"sea, marine, navy blue"
dependiente	"dependent, depending, disabled"
reunido	"gathered, joined, assembled"
*** 571 - 580 (/course/185945/spanish-adjectives/58/)	
holandés	Dutch
insuficiente	"insufficient, inadequate"
sistemático	systematic
mediado	"half-full, half-empty"
forzado	"forced, forcible, strained"
sorprendente	"surprising, astonishing, astounding"
sucio	"dirty, grubby, dingy"
expulsado	expelled
sexto	sixth
romántico	romantic
*** 581 - 590 (/course/185945/spanish-adjectives/59/)	
ácido	"acid, acidic, sour"
inaceptable	unacceptable
elegido	elected
campesino	"rural, rustic, country"
equilibrado	"equilibrated, balanced, well-adjusted"
ambicioso	"ambitious, overambitious"
cómico	"comic, comical, funny"
complementario	"complementary, supplementary, extra"
moderado	"moderate, measured, restrained"
remoto	"remote, far, distant"
*** 591 - 600 (/course/185945/spanish-adjectives/60/)	
vocal	vocal
ejecutivo	"executive, managing"
material	"material, bodily, physical"
horizontal	"horizontal, horizontal position, horizonal"
defensivo	defensive
poblado	"populated, inhabited"
bancario	banking
comprometido	"committed, involved, dangerous"
quinto	fifth
vegetal	"vegetable, vegetal"
*** 601 - 610 (/course/185945/spanish-adjectives/61/)	
explosivo	"explosive, plosive"
pintado	"painted, painting, coating"
espectacular	"spectacular, dramatic"
enamorado	"in love, enamored, lover"
identificado	identified
agrario	"agrarian, land, rural"
anunciado	announced
caro	"pricey, expensive, costly"
mixto	"mixed, joint, combination"
subterráneo	"underground, subterranean"
*** 611 - 620 (/course/185945/spanish-adjectives/62/)	
barato	"cheap, inexpensive, easy"
danés	Danish
elegante	"elegant, stylish, chic"
leve	"slight, mild, light"
inevitable	"unavoidable, inevitable, inescapable"
gótico	"Gothic, gothic"
vasto	"vast, extensive, wide"
trágico	"tragic, tragedian"
impreso	printed
delgado	"thin, slim, slender"
*** 621 - 630 (/course/185945/spanish-adjectives/63/)	
naval	naval
repetido	"repeated, duplicate"
serbio	"Serbian, Serb"
satisfactorio	"satisfying, satisfactory"
soberano	"sovereign, heavy, extreme"
confuso	"confused, fuzzy, blurred"
flexible	"flexible, supple, floppy"
ordenado	"tidy, ordered, orderly"
televisivo	"television, televisual, TV"
restante	"remaining, left over"
*** 631 - 640 (/course/185945/spanish-adjectives/64/)	
sordo	"deaf, dull, muted"
informático	computer
modesto	"modest, poor"
flamenco	"Flemish, charming, insolent"
declarado	"declared, avowed, confessed"
riguroso	"rigorous, strict, tight"
autorizado	"authorized, licensed, authoritative"
sonoro	"talking, resounding, loud"
potente	"powerful, potent, virile"
automático	"automatic, self-winding, instinctive"
*** 641 - 650 (/course/185945/spanish-adjectives/65/)	
suizo	Swiss
castellano	"Spanish, from Castile"
sospechoso	"suspect, fishy, suspicious"
clínico	"clinical, clinic"
prudente	"cautious, wise, prudent"
sorprendido	"surprised, startled, shocked"
uruguayo	Uruguayan
atento	"attentive, careful, helpful"
silencioso	"silent, quiet, noiseless"
austriaco	Austrian
*** 651 - 660 (/course/185945/spanish-adjectives/66/)	
temprano	early
lingüístico	"language, linguistic"
impuesto	"imposed, exacted"
injusto	"unjust, unfair, wrongful"
desesperado	"hopeless, desperate, in despair"
obvio	obvious
diseñado	designed
costero	"coastal, seaside"
amable	"kind, friendly, pleasant"
normativo	normative
*** 661 - 670 (/course/185945/spanish-adjectives/67/)	
tremendo	"tremendous, terrific, awful"
ganador	"winning, victorious"
demográfico	demographic
honrado	"honest, honored, upright"
canadiense	Canadian
cálido	"warm, hot, warm-hearted"
invisible	"unseen, invisible"
amoroso	"loving, affectionate, amorous"
marítimo	"sea, maritime, seaborne"
bruto	"brutish, crude, rude"
*** 671 - 680 (/course/185945/spanish-adjectives/68/)	
sabio	"wise, sage, learned"
escondido	"secret, hidden, remote"
reservado	"reserved, secretive, quiet"
redondo	"round, circular, rotund"
crudo	"raw, crude, green"
amargo	"bitter, negative, sugarless"
deseado	"desired, wanted"
táctico	tactical
gigantesco	"giant, gigantic, mammoth"
óptico	"optical, optic"
*** 681 - 690 (/course/185945/spanish-adjectives/69/)	
eclesiástico	"ecclesiastical, church, ecclesiastic"
creativo	"creative, inventive, idea man"
inmóvil	"motionless, still, immobile"
increíble	"incredible, unbelievable, amazing"
objetivo	"objective, unbiased"
mudo	"silent, dumb, mute"
flaco	"skinny, thin, gaunt"
innumerable	"innumerable, numberless"
esperado	"expected, hoped, awaited"
indirecto	indirect
*** 691 - 700 (/course/185945/spanish-adjectives/70/)	
mineral	mineral
prolongado	"prolonged, long, lengthy"
dinámico	"dynamic, dynamical"
petrolero	"oil, petroleum, oil company"
barroco	"baroque, over-elaborate, ornate"
cómodo	"comfortable, convenient, easy"
dominado	dominated
generalizado	"generalized, widespread, of common usage"
superficial	"shallow, superficial, perfunctory"
compatible	compatible
*** 701 - 710 (/course/185945/spanish-adjectives/71/)	
australiano	"Australian, Aussie"
pertinente	"pertinent, relevant, applicable"
guerrillero	guerrilla
estadístico	"statistical, statistic"
lamentable	"lamentable, shabby, regrettable"
térmico	thermal
entrado	joined
participante	"participant, contestant"
ficticio	"fictitious, fictional, assumed"
referido	referred
*** 711 - 720 (/course/185945/spanish-adjectives/72/)	
dormido	"sleeping, asleep, dopey"
comparado	"compared, comparative"
crónico	"chronic, long-term, die-hard"
amistoso	"friendly, amicable"
silvestre	"wild, indigenous, native"
mayoritario	majority
trasero	"rear, back, hind"
arquitectónico	"architectural, architectonic"
inesperado	unexpected
desaparecido	"missing, extinct, missing person"
*** 721 - 730 (/course/185945/spanish-adjectives/73/)	
irlandés	Irish
cruzado	"cross, crossed, crossbred"
discográfico	recording
indicado	"indicated, specified, appropriate"
asignado	earmarked
virtual	virtual
olímpico	"Olympic, Olympian"
prioritario	"critical, imperative, of first importance"
tierno	"tender, gentle, kind"
asturiano	Asturian
*** 731 - 740 (/course/185945/spanish-adjectives/74/)	
generado	generated
audiovisual	audiovisual
solemne	"solemn, dignified, formal"
narrativo	narrative
magnético	magnetic
tonto	"foolish, silly, fool"
elemental	"elemental, elementary, basic"
compartido	shared
vecino	"neighboring, neighbor, near"
consistente	"consistent, strict"
*** 741 - 750 (/course/185945/spanish-adjectives/75/)	
involucrado	"involved, implicated"
patronal	Cierre patronal = lockout
materno	"native, maternal"
seleccionado	selected
rubio	"blond, fair, blonde"
prestigioso	"prestigious, renowned, well-regarded"
retirado	"retired, withdrawn, secluded"
urbanístico	urban
centrado	"centered, well balanced, balanced"
nazi	Nazi
*** 751 - 760 (/course/185945/spanish-adjectives/76/)	
equivocado	"wrong, mistaken, misguided"
montañoso	"mountainous, hilly, highland"
agresivo	"aggressive, virulent, injurious"
abstracto	"abstract, nonfigurative"
luminoso	"luminous, bright, lighting"
lindo	"cute, nice, beautiful"
pasivo	"passive, non-participating, unadventurous"
conectado	connected
denso	"dense, thick, heavy"
doloroso	"painful, grievous, distressing"
*** 761 - 770 (/course/185945/spanish-adjectives/77/)	
vulgar	"vulgar, ordinary, tacky"
espeso	"thick, deep, dense"
nuboso	"cloudy, gloomy"
impresionante	"impressive, awesome, amazing"
solicitado	"sought after, in demand, popular"
distinguido	"distinguished, elegant, refined"
blando	"soft, mild, limp"
temático	"thematic, topical, topic"
protector	"protective, protecting"
corporal	"bodily, corporal, body"
*** 771 - 780 (/course/185945/spanish-adjectives/78/)	
botánico	"botanic, botanical"
fabricado	manufactured
tendido	"hung out, lying, laid"
funcional	"functional, useful, practical"
rígido	"rigid, stiff, stark"
sutil	"subtle, fine, subtile"
maldito	"fucking, cursed, damn"
ridículo	"ridicule, ridiculous, absurd"
decidido	"decided, determined, resolute"
duradero	"durable, enduring, permanent"
*** 781 - 790 (/course/185945/spanish-adjectives/79/)	
siniestro	"sinister, grim, ominous"
ausente	"absent, out, missing"
espantoso	"frightful, frightening, dreadful"
nulo	"null, void, zero"
mezclado	"blended, mixed, mingled"
tardío	"late, tardy, belated"
descrito	described
inquieto	"restless, uneasy, unquiet"
sustancial	"substantial, healthy, nourishing"
justificado	"justified, righteous, justifiable"
*** 791 - 800 (/course/185945/spanish-adjectives/80/)	
textil	textile
forestal	"forest, forestry"
enérgico	"energetic, strong, spirited"
discreto	"discrete, unobtrusive, discreet"
neto	"net, distinct, clear"
lírico	"lyrical, lyric, poetical"
levantado	"up, stand up"
homónimo	homonymous
minero	mining
despedido	"dismissed, discharged"
*** 801 - 810 (/course/185945/spanish-adjectives/81/)	
hondo	deep
auxiliar	"auxiliary, assistant, ancillary"
encendido	"on, fired, glowing"
extendido	"extended, widespread, issued"
mítico	"mythical, legendary, fabulous"
pronunciado	pronounced
brutal	"brutal, brutish, brute"
erróneo	"wrong, erroneous, misleading"
plástico	"plastic, sculptural"
clasificado	"classified, assorted"
*** 811 - 820 (/course/185945/spanish-adjectives/82/)	
sufrido	"complaisant husband, long-suffering, uncomplaining"
agradecido	"grateful, thankful, obliged"
burgués	"bourgeois, middle-class, well-off"
furioso	"angry, furious, wild"
publicitario	advertising
grabado	"recorded, engraved"
virgen	"virgin, unspoilt"
aproximado	"approximate, rough"
difundido	diffused
imaginario	"imaginary, fanciful"
*** 821 - 830 (/course/185945/spanish-adjectives/83/)	
divertido	"funny, enjoyable, amusing"
explícito	"explicit, express, clear"
indio	"Indian, boorish"
andaluz	"Andalusian, Andalucian"
espléndido	"splendid, superb, grand"
atado	tied
ético	"ethical, ethic, exemplary"
legendario	"legendary, fabled"
amado	"beloved, dear, darling"
sombrío	"somber, dark, dismal"
*** 831 - 840 (/course/185945/spanish-adjectives/84/)	
noruego	Norwegian
encarcelado	imprisoned
hebreo	Hebrew
vestido	dressed
esclavo	"slave, enslaved"
educado	"polite, educated, trained"
dudoso	"dubious, doubtful, uncertain"
problemático	"problem, problematic, problematical"
viajero	"traveling salesman, fond of travelling"
metropolitano	"metropolitan, subway, urban"
*** 841 - 850 (/course/185945/spanish-adjectives/85/)	
pagado	"paid, prepaid"
festivo	"festive, holiday, festival"
cerebral	"cerebral, brain"
encantado	"delighted, haunted, enthusiastic"
suelto	"loose, free, loose change"
sangriento	"bloody, sanguinary, gory"
acostumbrado	"accustomed, used, usual"
innecesario	"unnecessary, needless"
accesible	"accessible, approachable, reachable"
docente	"teaching, educational"
*** 851 - 860 (/course/185945/spanish-adjectives/86/)	
informal	"informal, casual, unreliable"
checo	Czech
análogo	"analogous, akin to"
espontáneo	"spontaneous, unbidden, unexpected"
potencial	potential
cerámico	ceramic
clandestino	"clandestine, underground, undercover"
conformado	"shaped, conformed"
arrestado	detained
periodístico	"journalistic, press, news media"
*** 861 - 870 (/course/185945/spanish-adjectives/87/)	
unitario	"unitary, Unitarian, unit"
regulador	"regulatory, regulating"
psíquico	"psychic, psychical, mental"
celeste	"heavenly, celestial, light blue"
repartido	"distributed, issued"
leal	"loyal, faithful, devoted"
hábil	"skillful, skilled, skilful"
maduro	"mature, ripe, seasoned"
evolutivo	"evolutionary, evolutional"
aragonés	Aragonese
*** 871 - 880 (/course/185945/spanish-adjectives/88/)	
persa	"Persian, Farsi, Iranian"
escogido	"selected, picked, select"
transitorio	"temporary, transitory, transient"
escocés	"tartan, Scottish, Scots"
boliviano	Bolivian
polémico	"polemic, polemical, controversial"
subjetivo	subjective
repentino	"sudden, abrupt"
planetario	planetary
frágil	"fragile, frail, brittle"
*** 881 - 890 (/course/185945/spanish-adjectives/89/)	
cualificado	"skilled, trained, qualified"
patente	"patent, obvious, clear"
acumulado	"accumulated, aggregate, accrued"
tímido	"shy, timid, bashful"
templado	"tempered, warm, mild"
despejado	"clear, cloudless, clear-headed"
heroico	heroic
andino	Andean
perpetuo	"perpetual, everlasting, life"
coordinado	"coordinated, coordinate, combined"
*** 891 - 900 (/course/185945/spanish-adjectives/90/)	
reforzado	reinforced
roto	"broken, torn, worn"
contradictorio	"contradictory, conflicting, opposing"
rumano	"Romanian, Rumanian, Roumanian"
colgado	"hanging, dangling, freeze"
calificado	"qualified, authorized, equipped"
coronado	crowned
ecuatoriano	Ecuadorian
hispano	"Hispanic, Spanish, Hispano"
preocupante	"worrying, disturbing, preoccupying"
*** 901 - 910 (/course/185945/spanish-adjectives/91/)	
sirio	"Sirius, Syrian"
harto	"fed up, sick of, sick to death of"
iniciado	"initiated, initiate, initiated member"
susceptible	"susceptible, sensitive"
migratorio	"migratory, migrant"
inclinado	"tilted, inclined, pitched"
iluminado	"illuminated, light"
exhaustivo	"exhaustive, thorough, comprehensive"
llano	"flat, smooth, simple"
parroquial	"parochial, parish"
*** 911 - 920 (/course/185945/spanish-adjectives/92/)	
costoso	"costly, expensive, difficult"
anónimo	"anonymous, nameless, unknown"
asustado	"afraid, frightened, startled"
húngaro	Hungarian
intacto	"intact, whole, unbroken"
vacío	"empty, blank, void"
casero	"home, homemade, homely"
diferenciado	differentiated
honesto	honest
regulado	"regulated, regular, mediocre"
*** 921 - 930 (/course/185945/spanish-adjectives/93/)	
gracioso	"funny, droll, graceful"
guapo	"handsome, pretty, nice"
terminal	"terminal, final, last"
preventivo	"preventive, preventative, precautionary"
viable	viable
pato	"bored, boring, dull"
acusado	"accused, marked, pronounced"
simpático	"nice, friendly, sympathetic"
bravo	"rough, brave, wild"
apasionado	"passionate, impassioned"
*** 931 - 940 (/course/185945/spanish-adjectives/94/)	
procesal	"procedural, trial"
románico	"Romanic, Romanesque, Romance"
probado	"proven, tried"
criollo	"American, creole, local"
montado	"mounted, set"
bélico	"war, warlike"
equipado	equipped
noveno	ninth
vencido	"defeated, beaten"
sinónimo	"synonymous, synonym, synonymous with"
*** 941 - 950 (/course/185945/spanish-adjectives/95/)	
semanal	"weekly, week-long"
atómico	atomic
fijado	"set, fixed"
adaptado	adapted
ofensivo	offensive
cultivado	"cultivated, cultured"
penoso	"painful, distressing, laborious"
sentimental	"sentimental, emotional, soulful"
ganadero	"stock, livestock"
unánime	unanimous
*** 951 - 960 (/course/185945/spanish-adjectives/96/)	
recuperado	recovered
experimentado	experienced
alimenticio	"alimentary, eating, food"
óptimo	"optimum, ideal, optimal"
respetuoso	"respectful, deferential, formal"
anciano	"old, elder, elderly"
querido	"dear, darling, loved"
exento	"exempt, free-standing"
tóxico	"toxic, toxicant, poisonous"
tributario	"tax, tributary, fiscal"
*** 961 - 970 (/course/185945/spanish-adjectives/97/)	
exiliado	"exiled, exile, in exile"
autóctono	"autochthonous, indigenous, native"
callado	"silent, quiet, kept"
liso	"smooth, flat, straight"
nórdico	"Nordic, Norse"
lunar	lunar
fiable	"reliable, trustworthy"
programado	programmed
plano	"flat, plane, level"
manuscrito	handwritten
*** 971 - 980 (/course/185945/spanish-adjectives/98/)	
geométrico	"geometrical, geometric"
notorio	"notorious, obvious, evident"
incierto	"uncertain, untrue, unsure"
licenciado	licensed
fantástico	"fantastic, fantastical, fantasy"
fértil	"fertile, rich, productive"
súbito	sudden
forzoso	"forced, necessary, obligatory"
solidario	"supportive, caring"
minoritario	minority
*** 981 - 990 (/course/185945/spanish-adjectives/99/)	
comparable	"comparable, similar"
exagerado	"exaggerated, excessive, overdone"
documentado	"documented, identifiable, informed"
mejorado	"enhanced, improved"
tirado	"stranded, lying, sprawled"
genérico	generic
criado	"grown, brought up"
acústico	"acoustic, acoustical"
delicioso	"delicious, luscious, delectable"
alcanzado	"short of, broke, penniless"
*** 991 - 1000 (/course/185945/spanish-adjectives/100/)	
estudiado	"studied, affected"
ilustrado	"illustrated, pictorial, enlightened"
arbitrario	"arbitrary, unwarranted, baseless"
paramilitar	paramilitary
sensato	"sensible, sane, rational"
inverso	"reverse, inverse, converse"
embarazada	pregnant
estúpido	"stupid, idiotic, silly"
multilateral	multilateral
protestante	"Protestant, protest"
*** 1001 - 1010 (/course/185945/spanish-adjectives/101/)	
bailarín	dancing
acuático	"aquatic, water"
farmacéutico	"pharmaceutical, pharmatical"
burocrático	"bureaucratic, official"
estético	"esthetic, aesthetic, beautiful"
non	odd
ortodoxo	"orthodox, conservative, traditional"
contado	"numbered, limited, certain"
monumental	"monumental, enormous, awesome"
desierto	"desert, deserted"
*** 1011 - 1020 (/course/185945/spanish-adjectives/102/)	
provisto	"stocked, supplied"
aliado	allied
insignificante	"insignificant, inconsiderable, trivial"
cereal	cereal
concentrado	"concentrate, concentrated, gathered"
saludable	"healthy, wholesome, salutary"
salarial	"wage, salary"
repleto	"full, replete, filled with"
croata	Croatian
robusto	"sturdy, robust, hardy"
*** 1021 - 1030 (/course/185945/spanish-adjectives/103/)	
sintético	"synthetic, artificial, concise"
inadecuado	"inadequate, unsuitable, unfit"
pegado	"glued, band-aid, stuck"
desgraciado	"miserable, unhappy, unfortunate"
ajustado	"tight, snug, close-fitting"
asombroso	"amazing, astonishing, breathtaking"
confiado	"confident, trustful, reliant"
submarino	"submarine, underwater, undersea"
libanés	Lebanese
*** 1031 - 1040 (/course/185945/spanish-adjectives/104/)	
anticipado	"early, advanced, anticipatory"
ingenuo	"ingenuous, naive, naïve"
simultáneo	"simultaneous, concurrent"
inherente	"inherent, attached to"
liviano	"light, easy"
bíblico	"biblical, scriptural, Bible"
exquisito	"exquisite, delicious, luscious"
bizantino	"Byzantine, pointless, untimely"
restringido	"restricted, limited, narrow"
fotográfico	photographic
*** 1041 - 1050 (/course/185945/spanish-adjectives/105/)	
residencial	residential
insoportable	"unbearable, insufferable, too much"
paterno	paternal
potable	"potable, drinkable, drinking"
incompleto	"incomplete, sketchy, unfinished"
expresivo	"expressive, affectionate"
atmosférico	"atmospheric, air"
ilícito	"illicit, illegal, unlawful"
olvidado	forgotten
racista	racist
*** 1051 - 1060 (/course/185945/spanish-adjectives/106/)	
asegurado	"assured, insured"
sublime	"sublime, lofty"
invertido	"invested, inverted, reversed"
independentista	"independence, pro-independence"
admirado	"admired, amazed, astonished"
decente	"honest, upright, decent"
hambriento	"hungry, ravenous, peckish"
áspero	"rough, harsh, rugged"
aduanero	customs
eventual	"eventual, prospective, temporary"
*** 1061 - 1070 (/course/185945/spanish-adjectives/107/)	
conceptual	conceptual
percibido	"perceived, spot"
puntual	"punctual, prompt, detailed"
atraído	attracted
incompatible	incompatible
condicionado	conditioned
precario	"precarious, precarious state, uncertain"
albanés	Albanian
favorecido	"favored, favoured, lucky"
limítrofe	"bordering, adjoining, adjacent"
*** 1071 - 1080 (/course/185945/spanish-adjectives/108/)	
adverso	"adverse, untoward, hostile"
periférico	"peripheral, outlying, marginal"
fluvial	"fluvial, river, riverine"
culto	"learned, educated, cultured"
agotado	"exhausted, spent, tired"
neutral	"neutral, unbiased"
resuelto	"resolved, determined, decided"
multinacional	multinational
piadoso	"godly, pious, devout"
molecular	molecular
*** 1081 - 1090 (/course/185945/spanish-adjectives/109/)	
usual	"usual, normal, customary"
retórico	"rhetoric, rhetorical, oratorical"
comunicado	connected
mediático	"media, high-profile, celebrity"
armónico	"harmonic, harmonious, symmetrical"
dichoso	"happy, blissful, bloody"
quieto	"still, quiescent, calm"
contable	"accounting, of accounts, countable"
marginal	"marginal, minimal, subsidiary"
marinero	"seagoing, seaworthy, naval"
*** 1091 - 1100 (/course/185945/spanish-adjectives/110/)	
numérico	"numeric, numerical"
intensivo	"intensive, crash"
finito	"finite, very thin"
tenso	"tense, strained, uptight"
irónico	"ironic, ironical"
hundido	"sunken, hollow, sagging"
temeroso	"afraid, fearful, timorous"
pío	"pious, piebald"
guardado	guarded
adelantado	"precocious, advanced for his age, advanced"
*** 1101 - 1110 (/course/185945/spanish-adjectives/111/)	
sumergido	"submerged, submersed, dived"
ibérico	Iberian
férreo	"iron, ferrous, rigid"
callejero	"street, from the street, stray"
melancólico	"gloomy, melancholic, melancholy"
líquido	"liquid, fluid, net"
glorioso	"glorious, splendid, great"
paraguayo	Paraguayan
ansioso	"anxious, eager, excited"
borracho	"drunken, drunk, ecstatic"
*** 1111 - 1120 (/course/185945/spanish-adjectives/112/)	
empírico	"empiric, empirical, empiricist"
rectangular	"rectangular, right-angled, having right angles"
emergente	"rising, surging, emerging"
reiterado	"reiterated, repeated"
erótico	"erotic, sexy"
cuántico	quantum
agitado	"agitated, troubled, shaken"
indefinido	"indefinite, indeterminate, permanent"
encantador	"enchanting, lovely, charming"
celoso	"jealous, zealous, conscientious"
*** 1121 - 1130 (/course/185945/spanish-adjectives/113/)	
frustrado	"frustrated, abortive, failed"
incómodo	"uncomfortable, awkward, cumbersome"
cooperativo	"cooperative, helpful"
renacentista	Renaissance
confundido	confused
volcánico	volcanic
civilizado	"civilized, civilised"
analítico	"analytic, analytical"
sostenido	"sustained, sharp, baseless"
apagado	"off, dull, out"
*** 1131 - 1140 (/course/185945/spanish-adjectives/114/)	
recíproco	"reciprocal, mutual, reciprocated"
administrado	"administered, administrated"
terapéutico	therapeutic
cortado	"cut, clipped, shy"
tripartito	tripartite
ilimitado	"unlimited, unbounded, infinite"
respetable	respectable
selectivo	"selective, exigent, choosy"
molesto	"annoying, obtrusive, troublesome"
exigente	"demanding, exigent, exacting"
*** 1141 - 1150 (/course/185945/spanish-adjectives/115/)	
finalizado	"finalized, terminated"
imponente	"imposing, grand, towering"
autoritario	"authoritarian, authoritative, bossy"
equitativo	"equitable, equal, fair"
emisor	issuing
yugoslavo	Yugoslavian
satélite	satellite
cumplido	"polite, thoughtful, generous"
sumo	"extreme, supreme"
vigoroso	"vigorous, strong, robust"
*** 1151 - 1160 (/course/185945/spanish-adjectives/116/)	
contencioso	"contentious, argumentative, captious"
próspero	"prosperous, successful, flourishing"
alcohólico	alcoholic
sereno	"calm, serene, composed"
importado	imported
emblemático	"emblematic, characteristic, archetypal"
temible	"fearsome, redoubtable, frightening"
marxista	"Marxist, Marxian"
desastroso	"disastrous, calamitous, terrible"
hidráulico	hydraulic
*** 1161 - 1170 (/course/185945/spanish-adjectives/117/)	
vago	"vague, faint, idle"
maligno	"malignant, malign, the devil"
afgano	Afghan
acreditado	"accredited, authorized US, authorised UK"
salido	"left, departed, protruding"
colorado	"red, colored, coloured"
homogéneo	homogeneous
conseguido	"well-made, well-done, well made"
perverso	"evil, wicked, perverse"
soberbio	"proud, superb, arrogant"
*** 1171 - 1180 (/course/185945/spanish-adjectives/118/)	
extraído	extracted
sobrenatural	"supernatural, unearthly"
insólito	"unusual, uncommon, extraordinary"
moro	"Moorish, possessive, black"
ascendente	"upward, up, ascendant"
inmobiliario	"real-estate (related), property"
bebido	drunk
prematuro	"early, premature, untimely"
blindado	"armored, armoured"
rudo	"rude, hard, crude"
*** 1181 - 1190 (/course/185945/spanish-adjectives/119/)	
iraní	Iranian
observado	observed
kurdo	"Kurdish, Kurd"
observador	"observant, alert"
inequívoco	"unmistakable, unequivocal, distinct"
galardonado	"award-winner, award-winning, prize-winning"
celestial	"celestial, heavenly"
cobarde	"cowardly, coward, craven"
rotundo	"definitive, emphatic, flat"
audaz	"bold, audacious, fearless"
*** 1191 - 1200 (/course/185945/spanish-adjectives/120/)	
asombrado	"astonished, amazed, flabbergasted"
indonesio	Indonesian
procesado	processed
incorrecto	"inaccurate, wrong, incorrect"
cariñoso	"loving, affectionate, warm"
portuario	port
traidor	"untrustworthy, treacherous"
fascista	fascist
descendiente	descendant
consumido	"frail, thin, drawn"
*** 1201 - 1210 (/course/185945/spanish-adjectives/121/)	
geológico	"geological, geologic"
implícito	"implicit, implied, constructive"
creador	creative
laico	"lay, secular, laic"
póstumo	posthumous
refinado	refined
consolidado	consolidated
atravesado	crosswise
discutido	controversial
rojizo	"reddish, ruddy, russet"
*** 1211 - 1220 (/course/185945/spanish-adjectives/122/)	
periódico	"periodic, periodical, recurring"
logrado	"successful, life-like"
ingenioso	"ingenious, witty, clever"
aburrido	"boring, dull, tiresome"
transportado	"transported, shipped"
estupendo	"great, wonderful, super"
quemado	"over-exposed, burnt UK, burned US"
infectado	infected
inmerso	"immersed, submerged, absorbed"
rítmico	"rhythmical, rhythmic"
*** 1221 - 1230 (/course/185945/spanish-adjectives/123/)	
cuidadoso	"careful, painstaking, detailed"
exótico	"exotic, extravagant"
perjudicado	"injured, disadvantaged, wronged"
rocoso	rocky
disperso	"dispersed, scattered, sparse"
argelino	Algerian
épico	"epic, Herculean, electrifying"
operado	operated
pintoresco	"picturesque, quaint, scenic"
unificado	united
*** 1231 - 1240 (/course/185945/spanish-adjectives/124/)	
tallado	"carved, engraved, sculpted"
necesitado	needy
restrictivo	"restrictive, tight"
cívico	"civil, civic, civilized"
trabajador	"hard-working, industrious, laborious"
rodado	"dappled, round stones, traffic"
disfrazado	disguised
indudable	"indubitable, evident, unquestionable"
moreno	"dark, brown, swarthy"
incidente	"incident, incidental"
*** 1241 - 1250 (/course/185945/spanish-adjectives/125/)	
sumido	immersed
caluroso	"warm, hot, sizzling"
teológico	theological
elástico	"resilient, springy, stretchy"
corporativo	"corporate, corporative"
metafísico	metaphysical
funerario	"funeral, funerary"
generador	"seed, generative"
fiero	"fierce, raging, ferocious"
ambiguo	"ambiguous, hard to read, inscrutable"
*** 1251 - 1260 (/course/185945/spanish-adjectives/126/)	
virtuoso	"virtuous, righteous, virtuoso"
infame	"infamous, vile, villain"
deseoso	"anxious, desirous, wishful"
quebrado	"broken, cracked, bankrupt"
alargado	"elongate, long, extended"
hueco	"hollow, resonant, empty"
suicida	"suicidal, suicide victim, suicide"
picado	"minced, chopped, ground"
renombrado	renowned
lujoso	"luxurious, fancy, plush"
*** 1261 - 1270 (/course/185945/spanish-adjectives/127/)	
calculado	"calculated, figured"
veloz	"fast, speedy, fleet"
monstruoso	"monster, monstrous, freakish"
delictivo	criminal
alterno	"alternate, alternating, alternative"
bendito	"blessed, blest, fortunate"
zapatero	"shoemaking, footwear, hard"
absorbido	absorbed
grosero	"rude, crass, boorish"
preferible	preferable
*** 1271 - 1280 (/course/185945/spanish-adjectives/128/)	
binario	binary
concertado	concerted
proporcionado	proportioned
flojo	"loose, limp, flabby"
asistente	"assistant, attendant"
guiado	guided
didáctico	"didactic, didactical, educational"
sofisticado	"sophisticated, showy, ostentatious"
continuado	"continued, kept, nonstop"
automovilístico	"motoring, car"
*** 1281 - 1290 (/course/185945/spanish-adjectives/129/)	
íntegro	"full, whole, integral"
analógico	"analogical, analogic, analogue"
agregado	"aggregate, attached, aggregated"
adyacente	"adjacent, contiguous"
fluido	"fluid, smooth, flowing"
meteorológico	"weather, meteorological"
literal	"literal, verbatim, word for word"
electromagnético	electromagnetic
obscuro	"uncertain, unsure, dark"
economista	economic
*** 1291 - 1300 (/course/185945/spanish-adjectives/130/)	
pardo	"brown, dun, half-breed"
distintivo	"distinctive, distinguishing"
afortunado	"fortunate, lucky, happy"
centenario	"centennial, centenary, hundred-year"
minucioso	"minute, thorough, meticulous"
fecundo	"fertile, fecund, pregnant"
apretado	"tight, pinched, pressed"
astuto	"cunning, clever, astute"
hereditario	hereditary
nominal	"nominal, named"
*** 1301 - 1310 (/course/185945/spanish-adjectives/131/)	
llamativo	"striking, startling, gaudy"
exponente	exponent
tardo	"slow, dull-witted"
novedoso	"novel, new, original"
graduado	"graduate, graduated, prescription"
escandaloso	"scandalous, shocking, outrageous"
alimentado	"fed, nourished"
sudamericano	South American
hospitalario	"hospitable, hospital"
nocivo	"noxious, harmful, injurious"
*** 1311 - 1320 (/course/185945/spanish-adjectives/132/)	
contiguo	"contiguous, adjacent, adjoining"
memorable	"memorable, eventful, unforgettable"
corrupto	corrupt
vicioso	"vicious, addict, malicious"
amenazador	"menacing, threatening, ominous"
carente	"lacking, wanting"
astronómico	"astronomical, astronomic"
millonario	"millionaire, loaded, million-dollar"
estático	static
arduo	"arduous, hard, tough"
*** 1321 - 1330 (/course/185945/spanish-adjectives/133/)	
portátil	portable
secular	"secular, ancient, century-old"
celta	Celtic
árido	"arid, barren, dry"
transversal	"cross, transversal, transverse"
premiado	"prizewinning, prize"
heredero	"heir, inheriting, being heir to"
suplementario	"supplementary, additional"
inusual	unusual
gemelo	twin
*** 1331 - 1340 (/course/185945/spanish-adjectives/134/)	
arrastrado	"dragged, pulled, hauled"
extinto	"extinct, defunct"
comparativo	comparative
logístico	"logistic, logistical"
contingente	contingent
destructivo	"destructive, disruptive"
hipotético	"hypothetical, notional, hypothetic"
interino	"acting, interim, temporary"
extraterrestre	"extraterrestrial, alien, extra-terrestrial"
comunal	"communal, village"
*** 1341 - 1350 (/course/185945/spanish-adjectives/135/)	
vergonzoso	"shameful, disgraceful, shameless"
tibio	"warm, lukewarm, tepid"
sobresaliente	"outstanding, protruding, leading"
sustantivo	"substantive, fundamental"
dominicano	"Dominican, of Santo Domingo"
explotado	"exploited, take advantage of"
cognitivo	cognitive
ocasionado	caused
clavado	"nailed, put up"
bovino	bovine
*** 1351 - 1360 (/course/185945/spanish-adjectives/136/)	
diminuto	"diminutive, tiny, minute"
respiratorio	respiratory
despierto	"awake, alert, wakeful"
vigésimo	twentieth
navarro	Navarrese
prehistórico	"prehistorical, prehistoric, outdated"
romo	"blunt, snub-nosed, snub"
malvado	"evil, wicked, villain"
astral	astral
compacto	compact
*** 1361 - 1370 (/course/185945/spanish-adjectives/137/)	
rosado	"pink, rosy, rose-flavoured"
contratado	contracted
ágil	"agile, nimble, quick"
endémico	"endemic, autochthonous, local"
victorioso	"victorious, winning, triumphant"
genuino	"genuine, true, authentic"
manso	"gentle, tame, meek"
devastador	"devastating, catastrophic"
apartado	"apart, remote, isolated"
plenario	"plenary, full"
*** 1371 - 1380 (/course/185945/spanish-adjectives/138/)	
anglosajón	"English-speaking, Anglo-Saxon"
ingrato	"thankless, ungrateful, hard"
cúbico	"cubic, cubical"
conflictivo	"problem, difficult, troublesome"
rústico	"rustic, peasant, coarse"
incentivo	incentive
repugnante	"disgusting, nasty, repugnant"
campeón	champion
paralizado	paralyzed
mitológico	mythological
*** 1381 - 1390 (/course/185945/spanish-adjectives/139/)	
inhumano	"inhuman, inhumane, heartless"
aleatorio	"random, aleatory, accidental"
imbécil	"imbecile, moronic, silly"
torero	"haughty, uppity, bullfighting"
inexplicable	"inexplicable, unaccountable"
acelerado	"accelerated, quick, rapid"
inquietante	"disquieting, disturbing, worrying"
abatido	"downcast, depressed, downhearted"
robado	"stolen, taken"
escénico	"scenic, dramatic"
*** 1391 - 1400 (/course/185945/spanish-adjectives/140/)	
brusco	"sharp, sudden, abrupt"
ventajoso	"advantageous, beneficial, favourable"
legislador	"legislator, legislative"
quirúrgico	surgical
extensivo	"extensive, applicable"
sanguíneo	"blood, fiery, quick-tempered"
drástico	drastic
permitido	permitted
búlgaro	Bulgarian
penitenciario	"penitentiary, confessor, prison"
*** 1401 - 1410 (/course/185945/spanish-adjectives/141/)	
jesuita	"Jesuit, Jesuitical"
grandioso	"grand, grandiose, magnificent"
cristalino	"crystalline, translucent, crystal"
elocuente	"eloquent, telling"
eminente	"eminent, prominent, noted"
funesto	"disastrous, fatal, baneful"
pedagógico	"pedagogical, pedagogic, teaching"
transatlántico	transatlantic
desplegado	"displayed, unfolded"
moribundo	"moribund, dying, dying woman"
*** 1411 - 1420 (/course/185945/spanish-adjectives/142/)	
recreativo	"leisure, recreational"
escéptico	"skeptic, skeptical, sceptical"
efímero	"fleeting, brief, short-lived"
infernal	"hellish, infernal, diabolic"
minúsculo	"tiny, minuscule, lower case"
subordinado	"subordinate, dependent, subservient"
benéfico	"beneficial, salutary, beneficent"
imperioso	"imperious, imperative, masterful"
represivo	repressive
ruidoso	"loud, noisy, rowdy"
*** 1421 - 1430 (/course/185945/spanish-adjectives/143/)	
leído	well-read
preferido	"favorite, chosen, favourite"
fisiológico	"physiologic, physiological"
subsidiario	subsidiary
certificado	"certified, registered"
precoz	"early, precocious, premature"
aristocrático	"aristocratic, patrician"
obsoleto	"obsolete, out-dated"
catastrófico	"catastrophic, disastrous, pitiful"
florido	"ornate, flowery, florid"
*** 1431 - 1440 (/course/185945/spanish-adjectives/144/)	
bibliográfico	"bibliographical, bibliographic"
atlántico	Atlantic
derribado	"demolished, felled, overthrown"
articulado	"articulated, jointed, articular"
fugitivo	"fugitive, runaway"
desprovisto	"lacking, without"
retenido	detained
gitano	"Gypsy, Gipsy, Romany"
difuso	"diffuse, vague, dim"
industrializado	industrialized
*** 1441 - 1450 (/course/185945/spanish-adjectives/145/)	
gentil	"gentile, genteel, graceful"
remitido	"sent, delivered"
impotente	"powerless, impotent, helpless"
esotérico	"esoteric, occult"
interactivo	interactive
patrio	"national, of a country, native"
arriesgado	"risky, hazardous, unsafe"
irresistible	"irresistible, compelling, resistless"
incansable	"tireless, unflagging, indefatigable"
pésimo	"awful, disastrous"
*** 1451 - 1460 (/course/185945/spanish-adjectives/146/)	
sabroso	"tasty, yummy, savory"
decorativo	"decorative, ornamental"
burlón	"mocking, jesting, quizzical"
fructífero	"fruitful, productive, fruit-bearing"
devoto	"devoted, devout, prayerful"
huérfano	"orphaned, orphan, alone"
pagano	"pagan, heathen, heathenish"
tupido	"bushy, thick, shaggy"
sociológico	sociological
ignorado	"disregarded, unknown"
*** 1461 - 1470 (/course/185945/spanish-adjectives/147/)	
caído	"fallen, drooping"
atónito	"astonished, stunned"
reformado	reformed
erudito	"erudite, learned, knowledgeable"
cuidado	taken care of
inseguro	"unsafe, unsure, insecure"
irresponsable	"irresponsible, feckless, Irresponsible"
emotivo	"emotional, moody, labile"
filipino	"Philippine, Filipino, of the Philippines"
amarillento	"yellowish, yellowy"
*** 1471 - 1480 (/course/185945/spanish-adjectives/148/)	
germánico	Germanic
empeñado	"determined, pawned, stubborn"
extremista	"extremist, extreme"
improvisado	"impromptu, makeshift, improvised"
constitutivo	"constituent element, constitutive, of formation"
sinfónico	symphonic
doblado	"bent, turned"
penúltimo	"penultimate, second-to-last, next-to-last"
pictórico	pictorial
jugado	"experienced, seasoned, astute"
*** 1481 - 1490 (/course/185945/spanish-adjectives/149/)	
semántico	"semantic, semantical"
mojado	"wet, soaked, moist"
dejado	"left, unkempt, uncared for"
plateado	"silvery, silver, silver-plating"
coreano	Korean
sectorial	"sectoral, sectorial"
indeterminado	"indeterminate, indefinite, undetermined"
lesionado	"injured, hurt, wounded"
acomodado	"accommodated, well-off, well-to-do"
ahogado	"crowded, cluttered, stalemated"
*** 1491 - 1500 (/course/185945/spanish-adjectives/150/)	
montés	"wild, mountain, highland"
prodigioso	"prodigious, monumental"
canónico	"canonical, canonic"
casual	"casual, random, chance"
pensativo	"thoughtful, pensive, reflective"
odioso	"odious, obnoxious, hateful"
jerárquico	"hierarchical, hierarchic"
triunfante	"triumphant, victorious"
alpino	Alpine
patrimonial	"patrimonial, inherited, hereditary"
*** 1501 - 1510 (/course/185945/spanish-adjectives/151/)	
superfluo	"superfluous, redundant, needless"
sumado	added
cuestionado	disputed
tosco	"coarse, rough, crude"
tormentoso	"stormy, inclement, tempestuous"
castaño	"chestnut, brown, auburn"
trivial	"trivial, banal, mundane"
indebido	"undue, improper, unjust"
armenio	Armenian
gastado	"spent, wasted, used"
*** 1511 - 1520 (/course/185945/spanish-adjectives/152/)	
grato	"agreeable, pleasant, pleasing"
destructor	destructive
grotesco	"grotesque, weird, strange"
mercenario	"mercenary, hack"
báltico	Baltic
estatutario	statutory
imperfecto	"imperfect, faulty"
triángulo	triangular
majestuoso	"majestic, stately, imposing"
organizativo	organizational
*** 1521 - 1530 (/course/185945/spanish-adjectives/153/)	
cronológico	"chronological, chronologic"
misionero	missionary
anormal	"abnormal, unnatural, anomalous"
mártir	long-suffering
cortesano	"lackey, courteous, courtly"
milagroso	"miraculous, wonder"
forense	forensic
tembloroso	"shaking, quivering, trembling"
óseo	"bony, osseous, bone"
perplejo	"perplexed, puzzled, bewildered"
*** 1531 - 1540 (/course/185945/spanish-adjectives/154/)	
engañoso	"deceitful, deceptive, misleading"
patriótico	patriotic
risueño	"smiling, beaming, sunny"
neutro	"neutral, neuter"
cimarrón	"wild, untamed"
prometedor	"promising, rosy, hopeful"
angosto	narrow
afectivo	"affective, of affection, emotional"
comprador	"buying, purchasing"
galo	"Gallic, Gaulish"
*** 1541 - 1550 (/course/185945/spanish-adjectives/155/)	
provechoso	"helpful, profitable, good"
innato	"innate, inborn, native"
diestro	"skilful, skillful, skilled"
acreedor	"worthy, deserving"
peludo	"haired, hairy, furry"
vitalicio	"life, lifelong"
mostrado	indicated
congelado	"frozen, very cold, deep-frozen"
organizador	organizing
granado	seedy
*** 1551 - 1560 (/course/185945/spanish-adjectives/156/)	
pretendido	"supposed, so-called, alleged"
diurno	"diurnal, daytime, day"
maya	Mayan
letal	"lethal, deadly"
satírico	"satirical, satiric"
lícito	"lawful, licit, legal"
desplazado	"displaced, misfit, out of place"
pragmático	"pragmatic, practical"
villano	"villain, coarse, boorish"
merecido	"deserved, well-deserved, well-earned"
*** 1561 - 1570 (/course/185945/spanish-adjectives/157/)	
investigador	investigative
afilado	"sharp, keen, cutting"
encarnado	"incarnate, ingrown, red"
sito	"situated, located"
desproporcionado	"disproportionate, undue, out of proportion"
bienvenido	welcome
precursor	"precursor, forerunner"
emparentado	"related, kindred, akin"
especulativo	"speculative, notional"
heterogéneo	"heterogeneous, diverse, varied"
*** 1571 - 1580 (/course/185945/spanish-adjectives/158/)	
inseparable	inseparable
discriminatorio	"discriminatory, discriminative"
invencible	"invincible, unbeatable, unconquerable"
hotelero	hotel
dialéctico	"dialectic, dialectical"
soltero	"single, unmarried, stag"
abreviado	"abbreviated, shortened"
papal	papal
instantáneo	"instant, instantaneous, fleeting"
venidero	"coming, future, forthcoming"
*** 1581 - 1590 (/course/185945/spanish-adjectives/159/)	
entusiasmado	"enthusiastic, eager, excited"
gramático	grammatical
caprichoso	"capricious, whimsical, wayward"
curado	"cured, mature, aged"
cercado	"fenced, enclosed"
dañino	"damaging, harmful, noxious"
evangélico	"evangelical, evangelic, evangelistic"
porcino	"porcine, pig, hog"
heredado	inherited
atlético	"athletic, trim, buff"
*** 1591 - 1600 (/course/185945/spanish-adjectives/160/)	
arraigado	"ingrained, rooted, stuck"
bondadoso	"kindly, kind, generous"
colosal	"colossal, mammoth, monumental"
pronto	"ready, prompt, quick"
reflexivo	"reflexive, sensible, prudent"
enano	"dwarfish, miniature, short"
vistoso	"colorful, ornate, flamboyant"
valeroso	"brave, valiant"
simétrico	"symmetric, symmetrical"
tribal	tribal
*** 1601 - 1610 (/course/185945/spanish-adjectives/161/)	
decorado	"decorated, furnished, fitted out"
sensual	"sensual, sensuous, sexy"
disciplinario	"disciplinary, disciplinarian"
vivido	"vivid, worldly"
manchado	"spotted, stained, dirty"
radiofónico	radio
resignado	resigned
desordenado	"disordered, disorderly, inordinate"
híbrido	"hybrid, bastard"
atrasado	"backward, late, overdue"
*** 1611 - 1620 (/course/185945/spanish-adjectives/162/)	
otomano	Ottoman
totalitario	totalitarian
veneciano	Venetian
afirmativo	"affirmative, positive"
residente	"resident, intern"
hipócrita	"hypocrite, hypocritical"
redondeado	"rounded, rounded off"
destituido	destitute
lácteo	"milk, lacteal, milky"
recio	"stout, well-built, fierce"
*** 1621 - 1630 (/course/185945/spanish-adjectives/163/)	
indigno	"undeserving, unworthy, unbecoming"
asteroide	asteroid
intrínseco	intrinsic
errante	"wandering, errant, stray"
confidencial	"confidential, private, told in secret"
capacitado	"trained, qualified"
eslovaco	"Slovakian, Slovak"
asentado	"sensible, mature, established"
mediocre	"mediocre, poor, average"
abrumador	"overwhelming, overpowering, crushing"
*** 1631 - 1640 (/course/185945/spanish-adjectives/164/)	
comunicativo	"communicative, forthcoming, sociable"
aromático	aromatic
honorario	honorary
intencionado	"intentioned, meant, deliberate"
fabuloso	"fabulous, fantastic, fictitious"
irritado	"irritated, annoyed, irked"
hinchado	"bloated, swollen, blown"
excitado	excited
panameño	Panamanian
simplificado	simplified
*** 1641 - 1650 (/course/185945/spanish-adjectives/165/)	
anexo	"annexed, attached, joined"
transnacional	"transnational, international"
afiliado	"affiliated, joined"
esférico	"spherical, spheric"
lucrativo	"lucrative, profitable"
futbolístico	"football, soccer"
humorístico	"humorous, joking, comical"
idóneo	"suitable, fitting"
consultivo	"consultative, advisory"
gaucho	helpful
*** 1651 - 1660 (/course/185945/spanish-adjectives/166/)	
fugaz	"fleeting, transient, flying"
deliberado	"deliberate, purposive, willful"
reproductivo	reproductive
desafortunado	"unfortunate, unlucky, luckless"
cascado	"cracked, broken, tinny"
opaco	"opaque, lacklustre, dull"
frenético	"frenzied, frantic, hectic"
arcaico	"archaic, old-fashioned"
naturalista	"naturalistic, naturalist"
dispar	"disparate, different, unalike"
*** 1661 - 1670 (/course/185945/spanish-adjectives/167/)	
tapado	"plugged, covered"
ocioso	"idle, at leisure, unused"
gramatical	"grammatical, grammatically correct"
terciario	"tertiary, third, Tertiary"
surrealista	"surreal, surrealist, surrealistic"
conquistador	conquering
afligido	"afflicted, distressed, mournful"
monótono	"monotone, monotonous, drab"
monárquico	"monarchic, monarchical, royalist"
cilíndrico	cylindrical
*** 1671 - 1680 (/course/185945/spanish-adjectives/168/)	
imperialista	"imperialist, imperialistic"
gritón	"loud, vocal, loud-mouthed"
cordial	"cordial, friendly, hearty"
discapacitado	"disabled, handicapped, impaired"
biográfico	"biographical, biographic"
pulmonar	"pulmonary, chest, lung"
inactivo	"inactive, quiescent, dormant"
porteño	"inhabitant of Buenos Aires, port, Porteño"
inaccesible	"inaccessible, prohibitive, incomprehensible"
consecuente	"consequent, consistent, consequential"
*** 1681 - 1690 (/course/185945/spanish-adjectives/169/)	
insensato	"senseless, insensate, meaningless"
mensajero	messenger
indeciso	"indecisive, undecided, irresolute"
iberoamericano	"Latin American, Ibero-American"
descriptivo	descriptive
franciscano	Franciscan
aeronáutico	"aeronautic, aeronautical"
inolvidable	unforgettable
improviso	unexpected
espinoso	"thorny, prickly, spiny"
*** 1691 - 1700 (/course/185945/spanish-adjectives/170/)	
lluvioso	"rainy, wet, moist"
podrido	"rotting, rotten, putrid"
ceremonial	ceremonial
norteño	"northern, north"
fonético	phonetic
involuntario	"unintentional, involuntary, unwitting"
aditivo	additive
casto	"chaste, pure, celibate"
ovino	"ovine, sheep"
etarra	ETA
*** 1701 - 1710 (/course/185945/spanish-adjectives/171/)	
exaltado	"exalted, hotheaded, ebullient"
accesorio	accessory
armonioso	"harmonious, melodious, balanced"
diabólico	"diabolic, devilish, diabolical"
imparcial	"impartial, unbiased"
manejado	used
caótico	"chaotic, in disorder, untidy"
aturdido	"stunned, confused, bewildered"
anticuado	"dated, outdated, antiquated"
sobrio	"sober, restrained, moderate"
*** 1711 - 1720 (/course/185945/spanish-adjectives/172/)	
parado	"standing, standing up, in good shape"
dilatado	"expanded, extensive, dilated"
hidroeléctrico	hydroelectric
esporádico	"sporadic, occasional, odd"
conocedor	aware
lavado	washed
imprevisto	"unexpected, sudden"
balear	Balearic
corrido	"consecutive, running, travelled"
bautizado	baptized
*** 1721 - 1730 (/course/185945/spanish-adjectives/173/)	
volador	flying
regio	"royal, kingly, regal"
trascendente	"transcendent, important, significant"
contractual	"contractual, of a contract"
necio	"foolish, fool, stupid"
episcopal	"episcopal, Episcopal"
melódico	melodic
deshecho	"undone, broken"
matinal	"matinee, morning"
guatemalteco	Guatemalan
*** 1731 - 1740 (/course/185945/spanish-adjectives/174/)	
ario	Aryan
nómada	"nomad, nomadic, wandering"
embrionario	"embryonic, embryo"
taurino	bull-fighting
altísimo	"soaring, towering, lofty"
apuntado	"pointed, aiming, pointy"
ávido	"avid, greedy, keen"
renal	"renal, kidney"
céntrico	"downtown, central, centric"
cortés	"polite, courteous, courtly"
*** 1741 - 1750 (/course/185945/spanish-adjectives/175/)	
preferente	"preferential, priority"
vertiginoso	"vertiginous, breakneck, dizzy"
abrupto	"abrupt, rapid, precipitous"
desterrado	"exiled, exile, banished"
leonés	lioness
defectuoso	"faulty, defective, with defects"
nefasto	"disastrous, unlucky, terrible"
foral	local government
litúrgico	"liturgical, liturgic"
simpatizante	"sympathizer, sympathetic, supporting"
*** 1751 - 1760 (/course/185945/spanish-adjectives/176/)	
indefenso	"helpless, defenseless, defenceless"
distraído	"distracted, absent, inattentive"
ilegítimo	illegitimate
alineado	"lined, aligned, in alignment"
psiquiátrico	psychiatric
preciado	"valuable, precious, valued"
laborioso	"laborious, industrious, ponderous"
magistral	"masterly, magisterial, masterful"
mundano	"mundane, worldly, secular"
estupefacto	"thunderstruck, dumbfounded, astonished"
*** 1761 - 1770 (/course/185945/spanish-adjectives/177/)	
predilecto	"favorite, chosen, favourite"
trémulo	"shimmery, tremulous, shimmering"
radicado	located
instruido	well-informed
sembrado	laid
inerte	"inert, motionless, lifeless"
sobreviviente	surviving
reaccionario	reactionary
rendido	"exhausted, submissive, surrendered"
multitudinario	"massive, multitudinous, mass"
*** 1771 - 1780 (/course/185945/spanish-adjectives/178/)	
mísero	"wretched, squalid, mean"
intervenido	intervened
hispánico	"Hispanic, Spanish"
infiel	"unfaithful, infidel, untrue"
triunfal	triumphal
horrendo	"horrific, horrid, frightful"
ininterrumpido	uninterrupted
adosado	attached
aficionado	"amateur, amateurish, enthusiastic about"
intuitivo	"intuitive, intuitional"
*** 1781 - 1790 (/course/185945/spanish-adjectives/179/)	
marchito	"withered, sere, overblown"
rematado	"absolute, total, complete"
arrojado	"gutsy, daring, brave"
enigmático	"enigmatic, puzzling, baffling"
bilingüe	bilingual
oceánico	oceanic
adquisitivo	"purchasing, acquisitive"
apostólico	apostolic
impasible	"impassive, unmoved, impassible"
paradójico	"paradoxical, nonsensical"
*** 1791 - 1800 (/course/185945/spanish-adjectives/180/)	
vacilante	"faltering, hesitant, vacillating"
graso	"fat, fatty, greasy"
turbio	"cloudy, murky, shady"
antropológico	"anthropological, anthropologic"
despiadado	"merciless, ruthless, remorseless"
labrado	"cultivated field, cultivated, carved"
transcurrido	lapsed
cíclico	"cyclic, gradual"
reluciente	"shiny, shining, gleaming"
desinteresado	"disinterested, uninterested, selfless"
*** 1801 - 1810 (/course/185945/spanish-adjectives/181/)	
morado	"purple, purplish, the purple one"
austero	"austere, severe, dour"
sacro	"sacral, sacred"
imaginativo	"imaginative, inventive"
afamado	"famous, renowned"
experto	"expert, skilled, knowledgeable"
perezoso	"lazy, slothful, sluggish"
parisino	Parisian
influido	"influenced, affected"
terrenal	"earthly, worldly"
*** 1811 - 1820 (/course/185945/spanish-adjectives/182/)	
infrarrojo	infrared
tenebroso	"dark, gloomy, murky"
fundido	"molten, fading, shattered"
arrebatado	"taken, rapt, rushed"
benigno	"benign, mild, kind"
cardiaco	"cardiac, heart"
intruso	intrusive
colindante	"adjacent, neighboring, adjoining"
perceptible	"perceptible, noticeable, discernible"
fraudulento	"fraudulent, dishonest, bogus"
*** 1821 - 1830 (/course/185945/spanish-adjectives/183/)	
concerniente	"concerning, relating to"
morisco	"Moorish, Moresque"
borrado	erased
desconcertado	"embarrassed, disconcerted, bewildered"
metido	"nosy, intrusive"
peregrino	"senseless, stupid, outlandish"
interpretativo	interpretative
patológico	"pathologic, pathological, neurotic"
mapuche	"Mapuche, adj"
obediente	"compliant, obedient, dutiful"
*** 1831 - 1840 (/course/185945/spanish-adjectives/184/)	
pericial	"expert, qualified"
alzado	"raised, elevated, lifted"
cambiado	turned
neoyorquino	New York
relajado	"relaxed, leisurely, laid back"
prolífico	prolific
injustificado	"unwarranted, unjustified"
nutrido	"well-stocked, nourished, healthy"
austral	"austral, southern"
accidentado	"bumpy, uneven, rough"
*** 1841 - 1850 (/course/185945/spanish-adjectives/185/)	
falto	"lacking, short, broke"
tieso	"stone-dead, dead as a doornail, broke"
descuidado	"neglected, careless, negligent"
absorto	"absorbed, engrossed, preoccupied"
salvadoreño	"Salvadoran, Salvadorian"
señorial	"manorial, baronial, lordly"
islandés	Icelandic
macizo	"massive, solid, chunky"
patético	pathetic
deprimido	"depressed, sunken, low-lying"
*** 1851 - 1860 (/course/185945/spanish-adjectives/186/)	
afectuoso	"warm, affectionate, tender"
impositivo	"tax, imposing"
oriundo	native
esbelto	"slender, slim, svelte"
autobiográfico	"autobiographical, autobiographic"
inaudito	"unheard, unheard-of, unprecedented"
impreciso	"vague, imprecise, loose"
enclavado	"buried, enclosed, nestled"
acentuado	"accented, accentuated, having an accent"
digestivo	digestive
*** 1861 - 1870 (/course/185945/spanish-adjectives/187/)	
plagado	"riddled, infested, crammed full"
rutinario	"routine, stuck in his ways, unimaginative"
métrico	"metric, metrical"
departamental	departmental
inca	Inca
estimulante	"stimulating, refreshing, stimulant"
panorámico	panoramic
certero	"accurate, certain, unerring"
causal	"causal, responsible, grounds"
revelado	"revealed, exposed, developed"
*** 1871 - 1880 (/course/185945/spanish-adjectives/188/)	
altivo	"haughty, overbearing, lordly"
saturado	"saturated, swamped, up to one's ears"
indicativo	indicative
nato	"born, congenital, natural"
torcido	"crooked, wry, turned"
paquistaní	Pakistani
rudimentario	"rudimentary, elementary, inchoate"
mudéjar	Mudejar
entendido	"understood, knowledgeable, expert"
delirante	"delirious, raving, frenzied"
*** 1881 - 1890 (/course/185945/spanish-adjectives/189/)	
enfermizo	"sickly, unhealthy, infirm"
formativo	"formative, training, educational"
cuantioso	"large, heavy, considerable"
floral	floral
fingido	"mock, pretended, feigned"
aludido	"aforementioned, aforesaid"
aledaño	"neighbouring, adjoining, bordering"
oratorio	oratorio
alentador	"encouraging, cheering"
macedonio	Macedonian
*** 1891 - 1900 (/course/185945/spanish-adjectives/190/)	
deshabitado	"uninhabited, deserted"
controlador	controlling
abusivo	"abusive, exorbitant"
socioeconómico	socioeconomic
adoptivo	"adopted, adoptive"
comedido	"restrained, reticent"
seleccionador	selection
insaciable	"insatiable, insatiate"
gestor	managing
reconocible	recognizable
*** 1901 - 1910 (/course/185945/spanish-adjectives/191/)	
gaseoso	"gaseous, gassy, fizzy"
agrio	"tart, sour, acid"
inadvertido	"inadvertent, unnoticed, unseen"
ameno	"pleasant, enjoyable, entertaining"
incógnito	"incognito, unknown"
oprimido	oppressed
asistido	"assisted, aided"
cónico	"conical, conic, cone-shaped"
teólogo	divine
honorífico	"honorific, honorable, honorary"
*** 1911 - 1920 (/course/185945/spanish-adjectives/192/)	
indiscriminado	"indiscriminate, random"
manual	"manual, hand made"
mosaico	"mosaic, Mosaic"
reinante	"reigning, regnant, prevailing"
siciliano	Sicilian
modernista	"modernist, modernistic"
domiciliario	"home, house"
nasal	nasal
inagotable	"inexhaustible, tireless, unflagging"
batido	"beaten, whipped, frappe"
*** 1921 - 1930 (/course/185945/spanish-adjectives/193/)	
undécimo	eleventh
mongol	"Mongolian, Mongol"
salado	"savory, salty, salted"
propenso	"prone, susceptible, liable"
horroroso	"horrifying, harrowing, horrid"
apuesto	"handsome, good-looking, wager"
eólico	"wind, Aeolian, eolian"
subversivo	subversive
molido	"ground, milled, minced"
azulado	"bluish, azure"
*** 1931 - 1940 (/course/185945/spanish-adjectives/194/)	
invicto	"unbeaten, undefeated, unconquered"
feminista	feminist
impenetrable	"impenetrable, impervious, inscrutable"
merecedor	worthy of
lúcido	"lucid, clear, magnificent"
idealista	idealistic
consumado	"accomplished, consummate, consumed"
narrado	narrated
emocionante	"exciting, thrilling, emotional"
nicaragüense	Nicaraguan
*** 1941 - 1950 (/course/185945/spanish-adjectives/195/)	
suntuoso	"sumptuous, palatial, rich"
sumiso	"submissive, obedient, compliant"
puntiagudo	"pointed, sharp, spiky"
invariable	"invariable, invariant, changeless"
espantado	"scared, frightened, startled"
paulatino	"gradual, slow"
marciano	Martian
sentido	"sensitive, heartfelt, deep"
turbado	"embarrassed, disturbed, troubled"
serrano	"rustic, hill, mountain"
*** 1951 - 1960 (/course/185945/spanish-adjectives/196/)	
materialista	"materialistic, materialist"
enfurecido	"enraged, maddened, furious"
igualitario	"equal, same, egalitarian"
navideño	Christmas
pulido	"polished, well-polished"
frondoso	"leafy, overgrown, lush"
termal	"thermal, hot"
mobiliario	urban furniture
dogmático	"dogmatic, opinionated, dogmatical"
sosegado	"placid, patient"
*** 1961 - 1970 (/course/185945/spanish-adjectives/197/)	
verdoso	greenish
apurado	"short, out, rushed"
reprimido	"repressed, pent"
comprensivo	"understanding, comprehensive, sympathetic"
violado	broken
facial	"facial, face value"
hondureño	Honduran
eliminatorio	"knockout, qualifying"
diseminado	"disseminated, scattered"
cantor	singing
*** 1971 - 1980 (/course/185945/spanish-adjectives/198/)	
despoblado	"deserted, outback, unsettled"
grandísimo	"great, big"
tocado	"touched, injured, rotten"
ínfimo	negligible
precolombino	pre-Columbian
tentado	tempted to
bestia	"ignorant, stupid"
infeccioso	"infective, infectious"
genital	genital
sacerdotal	"priestly, sacerdotal"
*** 1981 - 1990 (/course/185945/spanish-adjectives/199/)	
lagarto	sharp
salpicado	"splashing, sprinkle, splattered"
angustioso	"distressing, anguished, heartbreaking"
pornográfico	pornographic
azucarero	sugar
lituano	Lithuanian
benévolo	"benevolent, gentle, kindly"
activado	activated
nítido	"sharp, clear, precise"
escarpado	"steep, sheer, precipitous"
*** 1991 - 2000 (/course/185945/spanish-adjectives/200/)	
elíptico	"elliptical, elliptic"
morfológico	morphologic
cabal	"thorough, complete, proper"
impetuoso	"impetuous, impulsive, violent"
mural	"wall, mural"
letrado	learned
impío	"unholy, ungodly, impious"
fundamentalista	fundamentalist
inmoral	immoral
arancelario	tariff
*** 2001 - 2010 (/course/185945/spanish-adjectives/201/)	
paisano	from the same place
regidor	governing
airado	"angry, irate"
dócil	"docile, gentle, amenable"
curativo	"healing, curative, remedial"
sobrante	"leftover, over, spare"
náutico	nautical
ambulante	"traveling, itinerant, walking"
asimétrico	"asymmetric, asymmetrical"
conmovedor	"poignant, touching, thrilling"
*** 2011 - 2020 (/course/185945/spanish-adjectives/202/)	
labrador	Labrador
antibiótico	"antibiotic, antibacterial"
estancado	stagnant
heráldico	"heraldic, armorial"
alegórico	"allegorical, allegoric"
auditorio	hearing
arenoso	"sandy, gritty"
cosmético	cosmetic
inverosímil	"improbable, incredible, unlikely"
tácito	"tacit, unspoken, implied"
*** 2021 - 2030 (/course/185945/spanish-adjectives/203/)	
gastronómico	gastronomic
contraproducente	"counterproductive, counter-productive"
desarmado	"disarmed, unarmed, defenceless"
picante	"spicy, hot, pungent"
irreal	unreal
cosaco	Cossack
inorgánico	inorganic
travieso	"naughty, mischievous, playful"
petrolífero	petroliferous
flamante	"smart, splendid, brilliant"
*** 2031 - 2040 (/course/185945/spanish-adjectives/204/)	
abolido	abolished
napoleónico	Napoleonic
equívoco	"equivocal, mistaken, ambiguous"
manchego	"native of La Mancha, of La Mancha, Manchegan"
herbáceo	herbaceous
placentero	"pleasurable, pleasant, delightful"
naciente	"rising, nascent, infant"
foráneo	"outsider, stranger, foreign"
escultórico	"sculpture, sculptural"
atrevido	"daring, bold, presumptuous"
*** 2041 - 2050 (/course/185945/spanish-adjectives/205/)	
empobrecido	"impoverished, make poor"
asalariado	"salaried, wage-earning"
operacional	operational
supranacional	supranational
forjado	wrought
profano	"profane, lay, secular"
prusiano	Prussian
pernicioso	"pernicious, harmful, injurious"
auditivo	"auditory, aural"
mercante	"merchant, trading"
*** 2051 - 2060 (/course/185945/spanish-adjectives/206/)	
expreso	"express, specific"
igualado	"fledged, over-familiar, fresh"
hermético	"airtight, tight, hermetic"
malicioso	"malicious, mischievous, catty"
tailandés	Thai
retrasado	"delayed, late, retarded"
castrense	military
gustoso	"delicious, tasty, flavourful"
galés	Welsh
patógeno	"pathogenic, pathogen"
*** 2061 - 2070 (/course/185945/spanish-adjectives/207/)	
augusto	August
anal	anal
sanguinario	"bloodthirsty, sanguinary, bloody"
venerable	venerable
intermitente	intermittent
ucranio	Ukrainian
arrugado	"wrinkled, creased, wizened"
retrospectivo	retrospective
indiscreto	"indiscreet, tactless"
encarnizado	"bitter, grim, cutthroat"
*** 2071 - 2080 (/course/185945/spanish-adjectives/208/)	
aplastante	"crushing, overwhelming, shattering"
platónico	"Platonic, platonic"
participativo	participating
veraniego	"summer, summery, summertime"
infructuoso	"unsuccessful, fruitless, unprofitable"
algebraico	"algebraic, algebraical"
inteligible	"comprehensible, understandable, intelligible"
voluminoso	bulky
carismático	charismatic
sediento	"thirsty, hungry"
*** 2081 - 2090 (/course/185945/spanish-adjectives/209/)	
furtivo	"sneak, sneaky, furtive"
apresurado	"hasty, hurried"
fortuito	"fortuitous, lucky, fortunate"
osado	"courageous, daring, bold"
ganso	"lazy, idle, fairy"
impropio	"inappropriate, improper, unfit"
juicioso	"wise, judicious, reasonable"
mezquino	"petty, mean, shabby"
excluyente	exclusive
vespertino	"evening, vespertine"
*** 2091 - 2100 (/course/185945/spanish-adjectives/210/)	
aritmético	"arithmetic, arithmetical"
circulante	"circulating, working, current"
tentativo	tentative
incontable	"countless, innumerable, incalculable"
estilístico	stylistic
degradado	degraded
dictatorial	dictatorial
ferviente	fervent
lúdico	"playful, fun, ludic"
atípico	atypical
*** 2101 - 2110 (/course/185945/spanish-adjectives/211/)	
estrellado	"starry, stellate, star-filled"
espacioso	"roomy, spacious, airy"
proletario	"proletarian, working-class"
utópico	"Utopian, ideal, perfect"
fichado	"filed, on file"
pantanoso	"boggy, marshy, swampy"
extraviado	"lost, missing, strayed"
revelador	revealing
orbital	"orbital, orbiting"
asistencial	"care, assistance, aid"
*** 2111 - 2120 (/course/185945/spanish-adjectives/212/)	
desértico	"desert, deserted, unpopulated"
momentáneo	"momentary, fleeting, immediate"
dolorido	"sore, aching, painful"
intrincado	"intricate, tricky, involved"
orquestal	orchestral
indeseable	"undesirable, objectionable"
mayúsculo	"capitalised, tremendous, enormous"
culinario	"culinary, cooking, of cooking"
lugareño	"local, village"
dental	dental
*** 2121 - 2130 (/course/185945/spanish-adjectives/213/)	
obsesivo	obsessive
ilusorio	"illusory, unreal, illusive"
imperante	"prevailing, ruling, dominant"
insatisfecho	"dissatisfied, unsatisfied"
educacional	educational
asiduo	"regular, assiduous, frequent"
cojo	"lame, defective, wobbly"
napolitano	Neapolitan
tinto	"red, dark red, burgundy"
soleado	sunny
*** 2131 - 2140 (/course/185945/spanish-adjectives/214/)	
angustiado	"anxious, distressed, anguished"
inexperto	"inexperienced, untrained, inexpert"
razonado	reasoned
compensatorio	"countervailing, compensatory"
nigeriano	Nigerian
raso	"clear, open, cloudless"
impar	"odd, uneven, odd number"
guaraní	Guarani
lozano	"lush, lusty, healthy"
tabú	"taboo, tabu"
*** 2141 - 2150 (/course/185945/spanish-adjectives/215/)	
horario	"timetable, schedule, time"
cauteloso	"cautious, wary, cagey"
compasivo	"compassionate, tender, sympathetic"
frívolo	"frivolous, trifling, flighty"
impuro	"impure, unchaste, adj"
oblicuo	"oblique, skew, sideways"
tópico	"topical, external"
marginado	"outcast, disadvantaged, outsider"
vecinal	local
manifiesto	"manifest, apparent, obvious"
*** 2151 - 2160 (/course/185945/spanish-adjectives/216/)	
amazónico	Amazonian
chipriota	Cypriot
captado	"gain, win"
decimal	decimal
gregoriano	Gregorian
desenfrenado	"wild, rampant, unbridled"
hepático	"hepatic, liver"
extremado	excessive
confinado	"confined, bound"
despavorido	terrified
*** 2161 - 2170 (/course/185945/spanish-adjectives/217/)	
endeble	"feeble, flimsy, wimp"
larguísimo	"sesquipedalian, lengthy, marathon"
vascular	vascular
ártico	"arctic, Arctic"
doctrinal	doctrinal
saharaui	Saharan
aconsejable	"advisable, recommendable"
insuperable	"insurmountable, unbeatable, insuperable"
caritativo	"charitable, benevolent"
prevenido	"warned, prepared, forewarned"
*** 2171 - 2180 (/course/185945/spanish-adjectives/218/)	
abultado	"large, bulging, bulky"
fusionado	consolidated
cínico	"cynic, cynical"
ebrio	"drunk, inebriate, inebriated"
mafioso	"mafia, of the Mafia"
volátil	"volatile, flying, changeable"
empinado	"steep, up-and-down, straight up"
hechicero	"witch, captivating, bewitching"
arrepentido	"repentant, sorry, remorseful"
devorado	"scarf US, scoff UK"
*** 2181 - 2190 (/course/185945/spanish-adjectives/219/)	
emprendedor	"enterprising, entrepreneurial"
ileso	"uninjured, unhurt, unscathed"
desmedido	"excessive, disproportionate"
disminuido	"diminished, handicapped person, handicapped"
traumático	traumatic
comprimido	"compressed, flat, thin"
honroso	honorable
obsceno	"obscene, dirty, lewd"
ocular	"ocular, eye, optical"
anaranjado	"orange, orange-coloured"
*** 2191 - 2200 (/course/185945/spanish-adjectives/220/)	
proteccionista	"protective, protectionist"
carnívoro	carnivorous
gozoso	"pleasant, enjoyable, happy"
inmundo	"filthy, unclean, foul"
porcentual	percentage
amurallado	walled
entretenido	"entertaining, amused, amusing"
sintáctico	syntactic
galáctico	galactic
contagioso	"infectious, contagious"
*** 2201 - 2210 (/course/185945/spanish-adjectives/221/)	
cardinal	"cardinal, fundamental"
tortuoso	"tortuous, winding, circuitous"
amarrado	"tied, tight-fisted, miserly"
itinerario	itinerary
imaginable	imaginable
salino	"saline, salty, spotted"
ondulado	"wavy, corrugated, undulated"
despreocupado	"carefree, slovenly, unconcerned"
cano	"grey, grey-haired, grey-headed"
hipotecario	mortgage
*** 2211 - 2220 (/course/185945/spanish-adjectives/222/)	
cautivo	"captive, fixed, nonliquid"
cosmopolita	cosmopolitan
concurrido	"crowded, busy"
escalonado	"stepped, tiered, staggered"
colgante	"hanging, suspension"
esquivo	"elusive, evasive, shy"
anatómico	"anatomical, anatomic, form-fitting"
perfeccionado	improved
xenófobo	"xenophobic, xenophobe"
grabador	"engraving, recording, which records"
*** 2221 - 2230 (/course/185945/spanish-adjectives/223/)	
vanguardista	"avant-garde artist, forward-looking, avant-garde"
fatídico	"fateful, fatidical"
pegajoso	"sticky, tacky, gooey"
corso	Corsican
higiénico	"hygienic, sanitary"
indocumentado	"illegal alien, undocumented, unidentified"
recortado	cut
florentino	Florentine
duodécimo	twelfth
desdichado	"unhappy, unfortunate, miserable"
*** 2231 - 2240 (/course/185945/spanish-adjectives/224/)	
cinético	kinetic
relleno	"filled, stuffed"
asqueroso	"foul, gross, disgusting"
aparejado	coupled
concesionario	"licensed, franchised"
vario	"various, several, varied"
infundado	"unfounded, groundless, baseless"
explicativo	"explanatory, explicative"
imperativo	"imperative, authoritative, commanding"
colegiado	collegiate
*** 2241 - 2250 (/course/185945/spanish-adjectives/225/)	
regalado	given
desmesurado	"excessive, disproportionate, enormous"
carnal	"carnal, fleshly, by blood"
categórico	"categorical, definite, flat"
integrador	conciliatory
histérico	"hysterical, hysteric"
disparatado	"crazy, goofy, absurd"
copioso	"copious, rich, plentiful"
disimulado	"hidden, concealed"
mentiroso	"lying, false, untruthful"
*** 2251 - 2260 (/course/185945/spanish-adjectives/226/)	
afable	"affable, genial, matey"
inefable	"ineffable, unspeakable, indescribable"
macabro	"macabre, grim, ghoulish"
burdo	"coarse, clumsy, rough"
estacionario	"stationary, unchanging, unchanged"
empatado	tied
caballeresco	"knightly, chivalrous, gentlemanly"
meritorio	"meritorious, worthy, deserving"
sagaz	"sagacious, canny, sharp"
borroso	"blurry, faint, vague"
*** 2261 - 2270 (/course/185945/spanish-adjectives/227/)	
supersticioso	superstitious
repetitivo	"repetitive, repeated, repeating"
bacteriano	bacterial
inapropiado	"inappropriate, unsuitable"
ontológico	ontological
glacial	"glacial, frosty, stony"
echado	"lying, laid"
mortífero	"lethal, deadly, mind-numbing"
recluso	imprisoned
confiable	"trustworthy, reliable"
*** 2271 - 2280 (/course/185945/spanish-adjectives/228/)	
bioquímico	biochemical
profético	"prophetic, prophetical, predictive"
antiaéreo	antiaircraft
inalámbrico	"wireless mike/telephone, wireless, cordless"
loable	"praiseworthy, laudable, worthy"
desocupado	"idle, unoccupied, empty"
docto	"learned, knowledgeable, well versed"
entrañable	"intimate, snug, cozy"
programático	programmatic
ateo	atheistic
*** 2281 - 2290 (/course/185945/spanish-adjectives/229/)	
amerindio	Amerindian
distorsionado	distorted
colonizador	"colonial, colonizing, colonising"
malévolo	"malevolent, malicious, spiteful"
bayo	bay
heterosexual	"heterosexual, straight"
pelado	"bare, bald, broke"
metabólico	metabolic
disciplinado	"disciplined, trained, well-behaved"
irreparable	"irreparable, irretrievable, unrepairable"
*** 2291 - 2300 (/course/185945/spanish-adjectives/230/)	
agravado	aggravated
itinerante	"itinerant, peripatetic, traveling"
resumido	"summarized, summarised"
descalzo	"barefoot, bare, barefooted"
prolijo	"prolix, wordy, long-winded"
arreglado	"arranged, neat, settled"
inacabado	"unfinished, incomplete"
cándido	"adj, naïve, ingenuous"
inconcluso	unfinished
dominador	domineering
*** 2301 - 2310 (/course/185945/spanish-adjectives/231/)	
chocante	"striking, shocking, surprising"
inestimable	"invaluable, inestimable, priceless"
indivisible	indivisible
campestre	"country, rural, countryside"
ponderado	"weighted, balanced, prudent"
arterial	arterial
catastral	"cadastral, land register"
estudioso	"studious, bookish"
vikingo	"Viking, Norse"
vencedor	"victor, victorious, conquering"
*** 2311 - 2320 (/course/185945/spanish-adjectives/232/)	
falsificado	"falsified, forged, counterfeit"
coloquial	"colloquial, coloquial, informal"
cauto	"cautious, careful, wary"
perturbado	disturbed
inexorable	"inexorable, relentless, ruthless"
entreabierto	"ajar, half-open"
dinástico	dynastic
afecto	"attached, fond, keen"
funeral	funeral
anímico	"of mind, mental, emotional"
*** 2321 - 2330 (/course/185945/spanish-adjectives/233/)	
incontrolado	"uncontrolled, unrestrained, unauthorised"
cuñado	sister-in-law
siderúrgico	iron and steel
turbulento	"turbulent, wild, troubled"
milenario	"millenary, millennial, millennium"
impedido	"disabled, handicapped, hindered"
bávaro	Bavarian
estirado	"drawn, stretched, stiff"
previsor	foresighted
nutritivo	"nutritive, nutrient, nutritious"
*** 2331 - 2340 (/course/185945/spanish-adjectives/234/)	
asirio	Assyrian
conciso	"concise, short, pithy"
arbitral	arbitral
combativo	combative
soñador	"dreamy, dreamer"
estilizado	"stylized, slender, slim"
expansivo	expansive
obstinado	"obstinate, stubborn, obdurate"
bellísimo	"gorgeous, lovely"
seductor	seductive
*** 2341 - 2350 (/course/185945/spanish-adjectives/235/)	
cruento	bloody
soñado	"dreamed-about, dreamy, mad"
carnoso	"full, thick, fleshy"
suplente	"substitute, surrogate"
pobrecito	poor
inconfundible	unmistakable
descompuesto	"impolite, rude, drunk"
puerco	sow
rancio	"musty, rancid, fusty"
cromático	"chromatic, colour"
*** 2351 - 2360 (/course/185945/spanish-adjectives/236/)	
metalúrgico	"metallurgical, metalworker, metallurgist"
ecuatorial	equatorial
burro	"furious, beside himself, brainless"
cítrico	"citric, citrus"
quitado	taken
diligente	"diligent, hard-working, assiduous"
derechista	"rightist, right-wing"
atropellado	"rushed, hurried"
intransigente	"intransigent, uncompromising, diehard"
disgustado	"upset, displeased, annoyed"
*** 2361 - 2370 (/course/185945/spanish-adjectives/237/)	
puntero	"leading, cutting-edge, state-of-the-art"
suspenso	"on the back burner, pending, suspended"
desafiante	"challenging, rebellious, defiant"
receptivo	"receptive, open"
bronco	"adj, rough, course"
miliciano	"militiwoman, militia"
deformado	"distorted, deformed"
belicoso	"warlike, bellicose, pugnacious"
individualizado	individualized
abdominal	abdominal
*** 2371 - 2380 (/course/185945/spanish-adjectives/238/)	
antagónico	antagonistic
truncado	"truncated, cut short"
capón	castrated
volante	flying
ayudante	assistant
pícaro	"mischievous, impish, crafty"
postrer	"last, final"
erizado	"standing up on end, prickly, bristling with"
descubridor	"inquisitive, investigative, of inquiry"
pródigo	"lavish, prodigal, wasteful"
*** 2381 - 2390 (/course/185945/spanish-adjectives/239/)	
adinerado	"wealthy, moneyed, rich"
ruinoso	"ruinous, ruined, tumbledown"
excelso	"excellent, sublime"
bohemio	"Bohemian, bohemian"
congénito	congenital
sumario	"summary, brief, short"
peatonal	pedestrian
descontento	"discontent, discontented, disgruntled"
federativo	"federative, federate"
terrorífico	"terrifying, horrific, terrific"
*** 2391 - 2400 (/course/185945/spanish-adjectives/240/)	
sitiado	"besieged, surrounded"
mestizo	"mongrel, crossbred, mestizo"
bonachón	"kindly, affable, easygoing"
giratorio	"rotatory, gyratory, revolving"
conciliador	conciliatory
desconfiado	"suspicious, mistrustful, distrustful"
indecible	"unspeakable, unutterable, untold"
apócrifo	"apocryphal, spoof, inauthentic"
reactivo	reactive
facultativo	"optional, medical, facultative"
*** 2401 - 2410 (/course/185945/spanish-adjectives/241/)	
obeso	obese
contrapuesto	"opposed, countered"
candente	"red-hot, current, latest"
versado	"versed, well versed, knowledgeable"
primaveral	"spring, spring-like"
torrencial	"torrential, pouring, driving"
tipográfico	typographic
sobrehumano	superhuman
lánguido	"languorous, languid, limp"
arbóreo	arboreal
*** 2411 - 2420 (/course/185945/spanish-adjectives/242/)	
desconcertante	"baffling, embarrassing, disconcerting"
tamaño	"huge, colossal, such a large"
incendiario	incendiary
exiguo	"meager, scanty, exiguous"
confiscado	"confiscated, forfeit"
monástico	"monastic, monkish"
cartesiano	Cartesian
finés	Finnish
verosímil	"plausible, realistic, verisimilar"
aprovechado	"resourceful, hard-working"
*** 2421 - 2430 (/course/185945/spanish-adjectives/243/)	
zoológico	"zoological, zoo"
animoso	"spirited, game"
azotado	whipped
escueto	"succinct, concise, frank"
combatiente	"combatant, fighting"
gallardo	"dashing, gallant, debonair"
cantábrico	"Cantabrian, of Cantabria"
centésimo	hundredth
lechero	"milk, dairy, milkwoman"
vanidoso	"vain, conceited, smug"
*** 2431 - 2440 (/course/185945/spanish-adjectives/244/)	
mutilado	"cripple, hacked about"
pronóstico	prognostic
desechado	waste
curvado	bent
preceptivo	"prescriptive, mandatory, compulsory"
sensitivo	"sensitive, therapeutic"
descolorido	"colorless, faded, off-colour"
divorciado	"divorcé/divorcée, divorced"
metódico	"methodical, orderly"
sedentario	"sedentary, inactive, settled"
*** 2441 - 2450 (/course/185945/spanish-adjectives/245/)	
vernáculo	vernacular
libio	Libyan
recóndito	"remote, distant, unexplored"
matutino	"morning, morning paper"
instructivo	"instructive, instructional, illuminating"
distanciado	estranged
grisáceo	"grayish, greyish"
analfabeto	"illiterate, unlearned, unlettered"
caudaloso	"wide, fast-flowing"
coronario	coronary
*** 2451 - 2460 (/course/185945/spanish-adjectives/246/)	
ronco	hoarse
ribereño	"riparian, riverine, riverside"
vicario	vicarious
fogoso	"ardent, passionate, fanatical"
convergente	"convergent, in agreement, converging"
sonado	"dreamed-about, dreamy, mad"
patriarcal	patriarchal
preponderante	"prevailing, main"
encorvado	"curved, crooked, slouch"
reñido	"be at odds with, fallen out with, hard-fought"
*** 2461 - 2470 (/course/185945/spanish-adjectives/247/)	
etimológico	etymologic
confortable	"comfortable, comfy, comforting"
presencial	"face-to-face, in-person"
importuno	"importunate, obtrusive"
difunto	"deceased, late, defunct"
neurológico	neurological
agreste	"wild, rough, rural"
adorable	"adorable, to be adored, to be worshipped"
diagnóstico	diagnostic
oportunista	"opportunist, opportunistic"
*** 2471 - 2480 (/course/185945/spanish-adjectives/248/)	
inalcanzable	"unachievable, unattainable"
individualista	individualist
subdesarrollado	"developing, underdeveloped"
preexistente	preexisting
sarcástico	"sarcastic, snide"
petrificado	petrified
blanquecino	"whitish, pallid"
aldeano	"village, rustic"
intrépido	"intrepid, fearless, bold"
calculador	"calculating, astute, scheming"
*** 2481 - 2490 (/course/185945/spanish-adjectives/249/)	
servicial	"helpful, accommodating, obliging"
birmano	Burmese
rugoso	"coarse, wrinkled"
visionario	visionary
plebeyo	"plebeian, common"
léxico	lexical
oficioso	"informal, officious"
envidiable	enviable
gremial	"union, trade"
lívido	"livid, lurid, pallid"
*** 2491 - 2500 (/course/185945/spanish-adjectives/250/)	
dispositivo	"regulatory, dispositive"
contemplativo	contemplative
sajón	"Saxon, of Saxony"
fragmentario	fragmentary
sinuoso	"sinuous, serpentine, devious"
cotizado	"valued, esteemed"
fraternal	"fraternal, brotherly, sisterly"
vaticano	Vatican
isleño	islander
entrante	"coming in, entering, next"
*** 2501 - 2510 (/course/185945/spanish-adjectives/251/)	
todopoderoso	"almighty, the Almighty, all powerful"
nobiliario	nobiliary
dificultoso	"difficult, troublesome, hard going"
prosaico	"prosaic, earthbound, prosy"
domesticado	"domesticated, tame, housebroken"
locomotor	"locomotive, locomotor"
ecléctico	eclectic
fastidioso	"fastidious, annoying, bothersome"
tiránico	"tyrannical, tyrannous, oppressive"
conexo	related
*** 2511 - 2520 (/course/185945/spanish-adjectives/252/)	
tectónico	tectonic
susodicho	"above, aforementioned, aforesaid"
solvente	"solvent, sound, reliable"
imponible	"taxable, tax, dutiable"
polvoriento	"dusty, powdery"
insatisfactorio	unsatisfactory
rizado	"curly, kinky, frizzy"
enmascarado	masked
merino	merino
ovalado	oval
*** 2521 - 2530 (/course/185945/spanish-adjectives/253/)	
privativo	privative
alfabético	"alphabetic, alphabetical"
ático	"attic, of Attica, Attic"
chillón	"gaudy, lurid, harsh"
impactante	"adj, impressive, powerful"
musculoso	"muscular, brawny"
inducido	induced
ofendido	"insulted, hurt"
liguero	league
rotativo	"rotary, rotating, rotative"
*** 2531 - 2540 (/course/185945/spanish-adjectives/254/)	
detestable	"abhorrent, detestable, obnoxious"
veraz	"real-life, true, verified"
agobiado	"suffocated, overwhelmed, inundated"
bienaventurado	blessed
nupcial	"bridal, wedding, nuptial"
utilitario	utilitarian
sugerente	"sexy, suggestive"
tuerto	"one-eyed person, one-eyed, blind in one eye"
perforado	"perforated, punched"
terco	"stubborn, obstinate, opinionated"
*** 2541 - 2550 (/course/185945/spanish-adjectives/255/)	
aerodinámico	aerodynamic
preparativo	preparative
suburbano	suburban
etéreo	"ethereal, aerial, airy"
cervical	"cervical, neck"
homólogo	homologous
linfático	lymphatic
escrupuloso	scrupulous
incurable	"incurable, hopeless"
perspicaz	"keen, clear-eyed, acute"
*** 2551 - 2560 (/course/185945/spanish-adjectives/256/)	
depresivo	"depressing, depressive"
pavoroso	"dreadful, frightening, terrifying"
cuajado	"dumbfounded, full, asleep"
monográfico	"monographic, on a single subject"
lustroso	"glossy, lustrous"
consular	consular
codiciado	"coveted, sought-after"
frutal	fruity
adjetivo	adjective
etrusco	Etruscan
*** 2561 - 2570 (/course/185945/spanish-adjectives/257/)	
importador	"importing, import, importer"
receloso	"suspicious, mistrustful, distrusting"
pastoril	"pastoral, rural, shepherding"
purpúreo	purple
sedimentario	sedimentary
esperanzador	"encouraging, inspiring"
lloroso	"weeping, tearful, in tears"
felino	"feline, catlike, cat-like"
impertinente	"impertinent, pert, cheeky"
bizarro	"dashing, brave, gallant"
*** 2571 - 2580 (/course/185945/spanish-adjectives/258/)	
sórdido	"seedy, sleazy, sordid"
acérrimo	"staunch, steadfast, bitter"
cartaginés	Carthaginian
luterano	Lutheran
pasional	"passional, passionate"
inflamable	"inflammable, flammable"
simulado	"simulated, mock"
meridiano	"meridian, midday"
incoloro	"colorless, colourless"
anglicano	Anglican
*** 2581 - 2590 (/course/185945/spanish-adjectives/259/)	
evolucionado	evolved
figurado	"figurative, figured"
metafórico	metaphorical
aristotélico	Aristotelian
desorientado	"disoriented, disorientated, confused"
misericordioso	"merciful, compassionate"
antecesor	preceding
erecto	erect
nublado	"cloudy, overcast, storm cloud"
suculento	"succulent, luscious, juicy"
*** 2591 - 2600 (/course/185945/spanish-adjectives/260/)	
acalorado	"hot, warm, heated"
beato	"blessed, pious, sanctimonious"
reverendo	"reverend, revered"
esquemático	"schematic, diagrammatic, simplified"
bobo	"stupid, dumb, idiotic"
vaginal	vaginal
anómalo	"anomalous, aberrant"
plácido	"placid, calm, quiet"
bajito	"ground floor, under, poor"
indulgente	"indulgent, forgiving, lenient"
*** 2601 - 2610 (/course/185945/spanish-adjectives/261/)	
maltrecho	"injured, badly damaged, battered"
incontrolable	"uncontrollable, irrepressible, ungovernable"
probatorio	"evidentiary, probative, evidential"
corpóreo	"corporeal, three-dimensional, 3D"
inexacto	"inaccurate, inexact, incorrect"
espartano	"spartan, austere, Spartan"
provinciano	"provincial, backward, narrow-minded"
colmado	"abundant, full, saturated"
acondicionado	conditioned
expandido	expanded
*** 2611 - 2620 (/course/185945/spanish-adjectives/262/)	
exponencial	exponential
inalterable	"unalterable, immovable, inalterable"
alborotado	"unruly, rowdy, messy"
velado	"veiled, hidden, blurred"
trepador	rambling
decadente	"decadent, effete, in decline"
descarado	"blatant, sassy, brazen"
vagabundo	"vagabond, tramp, bum"
capilar	"capillary, hair"
lastimoso	"pitiable, pitiful, piteous"
*** 2621 - 2630 (/course/185945/spanish-adjectives/263/)	
psicodélico	"psychedelic, psychodelic"
inviolable	"inviolable, impregnable, insurmountable"
amigable	friendly
futurista	"futuristic, futurist"
inspirador	"inspirational, inspiring, inspiratory"
desdeñoso	"disdainful, scornful, contemptuous"
populoso	populous
hídrico	"water, hydrological"
portentoso	"prodigious, portentous, wonderful"
pormenorizado	detailed
*** 2631 - 2640 (/course/185945/spanish-adjectives/264/)	
impulsivo	"impulsive, hot-headed"
presumido	"smug, pretentious, snooty"
tunecino	Tunisian
generacional	"generational, generation"
multicolor	"multicolor, multicolored, motley"
godo	"Gothic, Goth, Spaniard"
agarrado	"stingy, mean, cheek-to-cheek"
viscoso	"viscous, viscid, gooey"
centígrado	"Celsius, centigrade, Centigrade"
etíope	Ethiopian
*** 2641 - 2650 (/course/185945/spanish-adjectives/265/)	
montañés	mountain
nostálgico	"nostalgic, homesick, wishful"
postrado	prostrate
esperanzado	"hopeful, optimistic"
oloroso	"odorous, fragrant"
pelirrojo	redhead
pujante	"booming, thriving"
habitable	"habitable, liveable, livable"
inocuo	"harmless, innocuous"
taciturno	"taciturn, morose, glum"
*** 2651 - 2660 (/course/185945/spanish-adjectives/266/)	
figurativo	"figurative, representational"
incisivo	"incisive, trenchant, sharp"
curtido	"tanned, hardened, experienced"
manufacturado	manufactured
victoriano	Victorian
jeroglífico	hieroglyphic
canino	canine
esforzado	"valiant, vigorous, strong"
descargado	discharged
surcoreano	South Korean
*** 2661 - 2670 (/course/185945/spanish-adjectives/267/)	
poseído	"possessed, driven, obsessed"
omnipresente	omnipresent
tranquilizador	"soothing, reassuring, calming"
macroeconómico	macroeconomic
vengativo	"vengeful, vindictive, retaliatory"
diáfano	"diaphanous, transparent, limpid"
descabellado	"ridiculous, hare-brained, absurd"
consabido	"familiar, aforementioned, well-known"
convexo	convex
anticonceptivo	contraceptive
*** 2671 - 2680 (/course/185945/spanish-adjectives/268/)	
inmovilizado	immobilized
concurrente	"concurrent, joining, uniting"
diversificado	diversified
sacrílego	sacrilegious
enganchado	"hooked, strung out, addicted"
venturoso	"fortunate, happy, venturous"
inmaterial	"immaterial, intangible"
palpitante	"palpitating, throbbing, beating"
axial	axial
reticente	"reticent, reluctant"
*** 2681 - 2690 (/course/185945/spanish-adjectives/269/)	
sensacional	"sensational, great"
haitiano	Haitian
centeno	"ryegrass, rye"
estrepitoso	"loud, uproarious, deafening"
ventral	ventral
relacional	relational
caduco	"deciduous, caducous, perishable"
lucido	"magnificent, splendid, lucid"
conífero	coniferous
cóncavo	concave
*** 2691 - 2700 (/course/185945/spanish-adjectives/270/)	
atascado	mired
acaudalado	"rich, well-to-do, wealthy"
encogido	"shrunken, huddled, crouched"
transgénico	"transgenic, genetically modified"
detector	detecting
discontinuo	"discontinuous, broken"
céltico	Celtic
novelesco	"fictional, fantastic"
impermeable	"impermeable, waterproof, impervious"
chiflado	"crazy, nuts, mad"
*** 2701 - 2710 (/course/185945/spanish-adjectives/271/)	
provocativo	"provocative, sexy, suggestive"
colegial	"collegiate, school, college"
jugoso	"juicy, succulent, colorful"
antipático	"unfriendly, unlikeable, antipathetic"
diocesano	diocesan
extrajudicial	"extrajudicial, out-of-court"
estampado	"print, printed, printing"
selvático	"wild, sylvan"
inanimado	inanimate
talentoso	"talented, gifted"
*** 2711 - 2720 (/course/185945/spanish-adjectives/272/)	
conducente	conducive
repulsivo	"repellent, repulsive, hideous"
inculto	"uncultivated, illiterate, rude"
angélico	angelic
humanístico	humanistic
valido	"favorite, favourite, valid"
herético	"heretic, heretical"
irrevocable	"irrevocable, indefeasible, irreversible"
piramidal	pyramidal
asustadizo	"scary, skittish, scared"
*** 2721 - 2730 (/course/185945/spanish-adjectives/273/)	
neumático	pneumatic
procesional	processional
pausado	"slow, deliberate, easy"
táctil	"tactile, touch"
atestado	"crowded, full, packed"
componente	component
fanático	"fanatical, fanatic, bigot"
sobrecargado	"overloaded, overburdened"
insospechado	unsuspected
bastardo	bastard
*** 2731 - 2740 (/course/185945/spanish-adjectives/274/)	
lastimero	"plaintive, mournful"
presuroso	"quick, hasty, speedy"
zalamero	"smoothie, greasy, flattering"
vienés	Viennese
diagonal	diagonal
parlante	"talking, speaking"
jadeante	"panting, breathless"
magnánimo	magnanimous
álgido	"decisive, critical, freezing"
depurado	"refined, pure"
*** 2741 - 2750 (/course/185945/spanish-adjectives/275/)	
esmerado	"careful, painstaking, neat"
volcado	"capsized, overturned, turned over"
oxidado	"rusty, oxidized, rusted"
malogrado	"late, late lamented, deceased"
circulatorio	circulatory
despótico	"despotic, overbearing, tyrannical"
absolutista	absolutist
incauto	"incautious, unwary, unguarded"
picaresco	"picaresque, roguish, arch"
aconsejado	advised
*** 2751 - 2760 (/course/185945/spanish-adjectives/276/)	
reseco	"arid, parched, skinny"
envolvente	"enveloping, surrounding, covering"
oneroso	"onerous, heavy, burdensome"
tumultuoso	"tumultuous, noisy, riotous"
aluvial	alluvial
embarazoso	"awkward, embarrassing, shameful"
inmaduro	"immature, callow, undeveloped"
sísmico	seismic
improcedente	"unfair, improper, inadmissible"
condensado	condensed
*** 2761 - 2770 (/course/185945/spanish-adjectives/277/)	
subrayado	"underlining, underlined"
satánico	Satanic
soso	"bland, tasteless, dull"
pastor	shepherdess
ilustrativo	"illustrative, explanatory"
deslucido	"tattered, worn, worn out"
retroactivo	"retrospective, backdated"
circunstancial	circumstantial
secuencial	sequential
sexy	"sexy, sex appeal, hot"
*** 2771 - 2780 (/course/185945/spanish-adjectives/278/)	
acogedor	"welcoming, warm, friendly"
predecible	predictable
ecuménico	"ecumenical, oecumenical"
áureo	golden
sepulcral	"sepulchral, hollow, stony"
letón	Latvian
calcáreo	calcareous
ortogonal	orthogonal
alusivo	"allusive, alluding, referring"
concienzudo	"conscientious, thorough, thoroughgoing"
*** 2781 - 2790 (/course/185945/spanish-adjectives/279/)	
polideportivo	multisport
trabajoso	"hard-going, laborious, hard"
inflamado	"swollen, aflame, sore"
vándalo	Vandal
chato	"flat, snub nosed, pug-nosed"
perdurable	"lasting, perdurable, abiding"
urinario	"comfort station, loo, urinary"
ahumado	"smoked, smoky, tinted"
irremediable	"hopeless, irremediable, incurable"
agraciado	"graceful, attractive, good-looking"
*** 2791 - 2800 (/course/185945/spanish-adjectives/280/)	
negado	"hopeless, useless, rubbish"
descontrolado	uncontrolled
resbaladizo	"slippery, touchy, delicate"
contrariado	"annoyed, disgruntled"
burlesco	"burlesque, mock, mocking"
pakistaní	Pakistani
rastrero	"creeping, slithering, squirming"
magnifico	"magnificent, superb, great"
resonante	"resonant, ringing, booming"
zonzo	"idiot, bore, stupid"
*** 2801 - 2810 (/course/185945/spanish-adjectives/281/)	
holgado	"loose, baggy, roomy"
tricolor	tricolor
sugestivo	"suggestive, stimulating"
cancerígeno	"carcinogenic, cancerogenic"
utilizable	usable
infrecuente	"infrequent, few and far between, uncommon"
fornido	"well-built, strapping, hefty"
maxilar	maxillary
disuasorio	"deterrent, dissuasive"
barbudo	bearded
*** 2811 - 2820 (/course/185945/spanish-adjectives/282/)	
proscrito	"proscribed, outcast, outlaw"
concéntrico	"concentric, concentrical"
poquísimo	very little
consentido	"favorite, spoilt, spoiled"
motorizado	"motorized, powered"
fidedigno	"trustworthy, reliable, credible"
inmunológico	"immune, immunological"
antedicho	"above, aforesaid, aforementioned"
mono	"pretty, cute, adorable"
ascético	ascetic
*** 2821 - 2830 (/course/185945/spanish-adjectives/283/)	
basto	"coarse, rude, impolite"
helénico	Hellenic
patricio	patrician
manejable	"manageable, tractable, easy to handle"
enojoso	"annoying, irritating, aggravating"
forastero	"outsider, alien, stranger"
matriculado	"registered, enrolled, licensed"
errado	"wrong, mistaken, amiss"
fulgurante	"stunning, shining, bright"
rayado	"lined, streaky, streaked"
*** 2831 - 2840 (/course/185945/spanish-adjectives/284/)	
veterinario	veterinary
defraudado	disappointed
cabizbajo	"crestfallen, bowed, dejected"
trigésimo	thirtieth
cutáneo	"cutaneous, skin, of the skin"
inflamatorio	inflammatory
expedicionario	expeditionary
barítono	baritone
interurbano	interurban
predestinado	"predestined, fated, doomed"
*** 2841 - 2850 (/course/185945/spanish-adjectives/285/)	
sintomático	symptomatic
codicioso	"greedy, covetous, avaricious"
regresivo	regressive
desfigurado	"contorted, distorted, twisted"
incontestable	"incontestable, unanswerable, unquestioned"
semestral	"biannually, half-year"
peyorativo	"pejorative, derogatory"
expectante	"expectant, excited, eager"
palaciego	"palatial, courtier, palace"
desgarrador	"heartbreaking, heartrending"
*** 2851 - 2860 (/course/185945/spanish-adjectives/286/)	
sazonado	"flavored, seasoned, spiced up"
hediondo	"stinking, smelly, fetid"
irrefutable	"irrefutable, unanswerable, indefensible"
policiaco	"police, detective, crime"
vegetariano	"vegetarian, vegan, veggie"
acoplado	coupled
acostado	"lying, lying down"
trimestral	"quarterly, three-month"
rectángulo	"rectangle, oblong"
malhumorado	"grumpy, surly, peevish"
*** 2861 - 2870 (/course/185945/spanish-adjectives/287/)	
ígneo	igneous
descarnado	"stark, blunt, with all the gory details"
ininteligible	"incomprehensible, unintelligible, illegible"
rezagado	"lagging, laggard, straggler"
verídico	"true, veracious, veridical"
intocable	"untouchable, unaffordable, out of one's price range"
inconmensurable	"immeasurable, incommensurable, incommensurate"
lacustre	lacustrine
pomposo	"pompous, grandiose, overblown"
imposibilitado	helpless
*** 2871 - 2880 (/course/185945/spanish-adjectives/288/)	
ortográfico	orthographic
paleolítico	"paleolithic, palaeolithic"
improductivo	"unproductive, idle, unprofitable"
confesional	denominational
clemente	"merciful, gracious, clement"
reversible	reversible
lerdo	"dull, heavy, oafish"
arcilloso	"clayey, argillaceous"
retrógrado	"retrograde, reactionary, retrogressive"
corrector	"correcting, corrective"
*** 2881 - 2890 (/course/185945/spanish-adjectives/289/)	
abarrotado	"crammed, packed, jammed"
arábigo	"Arabic, Arab"
anecdótico	"anecdotic, anecdotal, anecdotical"
desempleado	"unemployed, jobless, out of work"
aguerrido	"brave, courageous, valiant"
radioactivo	radioactive
paranoico	"paranoiac, paranoid"
depositario	depositary
bullicioso	"boisterous, bustling, rowdy"
corrosivo	"corrosive, acerbic, acid"
*** 2891 - 2900 (/course/185945/spanish-adjectives/290/)	
policíaco	"police, detective, crime"
vacacional	vacation
crustáceo	"crusty, scabby"
testimonial	"testimonial, token, symbolic"
arameo	"Aramean, Aramaean"
enjuto	"lean, spare, skinny"
nadador	swimmer
endocrino	"endocrine, endocrinal"
confederado	confederate
angelical	"angelic, angelical"
*** 2901 - 2910 (/course/185945/spanish-adjectives/291/)	
subalterno	"junior, subordinate, subaltern"
amorfo	"amorphous, shapeless, insipid"
surcado	"furrowed, lined"
bisexual	bisexual
maltés	Maltese
machista	"male chauvinist, macho, sexist"
persuasivo	"persuasive, convincing"
mordaz	"scathing, biting, incisive"
fervoroso	"fervent, earnest, passionate"
herbívoro	"herbivorous, herbivore"
*** 2911 - 2920 (/course/185945/spanish-adjectives/292/)	
gástrico	gastric
baldío	"waste, vain, useless"
antisocial	antisocial
espumoso	"frothy, sparkling, foamy"
copto	Coptic
bestial	"beastly, bestial, brutish"
pecuario	"livestock, cattle"
desposeído	"repossessed, deprived, dispossessed"
convulso	convulsed
idílico	idyllic
*** 2921 - 2930 (/course/185945/spanish-adjectives/293/)	
insulso	"flavourless, bland, flavorless"
neurótico	neurotic
interpersonal	interpersonal
catedral	"huge, monumental"
bailable	"dancey, dance, danceable"
caminante	"hiker, itinerant, wandering"
jocoso	"humorous, jocular, jocose"
reposado	"relaxed, calm"
laborable	"working, work, arable"
regionalista	regionalist
*** 2931 - 2940 (/course/185945/spanish-adjectives/294/)	
leñoso	"woody, ligneous"
ceniciento	"ashy, ashen, ash-gray"
desolador	"horrifying, devastating, distressing"
introductorio	"introductory, induction"
desprevenido	"unprepared, unaware, unready"
escalofriante	"spooky, hair-raising, bloodcurdling"
insalvable	"insuperable, insurmountable"
proteico	protean
sionista	Zionist
estropeado	"spoiled, damaged, ruined"
*** 2941 - 2950 (/course/185945/spanish-adjectives/295/)	
alocado	"crazy, mad, fast"
pecuniario	pecuniary
arbustivo	shrubby
arbolado	"wooded, tree-covered"
mimado	"spoiled, indulged, darling"
rotatorio	rotating
circunscrito	circumscribed
gentilicio	name of a family
inmaculado	"spotless, immaculate, stainless"
absorbente	"absorbent, absorbing, engrossing"
*** 2951 - 2960 (/course/185945/spanish-adjectives/296/)	
pirotécnico	pyrotechnic
tolerable	"tolerable, endurable, bearable"
tradicionalista	traditionalist
acerbo	"acerbic, bitter, harsh"
indolente	"indolent, easygoing, indifferent"
pedregoso	"stony, rocky"
ralo	"thin, scraggly, sparse"
premeditado	"deliberate, premeditated, willful"
hipnótico	hypnotic
intolerante	"intolerant, illiberal, bigot"
*** 2961 - 2970 (/course/185945/spanish-adjectives/297/)	
preestablecido	"pre-establish, established in advance, established beforehand"
acompasado	"deliberate, slow, rhythmical"
ineficiente	inefficient
compulsivo	compulsive
jamaicano	Jamaican
inicuo	"iniquitous, wicked, nefarious"
epistolar	epistolary
ilógico	illogical
arrollador	"overwhelming, devastating, overpowering"
provisorio	"provisional, provisory"
*** 2971 - 2980 (/course/185945/spanish-adjectives/298/)	
sesgado	"biased, slanted, inclined"
insufrible	"insufferable, impossible, unbearable"
zambo	"knock-kneed, bow-legged, bandy legged"
raído	"shabby, frayed, threadbare"
anejo	"annexed to, attached to, joined"
poligonal	polygonal
afeitado	shaven
tramposo	"cheat, crook, cheating"
falaz	"false, untrue, deceitful"
dolido	"hurt, be sorry"
*** 2981 - 2990 (/course/185945/spanish-adjectives/299/)	
desfasado	"out of phase, out-of-fashion, out-of-style"
salesiano	salesian
vívido	"vivid, worldly"
telepático	telepathic
congruente	"congruent, coherent"
norteafricano	North African
perecedero	perishable
insípido	"tasteless, insipid, unsavory"
impresionista	impressionistic
controlable	controllable
*** 2991 - 3000 (/course/185945/spanish-adjectives/300/)	
pequeñito	"tiny, wee, very small"
puritano	"puritanical, puritan, strait-laced"
coqueto	"flirtatious, vain, conceited"
semítico	Semitic
benefactor	"welfare, beneficent"
cafetero	"coffee lover, coffee"
desvalido	"helpless, defenseless, defenceless"
libertino	"libertine, profligate, rakish"
conjugado	conjugate
telegráfico	telegraphic
*** 3001 - 3010 (/course/185945/spanish-adjectives/301/)	
traicionero	"treacherous, traitorous, disloyal"
ramificado	ramified
intranquilo	"restless, uneasy, worried"
unifamiliar	single-family
mortuorio	mortuary
tedioso	"tedious, boring, wearisome"
transportista	"shipping, haulage"
sabido	"known, understood, intelligent"
enseñado	"taught, learned, trained"
fatigoso	"fatiguing, tiring, labored"
*** 3011 - 3020 (/course/185945/spanish-adjectives/302/)	
quebrantado	disrupted
desarticulado	disjointed
inclusivo	inclusive
craneal	cranial
indigente	"destitute, indigent, needy"
desacreditado	disreputable
empedrado	"paved, overcast, cloudy"
perentorio	"peremptory, imperative, assertive"
desorbitado	"disproportionate, excessive, exorbitant"
estereotipado	"stereotyped, clichéd"
*** 3021 - 3030 (/course/185945/spanish-adjectives/303/)	
hervido	boiled
climatológico	climatological
irrepetible	"once-in-a-lifetime, unrepeatable, one-off"
correctivo	corrective
agotador	"exhausting, strenuous, grueling"
punitivo	punitive
meticuloso	"meticulous, thorough, precise"
fenomenal	"phenomenal, awesome, amazing"
redundante	"redundant, superfluous, extra"
hexagonal	hexagonal
*** 3031 - 3040 (/course/185945/spanish-adjectives/304/)	
precavido	"cautious, thoughtful, prudent"
itálico	italic
resentido	"resentful, sullen, bitter"
calvo	"bald, hairless, without hair"
homérico	Homeric
sudoroso	"sweaty, sweating, perspiring"
degenerado	"degenerate, depraved, corrupt"
hispanohablante	"Spanish speaker, Spanish-speaking"
demente	"insane, demented, mad"
soñoliento	"drowsy, sleepy, somnolent"
*** 3041 - 3050 (/course/185945/spanish-adjectives/305/)	
goloso	"greedy, gourmand, sweet"
antológico	anthological
tétrico	"dismal, baleful, gloomy"
solícito	"solicitous, thoughtful"
violáceo	violet
fibroso	"fibrous, stringy"
innoble	ignoble
conectivo	connective
zurdo	"lefty, left-handed person, left-handed"
provenzal	Provencal
*** 3051 - 3060 (/course/185945/spanish-adjectives/306/)	
imperdonable	"unforgivable, unpardonable, inexcusable"
quejumbroso	"whining, complaining, querulous"
decimocuarto	fourteenth
anacrónico	anachronistic
alcalino	alkaline
contributivo	"contributory, tax"
legible	"readable, legible"
sacramental	sacramental
decimotercero	thirteenth
imputable	"traceable, chargeable, attributable"
*** 3061 - 3070 (/course/185945/spanish-adjectives/307/)	
chistoso	"funny, amusing, entertaining"
anfibio	"amphibian, amphibious"
límpido	limpid
virulento	"virulent, vicious"
agachado	bending over
incapacitado	"disabled, incapable, helpless"
avariento	miserly
narcótico	"narcotic, drug"
desanimado	"discouraged, downhearted, despondent"
discrecional	discretionary
*** 3071 - 3080 (/course/185945/spanish-adjectives/308/)	
interrogativo	"questioning, interrogative"
polifacético	all-round
inciso	"curt, precise"
novato	"rookie, novice, inexperienced"
supersónico	supersonic
diplomado	"certified, trained"
intercalado	inserted
malayo	"Malay, Malayan"
malparado	damaged
cultivable	"cultivable, arable, farmable"
*** 3081 - 3090 (/course/185945/spanish-adjectives/309/)	
estimable	"estimable, appreciable, reputable"
abovedado	"vaulted, domed, arched"
ondulante	"wavy, billowy, vibratory"
viciado	"tainted, stale, contaminated"
moralizador	"moralizing, moralistic, moralist"
equino	equine
plateresco	plateresque
atolondrado	"reckless, scatterbrained, harebrained"
bautismal	baptismal
predispuesto	predisposed
*** 3091 - 3100 (/course/185945/spanish-adjectives/310/)	
centrífugo	centrifugal
leguminoso	leguminous
proverbial	proverbial
hawaiano	Hawaiian
negruzco	blackish
azaroso	"hazardous, risky, timid"
expedito	"free, clear, unobstructed"
adhesivo	adhesive
cursivo	cursive
cuadrúpedo	"quadrupedal, quadruped"
*** 3101 - 3110 (/course/185945/spanish-adjectives/311/)	
pluralista	"pluralistic, diverse"
enajenado	"deranged, demented, insane"
gélido	"icy, gelid"
intercambiable	interchangeable
laureado	"laureate, prizewinner, prize-winning"
abigarrado	"mottled, motley, brindle"
unicelular	unicellular
extensible	"extensible, tensile, extendible"
malsano	"unhealthy, morbid, sickly"
refrigerado	"refrigerated, cooled"
*** 3111 - 3120 (/course/185945/spanish-adjectives/312/)	
siberiano	Siberian
estoico	"stoical, Stoic"
parabólico	"parabolic, parabolical"
irrisorio	"derisory, derisive, risible"
testarudo	"stubborn, pig-headed"
cursado	taken
furibundo	"furious, livid, enraged"
irascible	"irascible, testy, tetchy"
irreflexivo	"unthinking, thoughtless, unreflecting"
paritario	"equally divided, equally represented"
*** 3121 - 3130 (/course/185945/spanish-adjectives/313/)	
terso	"smooth, unwrinkled, polished"
hosco	"sullen, surly, dark"
longevo	"long-lived, long-standing"
evasivo	evasive
polifónico	polyphonic
cuaternario	quaternary
ufano	"conceited, vain, pleased with oneself"
lila	"lilac, dumb, stupid"
signatario	signatory
lóbrego	"gloomy, murky, dark"
*** 3131 - 3140 (/course/185945/spanish-adjectives/314/)	
indómito	"indomitable, unbroken, untamed"
refractario	"refractory, ovenproof, oven-proof"
inductivo	inductive
telonero	support
demostrativo	"demonstrative, indicative"
inyectado	injected
unívoco	"unambiguous, univocal"
colérico	"choleric, angry, irate"
contrarrevolucionario	counterrevolutionary
chalado	"crazy, mad, dotty"
*** 3141 - 3150 (/course/185945/spanish-adjectives/315/)	
sulfúrico	sulfuric
imperecedero	"undying, imperishable, immortal"
consolador	"consoling, comforting"
automotor	"automotive, car, self-propelled"
exorbitante	exorbitant
aparatoso	"ostentatious, spectacular, showy"
vinícola	wine
elitista	"elite, exclusive, elitist"
avezado	experienced
mesiánico	messianic
*** 3151 - 3160 (/course/185945/spanish-adjectives/316/)	
crepuscular	"crepuscular, twilight, of dusk"
escabroso	"rough, rugged, scabrous"
clamoroso	"clamorous, roaring, howling"
acotado	"enclosed, fenced in"
fortísimo	fortissimo
varado	"stranded, aground, man without a regular job"
desaforado	"huge, enormous, boundless"
seglar	"lay, secular, layman/laywoman"
recargado	"leaning on, leaning against, dripping"
fangoso	"muddy, dangerous, murky"
*** 3161 - 3170 (/course/185945/spanish-adjectives/317/)	
avícola	poultry
electivo	elective
ejecutable	"executable, enforceable, feasible"
decoroso	"decorous, dignified, seemly"
mareado	"dizzy, giddy, queasy"
interestatal	interstate
ostentoso	"ostentatious, swanky, flashy"
tempestuoso	"tempestuous, stormy, blustery"
trillado	"trite, hackneyed, threadbare"
censor	censorial
*** 3171 - 3180 (/course/185945/spanish-adjectives/318/)	
cognoscitivo	cognitive
lascivo	"lascivious, lecherous, lewd"
modulado	modulated
ominoso	"ominous, awful, dreadful"
empañado	"tarnished, blurred, steamy"
mallorquín	Majorcan
fehaciente	"reliable, irrefutable"
pasmado	"stunned, aghast, thunderstruck"
eufórico	"exuberant, euphoric, ecstatic"
desalmado	heartless
*** 3181 - 3190 (/course/185945/spanish-adjectives/319/)	
embriagado	"intoxicated, drunk"
henchido	puffed
enésimo	"umpteenth, zillionth, bazillionth"
amplificador	amplifying
condicionante	conditioning
mórbido	"morbid, diseased"
sangrante	bleeding
irreverente	"irreverent, disrespectful"
negociable	"negotiable, marketable"
inapreciable	"priceless, precious, inappreciable"
*** 3191 - 3200 (/course/185945/spanish-adjectives/320/)	
castizo	"pure, pure-blood, born-and-bred"
arqueado	arcuate
fracasado	"failed, unsuccessful, failure"
inhóspito	inhospitable
justiciero	law-abiding
fruncido	"frunce, gathered, pleated"
ultramarino	ultramarine
paradigmático	paradigmatic
iracundo	"wrathful, ireful, wroth"
taquillero	"box-office draw, box-office earner"
*** 3201 - 3210 (/course/185945/spanish-adjectives/321/)	
curricular	"educational, curricular"
sincrónico	"synchronous, concurrent, simultaneous"
pertinaz	"pertinacious, obstinate, persistent"
avisado	"switched on, tuned in, sensible"
dimensional	dimensional
esclavizado	enslaved
sefardí	Sephardic
filológico	"philological, philologic"
caucásico	Caucasian
aciago	"fateful, unlucky, ill-omened"
*** 3211 - 3220 (/course/185945/spanish-adjectives/322/)	
adicto	addicted
autógrafo	autographic
movible	"movable, moveable, mobile"
exploratorio	"exploratory, explorative"
pasmoso	"staggering, astounding, stunning"
punible	punishable
azorado	"upset, amazed, stunned"
radiológico	radiologic
aberrante	"aberrant, abnormal, strange"
enfático	"emphatic, pointed, forceful"
*** 3221 - 3230 (/course/185945/spanish-adjectives/323/)	
iónico	ionic
palatino	palatine
neural	neural
bipolar	bipolar
juliano	Julian
soportable	"bearable, endurable, livable"
ventoso	"windy, breezy, burglar"
opa	"dumb, stupid"
postizo	"false, artificial, dummy"
geodésico	geodesic
*** 3231 - 3240 (/course/185945/spanish-adjectives/324/)	
granítico	granitic
pétreo	"stony, petrous, rocky"
perito	"experienced, qualified, proficient"
minimalista	minimalist
frigio	Phrygian
espiral	"spiral, coiled"
vetusto	ancient
explicable	"explicable, explainable, accountable"
laxo	"lax, relaxed, loose"
destartalado	"ramshackle, tacky, shabby"
*** 3241 - 3250 (/course/185945/spanish-adjectives/325/)	
genealógico	genealogical
embustero	liar
allegado	related
adúltero	adulterous
contrabandista	"contraband, smuggled, bootleg"
adusto	"grim, forbidding, gaunt"
abyecto	"abject, wretched"
correlativo	"correlative, consecutive, corresponding"
púnico	Punic
sustancioso	"meaty, solid, juicy"
*** 3251 - 3260 (/course/185945/spanish-adjectives/326/)	
pulcro	"neat, trim, tidy"
sarraceno	Saracen
infecto	"infected, tainted, foul"
justificable	justifiable
ensimismado	"lost in thought, daydreaming, engrossed"
intempestivo	"ungodly, unearthly, unseasonable"
desparramado	"adj, spread, scattered"
intachable	"impeccable, irreproachable, faultless"
lumbar	lumbar
rampante	rampant
*** 3261 - 3270 (/course/185945/spanish-adjectives/327/)	
amargado	"embittered, bitter, become bitter"
puto	"bleedin', bloody, damned"
condensador	condensing
indeleble	indelible
ostensible	"obvious, evident"
retraído	"shy, withdrawn"
gastrointestinal	gastrointestinal
jubilado	"retired, pensioner"
miedoso	"fearful, funky, nervous"
esponjoso	"spongy, foamy, porous"
*** 3271 - 3280 (/course/185945/spanish-adjectives/328/)	
empedernido	"inveterate, confirmed, habitual"
astrológico	"astrological, astrologic"
mamario	mammary
litigioso	litigious
realizable	"realizable, achievable, feasible"
coetáneo	"coeval, contemporary, coetaneous"
enciclopédico	"encyclopedic, encyclopaedic"
colado	smitten
agustino	Augustinian
bípedo	"biped, bipedal"
*** 3281 - 3290 (/course/185945/spanish-adjectives/329/)	
mesurado	"measured, moderate, adj"
adiestrado	trained
intravenoso	intravenous
rectilíneo	"rectilinear, rectilineal"
analgésico	"analgesic, soothing"
convulsivo	convulsive
hidalgo	gentlemanly
germinal	germinal
oblongo	oblong
primoroso	"exquisite, elaborate, neat"
*** 3291 - 3300 (/course/185945/spanish-adjectives/330/)	
halagüeño	"flattering, attractive, pleasing"
poroso	porous
condescendiente	"agreeable, amenable, condescending"
somático	somatic
polinesio	Polynesian
cavado	tend
ranchero	"country, farm, farmhouse"
cirílico	Cyrillic
condenatorio	condemnatory
conspicuo	"conspicuous, eminent, notable"
*** 3301 - 3310 (/course/185945/spanish-adjectives/331/)	
expositivo	"expository, expositive"
heterodoxo	"heterodox, unorthodox"
incumplido	"breached, unreliable"
auricular	"auricular, of the ear"
colector	collecting
ladino	"cunning, crafty"
oleaginoso	oily
antitanque	antitank
moscovita	Muscovite
jacobino	Jacobean
*** 3311 - 3320 (/course/185945/spanish-adjectives/332/)	
maléfico	"malevolent, malignant, maleficent"
canceroso	cancerous
laminado	"laminate, laminated, laminar"
añejo	"old, vintage, mature"
virreinal	viceregal
indeseado	"unwanted, adj"
anhelante	"eager, longing, yearning"
intransitable	impassable
epiléptico	epileptic
megalítico	megalithic
*** 3321 - 3330 (/course/185945/spanish-adjectives/333/)	
irreconocible	"unrecognizable, unrecognisable"
alejandrino	Alexandrine
estanco	"watertight, bodega, corner store"
intercontinental	intercontinental
vocálico	vocalic
adaptable	adaptable
alucinógeno	hallucinogenic
fluorescente	"fluorescent, fluorescent tube"
antropomórfico	anthropomorphic
escamoso	"flaky, scaly, scaled"
*** 3331 - 3340 (/course/185945/spanish-adjectives/334/)	
perceptivo	"perceptive, perceptual"
magro	"lean, loin"
freudiano	Freudian
meloso	"mellow, honeyed, sweet"
neurálgico	"neuralgic, most important, crucial"
vuelto	change
kantiano	Kantian
misceláneo	miscellaneous
diminutivo	diminutive
aborrecido	"abhorred, hateful"
*** 3341 - 3350 (/course/185945/spanish-adjectives/335/)	
distributivo	distributive
íbero	Iberian
antropomorfo	anthropomorphous
desventurado	"hapless, unfortunate, unlucky"
monoteísta	monotheistic
pitagórico	Pythagorean
aventurado	"risky, adventurous"
somero	"surface, shallow, summary"
dórico	Doric
nebuloso	"nebulous, misty, foggy"
*** 3351 - 3360 (/course/185945/spanish-adjectives/336/)	
solapado	"underhanded, false, secretive"
acelerador	accelerating
intrascendente	"adj, trivial"
canoso	hoary
estruendoso	"loud, thunderous, uproarious"
lectivo	school
abnegado	"selfless, self-sacrificing"
desorganizado	disorganized
axilar	axillary
salobre	"brackish, salty"
*** 3361 - 3370 (/course/185945/spanish-adjectives/337/)	
concordante	"concordant, in agreement"
crédulo	"credulous, gullible"
deductivo	deductive
refrigerante	"cooling, refrigerant"
insidioso	insidious
inconexo	"unrelated, disjointed, disconnected"
ignoto	unknown
arsénico	"arsenic, arsenical"
gacho	"bowed, down, bent down"
rococó	rococo
*** 3371 - 3380 (/course/185945/spanish-adjectives/338/)	
gutural	"throaty, guttural"
despachado	dispatched
quimérico	"chimerical, impossible, unattainable"
estriado	"fluted, grooved, fluting"
abstraído	"abstracted, preoccupied, absorbed"
encapuchado	"hooded, masked"
bronceado	"tanned, bronzed, bronze"
inexplorado	"unexplored, uncharted"
dietético	"dietetic, dietary, dietitian"
alienado	"deranged, insane"
*** 3381 - 3390 (/course/185945/spanish-adjectives/339/)	
menstrual	menstrual
habilidoso	skilled
apilado	stacking
diluido	"dilute, diluted"
equidistante	equidistant
lisonjero	"flattering, complimentary, flatterer"
boquiabierto	open-mouthed
lubricante	"lubricating, lubricant"
grasiento	"oily, greasy, fat"
presuntuoso	"pretentious, presumptuous, conceited"
*** 3391 - 3400 (/course/185945/spanish-adjectives/340/)	
prismático	prismatic
profuso	"profuse, lavish"
reparador	"restorative, reinvigorating, refreshing"
ballenero	whaling
folklórico	"folkloric, folk"
desabrido	"tasteless, brusque, harsh"
petroquímico	petrochemical
retardado	"retarded, delayed, mentally disabled"
anguloso	"angular, sharp"
destemplado	"distempered, shivery"
*** 3401 - 3410 (/course/185945/spanish-adjectives/341/)	
pletórico	"plethoric, expression, full of"
bochornoso	"sultry, sticky, stuffy"
tónico	tonic
botado	"generous, comfortable, wealthy"
impracticable	"impracticable, unworkable, impassable"
indisoluble	"indissoluble, insoluble, binding"
lapidario	"lapidary, solemn"
mejicano	Mexican
ensamblador	assembly
inexpresivo	"expressionless, inexpressive"
*** 3411 - 3420 (/course/185945/spanish-adjectives/342/)	
fútil	"futile, trifling, inane"
semifinalista	semifinal
polivalente	"polyvalent, versatile, multi-use"
quinquenal	quinquennial
palmado	"of the palm, palmar"
rallado	grated
monolítico	monolithic
mulato	mulatto
nauseabundo	"nauseous, nauseating, sickening"
malhadado	unhappy
*** 3421 - 3430 (/course/185945/spanish-adjectives/343/)	
encumbrado	"lofty, high, soaring"
programable	programmable
huesudo	"bony, all bone, skeletal"
gravoso	"burdensome, oppressive"
arisco	"surly, vicious, sharp"
protocolario	formal
insustituible	irreplaceable
obtuso	"obtuse, blunt, dull"
venoso	"venous, veined"
agónico	"death, dying, to the death"
*** 3431 - 3440 (/course/185945/spanish-adjectives/344/)	
divisible	"divisible, partible, dividable"
renegado	"renegade, disowned"
babilónico	Babylonian
doctrinario	doctrinaire
senil	senile
rasgado	"almond-shaped, slanted, slanting"
hogareño	"domestic, home-loving, stay-at-home"
ducho	dexterous
calificativo	"qualifying, descriptive"
parco	"frugal, sparing, scarce"
*** 3441 - 3450 (/course/185945/spanish-adjectives/345/)	
descansado	"easy, restful, relaxed"
déspota	"despotic, tyrannical, brutal"
insano	"insane, unhealthy, morbid"
aventajado	"outstanding, excellent"
variopinto	"a variety of, a diversity of, colourful"
araucano	"Araucanian, Araucan"
rioplatense	"from Río de la Plata, of Río de la Plata"
sádico	sadistic
jubiloso	"jubilant, joyous, joyful"
excusado	"superfluous, unnecessary"
*** 3451 - 3460 (/course/185945/spanish-adjectives/346/)	
infinitesimal	infinitesimal
vaporoso	"steamy, vaporous, vapoury"
rencoroso	"rancorous, resentful"
lacio	"limp, droopy, straight"
interdependiente	interdependent
noticioso	newsworthy
numerario	numerical
mellizo	twin
quebradizo	"brittle, fragile, breakable"
caníbal	cannibal
*** 3461 - 3470 (/course/185945/spanish-adjectives/347/)	
seráfico	"seraphic, seraphical"
voluntarioso	"willful, wayward, headstrong"
adherente	"adherent, sticky, adhesive"
brumoso	"misty, foggy, hazy"
atribulado	"distressed, afflicted, heartbroken"
episódico	episodic
atenuante	extenuating
fantasioso	"fantasy, imaginative"
disconforme	"in disagreement, dissatisfied, unhappy"
tendencioso	"tendentious, biased, partial"
*** 3471 - 3480 (/course/185945/spanish-adjectives/348/)	
practicable	practicable
transexual	transsexual
carmelita	Carmelite
dieléctrico	dielectric
lacónico	"laconic, terse"
gringo	"Yankee, yank, gringo"
cetáceo	cetacean
entrometido	"obtrusive, meddling, meddlesome"
notarial	notarial
optativo	"optional, elective, optative"
*** 3481 - 3490 (/course/185945/spanish-adjectives/349/)	
rechoncho	"chubby, plump, thickset"
ducal	ducal
talar	"full-length, floor-length, maxi"
pectoral	"pectoral, chest"
permisivo	"permissive, indulgent"
decimoséptimo	seventeenth
recatado	"demure, coy, prim"
alcanzable	"attainable, reachable"
paralítico	"paralytic, palsied, disabled"
arrebatador	"passionate, dazzling, blinding"
*** 3491 - 3500 (/course/185945/spanish-adjectives/350/)	
tejano	"Texan, denim"
contextual	contextual
trópico	tropical
demagógico	demagogic
derretido	"melted, molten"
declarativo	declarative
estremecedor	"hair-raising, heart-rending"
impávido	"dauntless, undaunted, unperturbed"
fraterno	fraternal
antioxidante	antirust
*** 3501 - 3510 (/course/185945/spanish-adjectives/351/)	
escurridizo	"slippery, slip, evasive"
temporario	temporary
bucólico	"bucolic, pastoral"
mejorable	improvable
injurioso	"insulting, offensive, injurious"
raquítico	"rickety, rachitic, stunted"
compositivo	composite
mortecino	"dying, dim, weak"
permeable	"pervious, permeable"
acumulativo	"cumulative, accumulative, compound"
*** 3511 - 3520 (/course/185945/spanish-adjectives/352/)	
apiñado	"crowded, congested"
maoísta	Maoist
pecaminoso	"sinful, guilty"
irrealizable	unrealizable
voluble	"fickle, unstable, unpredictable"
trasatlántico	transatlantic
jurado	"authorized, certified, sworn"
ambivalente	"ambivalent, ambiguous, two-way"
dañoso	"harmful, mischievous, injurious"
paisajista	landscape
*** 3521 - 3530 (/course/185945/spanish-adjectives/353/)	
infausto	"unhappy, unlucky, fateful"
mustio	"withered, limp, gloomy"
introvertido	"introvert, introverted"
oligárquico	oligarchic
alucinante	"amazing, awesome, hallucinatory"
pascual	paschal
plomizo	"leaden, plumbeous, sullen"
desbocado	"runaway, out of control, worn"
prudencial	prudential
anárquico	"anarchic, anarchical"
*** 3531 - 3540 (/course/185945/spanish-adjectives/354/)	
electrostático	electrostatic
hierático	"hieratic, inscrutable, inexpressive"
hacendado	landed
nimio	"trivial, insignificant, petty"
mamífero	mammal
azucarado	"sugary, sweet, sugared"
agridulce	"bittersweet, sweet and sour"
nazareno	Nazarene
apabullante	overwhelming
soez	rude
*** 3541 - 3550 (/course/185945/spanish-adjectives/355/)	
virginal	"virginal, maiden, maidenly"
cartográfico	cartographic
fétido	"fetid, foul, stinking"
incorruptible	incorruptible
abrasador	"scorching, burning, blistering"
medroso	"fearful, cowardly, scary"
sacrosanto	sacrosanct
divulgativo	"information, of information, education"
templario	templar
fecal	"foul, polluted, fecal"
*** 3551 - 3560 (/course/185945/spanish-adjectives/356/)	
sardónico	sardonic
hirviente	"seething, boiling, scalding"
desagradecido	"ungrateful, unthankful, ungrateful person"
engorroso	"annoying, bothersome, trying"
plenipotenciario	plenipotentiary
apetitoso	"appetizing, tempting, inviting"
modelo	"exemplary, model"
nítrico	nitric
numeral	"numeral, numeric, numerical"
desenfadado	"casual, relaxed"
*** 3561 - 3570 (/course/185945/spanish-adjectives/357/)	
etnográfico	ethnographic
brioso	"proud, lively"
direccional	directional
semiautomático	semiautomatic
desechable	"disposable, throwaway, throw-away"
mugriento	"grubby, grimy, dirty"
indescifrable	"indecipherable, crabbed, illegible"
evocador	"evocative, dreamy"
ceñudo	"grim, frowning, scowling"
cálcico	calcic
*** 3571 - 3580 (/course/185945/spanish-adjectives/358/)	
concomitante	"concomitant, attendant, concurrent"
inveterado	"inveterate, confirmed, habitual"
leonado	"tawny, fulvous"
lesivo	"harmful, damaging, detrimental"
recalcitrante	"recalcitrant, obstinate"
estrafalario	"bizarre, wild, odd"
inconstante	"fickle, inconstant, unsteady"
senatorial	senatorial
descarriado	"astray, wayward, good for nothing"
moroso	"defaulter, defaulting, bad"
*** 3581 - 3590 (/course/185945/spanish-adjectives/359/)	
demostrable	"demonstrable, provable"
durable	durable
pretérito	"preterite, preterit, past"
renuente	reluctant
conmocionado	shocked
pequeñísimo	smallest
prieto	"tight-fitting, tight, dark"
sempiterno	"everlasting, sempiternal"
habanero	habanero pepper
sarnoso	"mangy, scabious, itchy"
*** 3591 - 3600 (/course/185945/spanish-adjectives/360/)	
estomacal	stomach
santísimo	"saintly, blessed"
acerado	steely
idólatra	"idolatrous, heathen"
incomprendido	misunderstood
posesivo	possessive
huraño	"shy, aloof, retiring"
diferido	"deferred, recorded, pre-recorded"
desestabilizador	destabilizing
octogenario	octogenarian
*** 3601 - 3610 (/course/185945/spanish-adjectives/361/)	
hostelero	"catering, hotel"
palomar	pigeon loft
meditabundo	"thoughtful, pensive, meditative"
retumbante	reverberating
zodiacal	zodiacal
estentóreo	stentorian
meteórico	meteoric
atronador	"deafening, thunderous, thundering"
agasajado	entertaining
candoroso	"innocent, naive"
*** 3611 - 3620 (/course/185945/spanish-adjectives/362/)	
fantasmagórico	phantasmagorical
regocijado	"exhilarated, merry, gleeful"
moteado	"mottled, speckled, spotted"
desalentador	"discouraging, disheartening"
ignominioso	"ignominious, disgraceful, inglorious"
fallado	past participle of fallar
preeminente	"prominent, preeminent"
atontado	"stunned, dopey, besotted"
amputado	amputated
dedicatorio	dedicatory
*** 3621 - 3630 (/course/185945/spanish-adjectives/363/)	
interplanetario	interplanetary
raudo	"swift, quick"
desvencijado	"ramshackle, rickety, rattletrap"
denodado	"dauntless, intrepid, brave"
coleccionable	collectable
jodido	"fucking, in a bad way, hard"
monacal	"monkish, monastic"
sensorio	sensory
conjuntivo	conjunctive
incorpóreo	"disembodied, incorporeal, bodiless"
*** 3631 - 3640 (/course/185945/spanish-adjectives/364/)	
aterciopelado	"velvety, velvet-like, velvet"
hirsuto	"hirsute, coarse, wiry"
láctico	"lactic, dairy"
parasitario	"parasitical, parasitic"
vergonzante	"embarrassing, shame-faced, bashful"
leproso	"leper, leprous"
demacrado	"gaunt, emaciated, haggard"
diabético	diabetic
hiperbólico	"hyperbolic, hyperbolical"
torneado	toned
*** 3641 - 3650 (/course/185945/spanish-adjectives/365/)	
culpado	guilty
parietal	parietal
paternalista	paternalistic
arrojadizo	projectile
despistado	"scatterbrain, lost in thought, distracted"
atinado	"wise, spot on, pertinent"
comprometedor	"compromising, damning, obligating"
averiguado	"learned, inquired"
multidimensional	multidimensional
centelleante	"scintillating, sparkling, twinkling"
*** 3651 - 3660 (/course/185945/spanish-adjectives/366/)	
extraterritorial	extraterritorial
helicoidal	helical
sobrecogedor	"horrible, startling, shocking"
mole	"lump, be great, be cool"
titánico	titanic
atezado	swarthy
chárter	"charter, chartered"
pinto	"dappled, piebald, skewbald"
fricativo	fricative
aspirado	aspirate
*** 3661 - 3670 (/course/185945/spanish-adjectives/367/)	
licencioso	licentious
embelesado	"spellbound, enraptured, entranced"
adictivo	addictive
adiposo	adipose
aerotransportado	airborne
enriquecedor	"enriching, rewarding"
cavernoso	"cavernous, hollow"
carmín	carmine
tullido	"crippled, lame"
nucleico	nucleic
*** 3671 - 3680 (/course/185945/spanish-adjectives/368/)	
bribón	"rascally, naughty, mischievous"
inapelable	"unappealable, inevitable, unavoidable"
montenegrino	Montenegrin
ambulatorio	"ambulatory, outpatient"
irritable	"irritable, techy, fretful"
censurable	"objectionable, censurable, reprehensible"
sardo	Sardinian
salvo	safe and sound
espurio	spurious
tórrido	torrid
*** 3681 - 3690 (/course/185945/spanish-adjectives/369/)	
ensenado	"taught, trained, learned"
adulador	"fawning, adulatory"
movedizo	"moving, shifting, shaky"
conspirador	conspiratorial
dúctil	"ductile, soft, adaptable"
gelatinoso	"gelatinous, jellied, full of jelly"
nihilista	nihilistic
mordido	bitten
volado	"flown, affair, lie"
sigiloso	"secretive, sneaky, sneaking"
*** 3691 - 3700 (/course/185945/spanish-adjectives/370/)	
coactivo	coercive
críptico	cryptic
algodonero	cotton
endiablado	"filthy, terrible, awful"
torvo	"grim, baleful, fierce"
inodoro	"odorless, odourless"
divisor	dividing
vidrioso	"glassy, glazed"
mismísimo	"self-same, very same, self same"
promiscuo	"promiscuous, mixed"
*** 3701 - 3710 (/course/185945/spanish-adjectives/371/)	
afeminado	"effeminate, unmanly, womanish"
bravío	"untamed, wild, uncouth"
metodista	Methodist
otoñal	autumnal
convicto	convicted
decimonoveno	nineteenth
repelente	"repellent, repulsive, cheeky"
telescópico	telescopic
irresoluto	"unresolved, irresolute, indecisive"
llevadero	"bearable, livable, liveable"
*** 3711 - 3720 (/course/185945/spanish-adjectives/372/)	
pediátrico	"pediatric, paediatric"
apático	"apathetic, listless, torpid"
evitable	"avoidable, preventable"
amodorrado	drowsy
egocéntrico	"egocentric, self-centred"
incestuoso	incestuous
judaico	Judaic
indistinto	"indistinct, indiscriminate"
incomodado	troubled
pegadizo	"catchy, sticky, infectious"
*** 3721 - 3730 (/course/185945/spanish-adjectives/373/)	
despreciativo	"contemptuous, scornful, snide"
dable	"possible, feasible"
cuadrático	quadratic
transitivo	transitive
axiomático	axiomatic
calórico	caloric
imborrable	"indelible, permanent, unforgettable"
semiótico	semiotic
sanguinolento	"bloody, sanguinolent, bloodshot"
combinatorio	combining
*** 3731 - 3740 (/course/185945/spanish-adjectives/374/)	
decrépito	"decrepit, ancient, very old"
alucinado	"deluded, hoodwinked"
yerto	"rigid, stiff"
lego	"lay, ignorant"
milésimo	"thousandth, millesimal"
paradisíaco	"heavenly, paradisiacal, paradisal"
patentado	"proprietary, patent"
coaxial	coaxial
colmo	"full to the brim, overflowing"
elogioso	"appreciative, eulogistic"
*** 3741 - 3750 (/course/185945/spanish-adjectives/375/)	
reincidente	"recidivist, relapsing, reoffending"
dubitativo	"dubious, undecided"
acrobático	acrobatic
aglutinante	agglutinative
irrespetuoso	"disrespectful, irreverent"
ibero	Iberian
marsupial	marsupial
hiriente	"wounding, hurtful, offensive"
bromista	"full of jokes, full of fun, fond of a laugh"
criptográfico	cryptographic
*** 3751 - 3760 (/course/185945/spanish-adjectives/376/)	
encinta	"pregnant, enceinte"
bermejo	"russet, ginger, bright red"
socarrón	sarcastic
lindero	adjoining
hípico	"equine, hippic"
prohibitivo	prohibitive
teocrático	theocratic
depravado	"vicious, depraved, degenerate"
menguado	"timid, shy, stupid"
deshonroso	"dishonorable, disgraceful, disreputable"
*** 3761 - 3770 (/course/185945/spanish-adjectives/377/)	
grandilocuente	"grandiloquent, magniloquent, expressive"
silábico	syllabic
aseado	"clean, cleanly"
introspectivo	introspective
desfallecido	faint
membranoso	"membranous, membraneous"
montañero	"mountain, mountaineering"
presumible	"presumable, likely, probable"
apologético	"apologetic, apologetical"
quincuagésimo	fiftieth
*** 3771 - 3780 (/course/185945/spanish-adjectives/378/)	
lujurioso	"lecherous, lustful, lewd"
borrascoso	"stormy, blustery, gusty"
impresentable	"unpresentable, socially inept, unreliable"
anodino	"anodyne, harmless, dull"
bengalí	Bengali
vírico	viral
valedero	valid
orientativo	"ball-park, guide, illustrative"
laberíntico	"rambling, labyrinthine"
loro	talkative
*** 3781 - 3790 (/course/185945/spanish-adjectives/379/)	
acrílico	acrylic
coreográfico	choreographic
quejoso	"complaining, moaning,"
mauritano	Mauritanian
yegua	stupid
feriado	"celebrated, observed"
inválido	"invalid, void"
magiar	Magyar
impúdico	unchaste
enfriado	"chilled, cooled, chilly"
*** 3791 - 3800 (/course/185945/spanish-adjectives/380/)	
harapiento	"ragged, shabby"
glabro	"hairless, glabrous"
velludo	"hairy, shaggy, plush"
helvético	Helvetic
unipersonal	"single-owner, single-member, individual"
cáustico	"caustic, scathing, acrimonious"
iterativo	"iterative, repeated, repetitive"
distendido	relaxed
antidepresivo	antidepressant
baqueano	expert
*** 3801 - 3810 (/course/185945/spanish-adjectives/381/)	
almenado	"castellated, crenellated"
enrevesado	"confusing, inaccessible"
cobrizo	"copper, cupric, coppery"
ordinal	ordinal
benemérito	worthy
malasio	Malaysian
adepto	adept
trepidante	"frenetic, shuddering"
umbrío	"gloomy, shady, dark"
esposado	handcuffed
*** 3811 - 3820 (/course/185945/spanish-adjectives/382/)	
disipado	dissipated
nitrogenado	nitrogenous
desperdigado	scattered
impagable	"invaluable, priceless"
lechoso	"milky, pale, creamy"
escuálido	"scraggy, skinny, scrawny"
sexista	sexist
decaído	"downcast, miserable, depressed"
antiinflamatorio	anti-inflammatory
omnívoro	omnivorous
*** 3821 - 3830 (/course/185945/spanish-adjectives/383/)	
blancuzco	"whitish, off-white"
engreído	"conceited, uppity, bumptious"
moldavo	Moldavian
vítreo	vitreous
cabalístico	"cabalistic, cabbalistic"
cuadragésimo	fortieth
cárdeno	"lurid, purple"
rollizo	"plump, over-weight"
empanado	"be sluggish, groggy, be logy"
fosforescente	"phosphorescent, phosporescent, fluorescent"
*** 3831 - 3840 (/course/185945/spanish-adjectives/384/)	
paradisiaco	"heavenly, paradisiacal, paradisaical"
asexual	asexual
maleable	"malleable, docile"
translúcido	translucent
clasista	"class, class conscious, classist"
tordo	"dapple-grey [UK], dapple-gray [US], dappled"
rebuscado	"elaborate, precious, recherche"
nominativo	"nominative, made out to a specific person"
calorífico	calorific
albino	albino
*** 3841 - 3850 (/course/185945/spanish-adjectives/385/)	
disoluto	"dissolute, profligate, raffish"
inoperante	"ineffective, inoperative, inactive"
hendido	"cleft, split, riven"
drogado	"high, stoned, drugged"
cornudo	"horned, cuckolded, wronged"
trasnochado	"passé, outmoded, outdated"
pendenciero	"tough, quarrelsome, rambunctious"
revoltoso	"unruly, rebellious, boisterous"
recreado	reenact
famélico	"famished, ravenous, starved"
*** 3851 - 3860 (/course/185945/spanish-adjectives/386/)	
bullanguero	"fun-loving, lively, rowdy"
deslumbrador	glaring
arriano	Arian
erosivo	erosive
horripilante	"horrifying, creepy, grisly"
insolidario	unsupportive
exultante	"elated, overjoyed, jubilant"
ceremonioso	"formal, ceremonious"
gimnástico	gymnastic
melodramático	melodramatic
*** 3861 - 3870 (/course/185945/spanish-adjectives/387/)	
arabesco	arabesque
indecoroso	"improper, indecorous, indelicate"
indistinguible	indistinguishable
pestilente	"pestilential, foul, smelly"
antinatural	unnatural
muchachito	"teenager, young girl, girl"
bacteriológico	bacteriological
depredador	predatory
preservativo	preservative
fraccionado	fractional
*** 3871 - 3880 (/course/185945/spanish-adjectives/388/)	
galopante	"galloping, rampant, rapidly advancing"
inaudible	inaudible
inventivo	"inventive, resourceful"
domado	tame
bicolor	"bicolor, bicolour, two-tone"
maníaco	"maniac, maniacal"
flamígero	perpendicular
consonántico	consonantal
inconmovible	immovable
insurrecto	insurgent
*** 3881 - 3890 (/course/185945/spanish-adjectives/389/)	
retráctil	retractable
macilento	"gaunt, adj"
cinemático	"kinematic, cinematic"
potásico	potassic
dilatorio	dilatory
regalón	"fond of giving presents, generous"
hiperactivo	"hyperactive, hyper"
endemoniado	"possessed, evil, wicked"
cesante	"unemployed, out of work"
calamitoso	"calamitous, dire"
*** 3891 - 3900 (/course/185945/spanish-adjectives/390/)	
efusivo	"effusive, gushing, warm"
imbricado	"overlapping, partially covered, imbricated"
dirigible	dirigible
portable	portable
sideral	sidereal
hortelano	garden
mahometano	"Mohammedan, Mahometan"
mucoso	mucous
dulzón	"sweet, sugary, honeyed"
impertérrito	"unmoved, impassive, undaunted"
*** 3901 - 3910 (/course/185945/spanish-adjectives/391/)	
arcano	"arcane, hidden"
desatinado	"foolish, crazy"
terroso	"earthy, muddy"
pingüe	"fat, rich, pinguid"
mohoso	"musty, moldy, mildewed"
subcutáneo	subcutaneous
ubicuo	"ubiquitous, omnipresent"
acético	acetic
expeditivo	expeditious
inaplicable	inapplicable
*** 3911 - 3920 (/course/185945/spanish-adjectives/392/)	
fotoeléctrico	"photoelectric, photoelectrical"
charro	"rodeo, Salamancan, gaudy"
fanfarrón	"boaster, braggart, loud-mouthed"
penitencial	penitential
amoniaco	ammoniac
bienal	"biennial, two-year, two yearly"
yermo	"deserted, uninhabited, waste"
malintencionado	malicious
curvilíneo	curved
fiduciario	"trust, fiduciary"
*** 3921 - 3930 (/course/185945/spanish-adjectives/393/)	
eximio	"distinguished, eminent"
mímico	mimic
diurético	diuretic
hilarante	hilarious
expendedor	vending
cerdoso	"bristly, stubbly, setaceous"
distinguible	distinguishable
majadero	"stupid, dumb"
limonado	lemon
avasallador	overwhelming
*** 3931 - 3940 (/course/185945/spanish-adjectives/394/)	
sociopolítico	sociopolitical
comedero	edible
epidémico	epidemic
inepto	"inept, unsuitable, useless"
pluricelular	pluricellular
psicópata	psychopathic
indiviso	undivided
cadavérico	"cadaverous, cadaveric, ghastly"
copulativo	copulative
calibrado	calibrated
*** 3941 - 3950 (/course/185945/spanish-adjectives/395/)	
desventajoso	"disadvantageous, disadvantaged"
interdisciplinario	"interdisciplinary, cross-discipline"
radiado	radiate
embotellado	"bottled, jammed, backed up"
extático	"ecstatic, rapturous, enraptured"
prístino	"pristine, primeval"
blasfemo	"blasphemous, profane"
taimado	"devious, sly, astute"
extrínseco	extrinsic
chiquitito	"tiny, teeny, weeny"
*** 3951 - 3960 (/course/185945/spanish-adjectives/396/)	
sinóptico	"synoptic, synoptical"
trunco	"incomplete, shattered, truncated"
inquisitivo	inquisitive
marital	marital
promisorio	promissory
remiso	remiss
truhán	"shameless, naughty"
presbiteriano	Presbyterian
autocrático	autocratic
costanero	coastal
*** 3961 - 3970 (/course/185945/spanish-adjectives/397/)	
huidizo	"elusive, evasive, shy"
genitivo	genitive
amoratado	"purplish, bruised"
sedicioso	seditious
remitente	sender
alborozado	merry
antillano	Antillean
meditativo	meditative
refulgente	"refulgent, effulgent, resplendent"
esquizofrénico	schizophrenic
*** 3971 - 3980 (/course/185945/spanish-adjectives/398/)	
sésil	sessile
infrahumano	subhuman
calmo	"calm, uncultivated land, undeveloped land"
amatorio	"amatory, amative"
bivalvo	bivalve
alpinista	mountaineering
aguado	"watery, washy, thin"
aguileño	aquiline
achacoso	"ailing, wrecked, knackered"
pregonero	town crier
*** 3981 - 3990 (/course/185945/spanish-adjectives/399/)	
tuberculoso	"tuberculous, tubercular, consumptive"
misógino	"misogynist, misogynistic"
multiforme	multiform
reiterativo	reiterative
masoquista	"masochistic, masochist, submissive"
mocho	"pollarded, cut off, blunted"
rúnico	runic
chupado	"skin-and-bone, skinny, dead easy"
superlativo	"superlative, supreme"
trigonométrico	"trigonometric, trig"
*** 3991 - 4000 (/course/185945/spanish-adjectives/400/)	
córneo	"horny, corneous"
irrecuperable	"irrecoverable, irretrievable, incurable"
incruento	bloodless
carbónico	carbonic
operatorio	operative
pedestre	"pedestrian, walking, on foot"
prenatal	"prenatal, antenatal"
desarrapado	shabby
siamés	Siamese
díscolo	"unruly, fractious, rebellious"
*** 4001 - 4010 (/course/185945/spanish-adjectives/401/)	
votivo	votive
aborrecible	"abhorrent, loathsome, hateful"
craso	"gross, crass, grievous"
heliocéntrico	heliocentric
carnicero	"meat-eating, carnivorous"
contrahecho	"misshapen, counterfeit, faked"
plañidero	plangent
sesudo	"sensible, brainy"
suntuario	sumptuary
zulú	Zulu
*** 4011 - 4020 (/course/185945/spanish-adjectives/402/)	
artero	tricky
reticular	"reticulate, reticulated"
venéreo	venereal
irreducible	irreducible
deleitoso	delightful
bianual	"biannual, twice-yearly"
creído	"conceited, vain, stuck-up"
serpentino	"serpentine, anguine, snaky"
pueblerino	"village, provincial, rustic"
apolítico	"apolitical, nonpolitical"
*** 4021 - 4030 (/course/185945/spanish-adjectives/403/)	
cachondo	"horny, randy, hot"
ladeado	"lopsided, askew, inclined"
ternario	ternary
saltarín	"lively, restless"
mañoso	"thief, handy, skillful"
ondulatorio	undulatory
funicular	funicular
principesco	princely
quijotesco	quixotic
tozudo	"stubborn, obstinate"
*** 4031 - 4040 (/course/185945/spanish-adjectives/404/)	
alevoso	"treacherous, premeditated"
declaratorio	declaratory
motivador	"motivating, motivational"
oxigenado	oxygenated
cohesivo	cohesive
ortopédico	"orthopedic, orthopaedic"
premonitorio	premonitory
inhabitable	uninhabitable
atávico	"atavistic, ancestral"
cochino	"dirty, hoggish, swinish"
*** 4041 - 4050 (/course/185945/spanish-adjectives/405/)	
orondo	"rotund, chubby, orotund"
testamentario	testamentary
coriáceo	coriaceous
generativo	generative
detallista	"meticulous, detail-oriented, perfectionist"
olfativo	olfactory
fónico	phonic
abstruso	abstruse
cegador	blinding
conformista	conformist
*** 4051 - 4060 (/course/185945/spanish-adjectives/406/)	
insinuado	implied
merovingio	Merovingian
microbiano	microbial
oclusivo	occlusive
rabínico	rabbinic
reumático	rheumatic
filoso	sharp
planchado	"bummed out, depressed, glum"
maniqueo	Manichaean
laudable	"praiseworthy, laudable"
*** 4061 - 4070 (/course/185945/spanish-adjectives/407/)	
rabón	tailless
impagado	unpaid
estofado	stewed
alsaciano	Alsatian
inextinguible	"inextinguishable, quenchless"
justificativo	justificatory
glotón	"gluttonous, piggish, greedy"
nudoso	"knotty, gnarled, knurled"
primerizo	"beginner, first-timer, green"
profiláctico	"prophylactic, preventive"
*** 4071 - 4080 (/course/185945/spanish-adjectives/408/)	
adventicio	adventitious
avispado	"bright, quick-witted, sharp"
cartujo	Carthusian
cremoso	creamy
almidonado	starched
vacuo	"vacuous, inane, empty"
carolino	Caroline
desapasionado	"passionless, dispassionate"
escenográfico	"scenographic, scenographical"
espirituoso	spirituous
*** 4081 - 4090 (/course/185945/spanish-adjectives/409/)	
timbrado	well-pitched
iluso	"dreamer, naive, gullible"
cansino	weary
arácnido	arachnid
ampuloso	bombastic
cuadrilátero	"quadrilateral, four-sided"
luctuoso	"tragic, sad"
basáltico	basaltic
mimoso	"cuddly, affectionate"
vidriado	glazed
*** 4091 - 4100 (/course/185945/spanish-adjectives/410/)	
hemorrágico	"hemorrhagic, haemorrhagic"
desarraigado	rootless
porfiado	"stubborn, obstinate"
umbilical	umbilical
antitético	"antithetical, antithetic"
separable	"detachable, separable, removable"
interrogador	interrogatory
adulón	greasy
carbonífero	carboniferous
piloso	"pilous, pilose"
*** 4101 - 4110 (/course/185945/spanish-adjectives/411/)	
ferroso	ferrous
mentecato	"goofy, silly"
homeopático	"homeopathic, homoeopathic"
inhábil	incompetent
transitable	"passable, accessible"
putrefacto	"putrid, putrefied, decayed"
indisciplinado	"undisciplined, lax, disorderly"
embotado	"blunt, dull, befuddled"
andrógino	androgynous
abombado	"dented, puffed, puffed out"
*** 4111 - 4120 (/course/185945/spanish-adjectives/412/)	
industrioso	industrious
insolvente	"insolvent, bankrupt"
pentagonal	pentagonal
articular	"articular, joint"
filisteo	philistine
mensurable	"measurable, mensurable"
estimativo	rough
sentencioso	"sententious, oracular, judgemental"
viudo	widowed
mullido	"fluffy, soft, springy"
*** 4121 - 4130 (/course/185945/spanish-adjectives/413/)	
glauco	glaucous
nono	"ninth, drip, dull"
liado	"rolled, tied up with, involved"
traslúcido	translucent
fálico	phallic
acusatorio	"accusatorial, accusatory, accused"
fatalista	fatalist
glúteo	gluteal
jesuítico	"Jesuitic, Jesuitical"
insomne	"sleepless, restless, wakeful"
*** 4131 - 4140 (/course/185945/spanish-adjectives/414/)	
nefando	"heinous, nameless, loathsome"
limonero	lemon
fatuo	"fatuous, conceited, foolish"
inextricable	inextricable
sónico	sonic
castrado	"castrated, neuter"
apocado	"timid, spiritless, diffident"
binocular	binocular
subatómico	subatomic
delgadito	"thin, slim, slender"
*** 4141 - 4150 (/course/185945/spanish-adjectives/415/)	
diatónico	diatonic
vivaracho	frisky
cartilaginoso	gristly
escrutador	searching
visualizado	visualized
pastoso	"pasty, doughy, thick"
asqueado	disgusted
enhiesto	"erect, straight, upright"
menesteroso	"needy, in need, underprivileged"
pancreático	pancreatic
*** 4151 - 4160 (/course/185945/spanish-adjectives/416/)	
timorato	"timorous, prudish"
cenagoso	"sludgy, boggy"
farsante	"fraud, phony, impostor"
imitativo	imitative
neoplatónico	Neoplatonic
barbado	"bearded, barbate"
centrípeto	centripetal
supletorio	"interim, temporary, stopgap"
escultural	sculptural
boyante	"buoyant, prosperous"
*** 4161 - 4170 (/course/185945/spanish-adjectives/417/)	
osmótico	osmotic
amaestrado	"performing, trained"
cabezón	"pigheaded, big-headed, stubborn"
tercermundista	"third-world country, n, Third World"
insumiso	unsubmissive
silíceo	siliceous
espiritista	spiritualist
temporero	temporary
cretense	Cretan
hebraico	Hebraic
*** 4171 - 4180 (/course/185945/spanish-adjectives/418/)	
truculento	"horrifying, gruesome, grisly"
níveo	"lily, niveous"
propiciatorio	propitiatory
sindicado	"unionised, unionized US"
caballeroso	"chivalrous, gentlemanly, gentlemanlike"
exánime	"lifeless, exanimate"
criadero	"breeding centre, breeding ground"
floreado	"flowered, flowery"
lampiño	"hairless, glabrous, depilous"
espasmódico	"spasmodic, jerky, fitful"
*** 4181 - 4190 (/course/185945/spanish-adjectives/419/)	
alarmista	"alarmist, alarming"
fofo	"flabby, soft, wobbly"
monocromo	"monochrome, monochromatic"
índico	Indian
gruñón	"grumpy, grumbler"
estrambótico	"outlandish, eccentric, odd"
lanudo	"woolly, shaggy, wooly"
biodegradable	biodegradable
homicida	"homicidal, murder"
libidinoso	"lustful, lecherous, libidinous"
*** 4191 - 4200 (/course/185945/spanish-adjectives/420/)	
rubicundo	"ruddy, rubicund, reddish-blonde"
tacaño	"stingy, mean, tight"
desaprovechado	wasted
consanguíneo	"akin, consanguineous"
asmático	asthmatic
angloparlante	"English-speaking, anglophone"
pubescente	pubescent
aireado	airy
fariseo	hypocrite
iconoclasta	iconoclastic
*** 4201 - 4210 (/course/185945/spanish-adjectives/421/)	
ptolemaico	Ptolemaic
sonámbulo	"sleepwalker, sleep-walker, somnambulist"
calar	"detect, permeable, penetrable"
manido	gamy
secretor	secretory
subrepticio	"surreptitious, undercover, secret"
campechano	"hearty, good-natured, cheerful"
vertebrado	"vertebrate, well structured"
titubeante	hesitant
pesaroso	"regretful, sorrowful"
*** 4211 - 4220 (/course/185945/spanish-adjectives/422/)	
desinfectante	disinfectant
epidérmico	"epidermal, epidermic"
indigesto	"indigestible, stodgy, heavy"
jurásico	Jurassic
apátrida	"stateless, unpatriotic"
transferible	transferable
cerril	wild
amoral	amoral
bicéfalo	bicephalous
huracanado	"hurricane, hurricane-force, violent"
*** 4221 - 4230 (/course/185945/spanish-adjectives/423/)	
impalpable	impalpable
esterilizado	sterilized
aerostático	aerostatic
despegado	"aloof, cold, distant"
alfanumérico	alphanumeric
atentado	attempted
sobornado	bribed
anestésico	anesthetic
flemático	"phlegmatic, stolid"
dormilón	sleepy
*** 4231 - 4240 (/course/185945/spanish-adjectives/424/)	
apestoso	"stinky, smelly, stinking"
halagador	"flatterer, flattering"
regordete	"chubby, dumpy, plump"
desvaído	"lacking definition, vague, ill-defined"
aclaratorio	"explanatory, illuminating, clarifying"
samaritano	Samaritan
incalificable	indescribable
profeso	professed
bituminoso	bituminous
beatífico	"beatific, beatifical"
*** 4241 - 4250 (/course/185945/spanish-adjectives/425/)	
mancomunado	"joint, jointly responsible"
triplicado	"triplicate, tripled"
pituitario	pituitary
resinoso	resinous
peliagudo	"tricky, thorny, dodgy"
persecutorio	persecutory
subido	"high, loud, bright"
antiséptico	antiseptic
sordomudo	"deaf-mute, deaf and dumb"
negrero	exploiter
*** 4251 - 4260 (/course/185945/spanish-adjectives/426/)	
extravertido	"extroverted, outgoing"
desgarbado	"gawky, ungainly, slovenly"
novelístico	novelistic
sidéreo	sidereal
mancillado	"abused, shamed, disgraced"
agnóstico	agnostic
antediluviano	antediluvian
tísico	"consumptive, phthisic"
contrito	"contrite, repentant"
lisiado	"crippled, lame, injured"
*** 4261 - 4270 (/course/185945/spanish-adjectives/427/)	
palatal	palatal
politécnico	polytechnic
vestal	vestal
vejatorio	vexatious
supernumerario	supernumerary
bulboso	bulbous
dálmata	Dalmatian
desganado	"dead, apathetic, sluggish"
hercúleo	Herculean
inconsecuente	"inconsistent, inconsequential, inconsequent"
*** 4271 - 4280 (/course/185945/spanish-adjectives/428/)	
alícuota	aliquot
laxante	laxative
pagadero	"payable, due"
viajante	travelling
madrugador	"early riser, early-rising, early"
desconsiderado	"inconsiderate, thoughtless"
alborotador	noisy
anémico	"anemic, bloodless"
fusible	fusible
inadaptado	maladjusted
*** 4281 - 4290 (/course/185945/spanish-adjectives/429/)	
inarticulado	inarticulate
regenerado	"regenerate, reclaimed"
terráqueo	"earthling, terrestrial"
rompedor	disruptive
alistado	"enlisted, inducted, joined"
obsequioso	"obliging, fulsome"
aséptico	aseptic
enunciativo	"expository, illustrative"
insectívoro	insectivorous
numerable	numerable
*** 4291 - 4300 (/course/185945/spanish-adjectives/430/)	
prostático	prostatic
roquero	rock
mocoso	"snuffly, sniffly, snotty"
ineluctable	ineluctable
tragicómico	seriocomic
átono	"atonic, unstressed, inert"
inmoderado	immoderate
cholo	"of mixed race, mixed-race"
balbuciente	"stuttering, stammering"
contumaz	"contumacious, obstinate"
*** 4301 - 4310 (/course/185945/spanish-adjectives/431/)	
desnaturalizado	denatured
bífido	bifid
borrico	"dumb, stupid, thick"
memo	"goofy, dumb, silly"
heurístico	heuristic
correoso	"leathery, tough, chewy"
procaz	"lewd, insolent, obscene"
macroscópico	macroscopic
inconformista	"nonconformist, non-conformist, non-conforming"
psicosomático	psychosomatic
*** 4311 - 4320 (/course/185945/spanish-adjectives/432/)	
acampanado	"bell-bottomed, bell-shaped, flared"
larvado	latent
salteado	"sautéed, assaulted"
amotinado	"mutinous, riotous"
fosfórico	phosphoric
demoniaco	"demonic, demoniacal, daemonic"
jamaiquino	Jamaican
aerobio	aerobic
conmutador	commutation
avieso	"evil, malicious, wicked"
*** 4321 - 4330 (/course/185945/spanish-adjectives/433/)	
mellado	"jagged, indented, notched"
inmisericorde	"pitiless, unmerciful"
calloso	"callous, horny"
empecinado	"stubborn, hard-headed"
zafio	"boorish, oafish, coarse"
chapucero	"botched, sloppy, slapdash"
herbario	herbal
zancudo	long-legged
rotacional	rotational
apoteósico	"tremendous, amazing"
*** 4331 - 4340 (/course/185945/spanish-adjectives/434/)	
abrochado	clasped
geofísico	geophysical
gustativo	gustatory
rogativo	inhibitory
maquiavélico	Machiavellian
parricida	patricidal
anquilosado	"stiff, seized up, out-of-date"
encefálico	encephalic
monosílabo	monosyllabic
mirón	"nosy, voyeuristic"
*** 4341 - 4350 (/course/185945/spanish-adjectives/435/)	
onomástico	onomastic
acanalado	"ribbed, corrugated"
deliberativo	deliberative
gamberro	"hooligan, troublemaker"
monógamo	monogamous
infamante	"offensive, slanderous, shameful"
embrollado	"embroiled, perplexed"
pendular	pendular
transicional	transitional
engañador	"deceptive, cheating, deceiving"
*** 4351 - 4360 (/course/185945/spanish-adjectives/436/)	
nudista	nudist
rimbombante	"bombastic, flamboyant, meretricious"
huero	"empty, vacuous, fatuous"
lunático	"lunatic, moonstruck"
superpoblado	overcrowded
transverso	"transverse, cross"
exangüe	"bloodless, exsanguine, anaemic"
oceanográfico	oceanographic
chirriante	scratchy
pudoroso	"shy, modest, bashful"
*** 4361 - 4370 (/course/185945/spanish-adjectives/437/)	
ocurrente	witty
rosáceo	"pinkish, rosaceous, rose"
embrutecido	coarsened
deferente	"deferential, deferent"
necrológico	"obituary, necrologic"
calumnioso	"slanderous, defamatory"
impenitente	"unrepentant, impenitent, inveterate"
recuperable	"recoverable, retrievable"
ganchudo	hooked
empalagoso	"cloying, mawkish, saccharine"
*** 4371 - 4380 (/course/185945/spanish-adjectives/438/)	
somnoliento	"drowsy, sleepy, sleep-inducing"
extraescolar	"extracurricular, out of school"
fláccido	"flaccid, flabby, limp"
fraccionario	fractional
lacrimoso	"lachrymose, tearful, lachrymal"
velador	night watchwoman
púdico	"seemly, modest, proper"
combo	"bent, warped"
jactancioso	boastful
filtrante	filtering
*** 4381 - 4390 (/course/185945/spanish-adjectives/439/)	
iridiscente	iridescent
chabacano	"tasteless, gaudy"
abrasivo	abrasive
fructuoso	"fruitful, successful, productive"
aprobatorio	"approving, approbatory"
acordonado	milled
pasteurizado	pasteurized
maceta	potted plant
curable	curable
expatriado	expatriate
*** 4391 - 4400 (/course/185945/spanish-adjectives/440/)	
chismoso	gossipy
errabundo	"wandering, roving"
concienciado	become aware
electrolítico	electrolytic
filantrópico	"philanthropic, philanthropical"
tratable	tractable
agronómico	"agronomic, agronomical"
descentrado	"off-centre UK, off-center US, unsettled"
nacarado	"pearly, nacreous, pearl"
expiatorio	expiatory
*** 4401 - 4410 (/course/185945/spanish-adjectives/441/)	
quisquilloso	"fussy, persnickety, touchy"
llorón	"weeping, maudlin, weepy"
elegíaco	elegiac
secante	"secant, siccative"
cetrino	"sallow, olive, greenish-yellow"
inopinado	unexpected
perforador	"piercing, perforating"
herrumbroso	"rusty, rust-coloured, reddish"
abastecedor	supplying
lingual	lingual
*** 4411 - 4420 (/course/185945/spanish-adjectives/442/)	
gerencial	"managerial, management"
reembolsable	"returnable, refundable"
tiznado	smutty
dominguero	"Sunday, Sunday best, Sunday driver"
obcecado	"blind, stubborn, obdurate"
velloso	"fluffy, downy, hairy"
puntilloso	"punctilious, particular, touchy"
rajado	"split, ripped, torn"
cautivador	"captivating, spellbinding, enthralling"
limitativo	limitative
*** 4421 - 4430 (/course/185945/spanish-adjectives/443/)	
amanerado	"mannered, affected, camp"
innominado	nameless
balsámico	"balsamic, balmy"
misional	missionary
perlado	"opaline, opalescent, pearly"
anticristiano	"unchristian, antichristian"
séptico	septic
morocho	"well-built, tough, dark-skinned"
beduino	Bedouin
alicaído	"crestfallen, downcast, weak"
*** 4431 - 4440 (/course/185945/spanish-adjectives/444/)	
abollado	"dented, battered"
superdotado	"exceptionally gifted, exceptional"
veleidoso	"fickle, mercurial, wayward"
ojeroso	"haggard, pinched"
patronímico	patronymic
chapado	"plated, beautiful, pretty"
reciclable	recyclable
olvidadizo	forgetful
intrauterino	intrauterine
marmóreo	"marble, marmoreal"
*** 4441 - 4450 (/course/185945/spanish-adjectives/445/)	
dehiscente	dehiscent
denario	denary
carguero	"freight, cargo"
garrafal	"monumental, terrible, enormous"
panegírico	"panegyric, panegyrical"
descreído	"unbelieving, godless, infidel"
chueco	"crooked, dodgy"
jaspeado	"marbled, variegated, mottled"
encerado	"wax, oiled, waxed"
abortivo	abortive
*** 4451 - 4460 (/course/185945/spanish-adjectives/446/)	
modificable	"adaptable, modifiable"
antisubmarino	antisubmarine
anillado	ringed
guarro	"dirty, filthy, indecent"
agorero	"pessimistic, negative"
iletrado	illiterate
leonino	leonine
melifluo	"mellifluous, honeyed, mellifluent"
achaparrado	"stumpy, scrub, scrubby"
fascinador	"fascinating, intriguing"
*** 4461 - 4470 (/course/185945/spanish-adjectives/447/)	
supino	"supine, face up, crass"
terminológico	terminological
flotador	"buoyant, floatable"
cuarentón	"fortyish, of about forty, in his [etc.] forties"
ginebrino	Genevan
hipocondríaco	hypochondriac
inenarrable	indescribable
locativo	locative
predicativo	predicative
aleccionador	"sobering, instructive, enlightening"
*** 4471 - 4480 (/course/185945/spanish-adjectives/448/)	
estatuario	statuesque
tecnócrata	technocratic
irrecusable	"unimpeachable, irrecusable"
advenedizo	"upstart, intrusive, meddlesome"
disuasivo	"deterrent, dissuasive"
laudatorio	laudatory
palmeado	"palmate, webbed"
sahariano	"Saharan, Saharian"
albano	Albanian
pecoso	"freckled, freckly"
*** 4481 - 4490 (/course/185945/spanish-adjectives/449/)	
inclasificable	nondescript
ruborizado	"blushing, go red"
recalentado	reheated
cuadriculado	"squared, gridded, graph paper"
antípoda	antipodal
lacerado	"lacerated, lacerate"
farragoso	"tedious, stodgy"
bilioso	bilious
cismático	"schismatical, schismatic"
amniótico	amniotic
*** 4491 - 4500 (/course/185945/spanish-adjectives/450/)	
petulante	conceited
interracial	interracial
sincopado	jazzy
papista	"popish, papistic"
bracero	"temporary labourer, temporary laborer, emigrant labourer"
impoluto	"unpolluted, spotless, unblemished"
inhibitorio	inhibitory
anexionista	annexationist
manco	one-armed
ahorrativo	"thrifty, saving"
*** 4501 - 4510 (/course/185945/spanish-adjectives/451/)	
cimero	top
tarado	"cretin, moron, loony"
inconsolable	"inconsolable, disconsolate"
indoloro	painless
faríngeo	"pharyngeal, pharyngal"
reverencial	reverential
estereofónico	"stereophonic, stereo"
elusivo	elusive
rogado	invited
polícromo	"polychrome, polychromatic"
*** 4511 - 4520 (/course/185945/spanish-adjectives/452/)	
pírrico	pyrrhic
roñoso	"dirty, filthy, rusty"
temblón	shaky
volteado	"turned over, topsy-turvy, messed up"
difamatorio	"defamatory, slanderous, scandalous"
adverbial	adverbial
ergonómico	ergonomic
fungicida	fungicidal
juncal	"handsome, dashing"
seudónimo	pseudonymous
*** 4521 - 4530 (/course/185945/spanish-adjectives/453/)	
conciliatorio	conciliatory
digerible	digestible
purulento	purulent
aprensivo	"apprehensive, nervous, squeamish"
ferromagnético	ferromagnetic
agustiniano	Augustinian
compresor	compression
borrachín	sot
atributivo	attributive
chusco	funny
*** 4531 - 4540 (/course/185945/spanish-adjectives/454/)	
modular	modular
fonográfico	phonographic
crespo	"curly, crisp, frizzy"
sedero	silk
entreverado	"streaky, mixed"
superable	surmountable
surreal	surreal
desemejante	unlike
infecundo	"barren, sterile, infertile"
cebado	"fattened, fattened-up"
*** 4541 - 4550 (/course/185945/spanish-adjectives/455/)	
camorrista	hooligan
casadero	marriageable
lacrimógeno	tearful
inatacable	unassailable
seroso	serous
fijador	fixative
sexagésimo	sixtieth
sucedáneo	"surrogate, substitute, ersatz"
contaminador	polluting
derechito	"straight, right"
*** 4551 - 4560 (/course/185945/spanish-adjectives/456/)	
transcontinental	transcontinental
serrado	"serrated, serrate"
somnífero	"sleep-inducing, somniferous"
antojadizo	"whimsical, fanciful, unpredictable"
falible	fallible
granulado	"granulated, powdered, ground"
invertebrado	invertebrate
apelativo	last name
calentador	warming
bipartito	bipartite
*** 4561 - 4570 (/course/185945/spanish-adjectives/457/)	
capcioso	captious
ilíaco	iliac
incorrupto	"incorrupt, undefiled"
lúbrico	lubricious
paleozoico	"paleozoic, palaeozoic"
polígamo	polygamous
geminado	geminate
aniñado	childish
foliar	foliar
hipodérmico	hypodermic
*** 4571 - 4580 (/course/185945/spanish-adjectives/458/)	
irremplazable	irreplaceable
alcoholizado	alcoholic
asonante	assonant
inhabitado	"inhabited, unsettled"
definible	definable
intransitivo	intransitive
irisado	"iridescent, chatoyant"
larguirucho	"lanky, gangling"
noctámbulo	"sleep walker, night owl, nocturnal"
rastreador	"trawler, tracker, tracking"
*** 4581 - 4590 (/course/185945/spanish-adjectives/459/)	
argivo	Argive
desalado	desalted
flexivo	"inflectional, inflexional"
filiforme	filiform
yámbico	iambic
sacio	sated
herboso	grassy
chicha	"beautiful, delightful"
irreprimible	irrepressible
olfatorio	olfactory
*** 4591 - 4600 (/course/185945/spanish-adjectives/460/)	
polimorfo	polymorphous
ruano	roan
amatista	amethyst
bilabial	bilabial
sofístico	"sophistic, sophistical"
mesozoico	Mesozoic
gangoso	"nasal, twangy"
parasimpático	parasympathetic
sañudo	vicious
dicharachero	"wit, chatterbox, talkative"
*** 4601 - 4610 (/course/185945/spanish-adjectives/461/)	
trigueño	"dark, olive, olive-skinned"
eferente	efferent
lelo	"halfwit, inane, stupid"
erial	uncultivated land
vociferante	vociferous
espermático	spermatic
contráctil	contractible
mozambiqueño	Mozambican
cicatero	niggardly
sembrador	sowing
*** 4611 - 4620 (/course/185945/spanish-adjectives/462/)	
almibarado	"syrupy, sugary, sugared"
hortera	"tasteless, vulgar, tacky"
tuberoso	tuberous
inabordable	unapproachable
desarreglado	"tousled, disorderly, disordered"
inmotivado	wanton
anticoagulante	anticoagulant
arable	arable
correccional	correctional
equilátero	equilateral
*** 4621 - 4630 (/course/185945/spanish-adjectives/463/)	
encandilado	high
malva	mauve
musculado	muscular
teutónico	Teutonic
ornitológico	ornithological
sabático	"sabbatical, Saturday"
afrodisíaco	aphrodisiac
calenturiento	"feverish, horny, randy"
flácido	"flabby, flaccid"
entrecano	"grizzled, greyish"
*** 4631 - 4640 (/course/185945/spanish-adjectives/464/)	
intelectivo	intellective
enloquecedor	"maddening, excruciating"
orgiástico	orgiastic
fragoso	rocky
bisoño	"rookie, untried, inexperienced"
rasposo	"rough, scratchy, rough-tasting"
putativo	putative
admirativo	admiring
autárquico	"autarchic, autarchical"
morenito	"black person, dark-skinned person, dark-haired"
*** 4641 - 4650 (/course/185945/spanish-adjectives/465/)	
bifurcado	forked
avaricioso	"miserly, avaricious"
protuberante	protuberant
sibilino	Sibylline
tropezón	small pieces of meat added to soup
apaisado	"oblong, landscape"
fotométrico	"photometric, photometrical"
ingrávido	weightless
hacendoso	"hard-working, industrious, house-proud"
marinado	marinated
*** 4651 - 4660 (/course/185945/spanish-adjectives/466/)	
filarmónico	philharmonic
corruptible	corruptible
dorio	Dorian
glutinoso	glutinous
prosódico	prosodic
soplón	sneaky
mohíno	sulky
incriminatorio	"incriminating, incriminatory"
mojigato	"prudish, sanctimonious, priggish"
acromático	achromatic
*** 4661 - 4670 (/course/185945/spanish-adjectives/467/)	
beodo	"drunk, sot, pissed"
cagado	"gutless, yellow"
remilgado	"prim, squeamish, mincing"
discorde	"discordant, jarring"
dadivoso	"generous, giving, charitable"
rotulado	"labeled, lettered"
malteado	malted
policromo	"polychrome, polychromatic"
chiquitín	"teeny, tiny"
intraducible	untranslatable
*** 4671 - 4680 (/course/185945/spanish-adjectives/468/)	
abacial	abbatial
deletéreo	deleterious
etílico	"ethyl, ethylic, alcoholic"
irrebatible	invincible
musgoso	mossy
desparejo	odd
representable	performable
maleducado	"rude, crude, ill-mannered"
turbo	"turbo, turbocharged"
corvino	corvine
*** 4681 - 4690 (/course/185945/spanish-adjectives/469/)	
desmañado	"clumsy, gauche, impractical"
halógeno	halogen
pardillo	"innocent, gullible"
pedantesco	"pedantic, pedantical, donnish"
romboidal	rhomboid
barométrico	"barometric, barometrical"
libresco	bookish
mamón	"freeloader, cadger, idiot"
pijo	"posh, preppy"
onomatopéyico	"onomatopoeic, echoic"
*** 4691 - 4700 (/course/185945/spanish-adjectives/470/)	
cantarín	singsong
soporífero	"soporific, sleepy, sleeping pill"
travestido	transvestite
inflable	inflatable
descosido	"open seam, disconnected, disjointed"
peleón	"quarrelsome, quarreling, scrappy"
ultrasónico	ultrasonic
ventrílocuo	ventriloquist
áurico	"auric, aurous"
corpuscular	corpuscular
*** 4701 - 4710 (/course/185945/spanish-adjectives/471/)	
postoperatorio	postoperative
tornasolado	"shimmering, shot"
apolíneo	Apollonian
eurasiático	Eurasian
fotosensible	photosensitive
perfectible	"perfectible, improvable"
cargante	"annoying, tiresome, irksome"
simiesco	apelike
descorazonador	"disheartening, discouraging"
perruno	"doggy, doggish"
*** 4711 - 4720 (/course/185945/spanish-adjectives/472/)	
plumoso	"feathery, fluffy, plumy"
adolorido	in pain
turgente	"turgid, full"
biónico	bionic
surtido	"supplied, stocked"
beréber	Berber
fileteado	"filleted, tooled"
vendible	"salable, marketable, vendible"
sinvergüenza	"scoundrel, rogue, shameless"
campante	"smug, unflappable, relaxed"
*** 4721 - 4730 (/course/185945/spanish-adjectives/473/)	
untuoso	unctuous
desaprensivo	unscrupulous
aparte	"apart, special, unusual"
grosella	dark-red
estereoscópico	stereoscopic
facsimilar	facsimile
rumboso	"generous, splendid"
inconsiderado	"inconsiderate, reckless, hasty"
azoico	azoic
cortito	"short, brief, hard of hearing"
*** 4731 - 4740 (/course/185945/spanish-adjectives/474/)	
acomodador	"adjusting, adjustment"
conservativo	"conservative, preservative"
localizable	"locatable, available, accessible"
grasoso	"oily, fatty, greasy"
carillo	priced
incivilizado	uncivilized
antirreligioso	antireligious
báquico	"Bacchic, bacchanal, bacchanalian"
bobalicón	"dumb, stupid, dopey"
melindroso	"finicky, dainty, squeamish"
*** 4741 - 4750 (/course/185945/spanish-adjectives/475/)	
injuriado	insulted
intimidante	"intimidating, adj   n"
letárgico	lethargic
gomoso	rubbery
chiita	shiite
sifilítico	syphilitic
altaico	Altaic
nervudo	sinewy
egeo	Aegean
cojonudo	"awesome, amazing, great"
*** 4751 - 4760 (/course/185945/spanish-adjectives/476/)	
enastado	horned
pasable	"passable, fair, tolerable"
pontifical	pontifical
anoréxico	anorexic
faccioso	factious
garboso	"graceful, jaunty"
millonésimo	millionth
mongólico	"Mongol, Mongolian"
inarmónico	inharmonious
pedunculado	"pedunculate, pedunculated"
*** 4761 - 4770 (/course/185945/spanish-adjectives/477/)	
aflautado	reedy
saboyano	Savoyard
acicalado	"smart, well-dressed, dressed up"
anuro	"anuran, anourous"
derrengado	beat
soslayo	oblique
estimulador	stimulating
afónico	"aphonic, voiceless, mute"
casuístico	casuistic
exclusivista	"exclusive, clannish, snobbish"
*** 4771 - 4780 (/course/185945/spanish-adjectives/478/)	
mareante	"get tight, get squiffy"
javanés	Javanese
litográfico	lithographic
mercurial	mercurial
negroide	Negroid
parsimonioso	"parsimonious, phlegmatic, unhurried"
panzudo	paunchy
precámbrico	Precambrian
pirómano	pyromaniacal
dérmico	"dermal, dermic"
*** 4781 - 4790 (/course/185945/spanish-adjectives/479/)	
bacanal	bacchanalian
catártico	cathartic
gafe	jinxed
legionario	legionary
serpenteante	meandering
pulposo	"pulpy, mushy"
limoso	"slimy, oozy"
frígido	frigid
escabechado	pickled
abochornado	ashamed
*** 4791 - 4800 (/course/185945/spanish-adjectives/480/)	
apergaminado	"shrunken, greaseproof"
burbujeante	bubbly
cretáceo	cretaceous
sonso	"dumb, stupid, dim"
oprobioso	"ignominious, opprobrious"
mucilaginoso	mucilaginous
omnidireccional	omnidirectional
saurio	saurian
vinoso	"vinous, winy"
montuoso	hilly
*** 4801 - 4810 (/course/185945/spanish-adjectives/481/)	
mutual	mutual
fisgón	"snooper, tease, snooping"
apriorístico	a priori
flameante	"blazing, flaming"
pinado	pinnate
barbitúrico	barbituric
malcriado	"misbehaving, badly behaved, ill-mannered"
juerguista	"reveller, raver"
suborbital	suborbital
ambarino	amber
*** 4811 - 4820 (/course/185945/spanish-adjectives/482/)	
chancho	"dirty, filthy"
ahíto	"full, sated, satiated"
dispendioso	wasteful
encartado	accused
vivíparo	viviparous
irreligioso	"irreligious, ungodly, godless"
gomero	"rubber, gum, Gomera"
esmirriado	"skinny, scrawny, scraggy"
mujeril	"womanly, womanish"
friolero	"chilly, shivery"
*** 4821 - 4830 (/course/185945/spanish-adjectives/483/)	
resbaloso	slippery
díptero	dipterous
elegiaco	elegiac
ponderable	ponderable
mendeliano	Mendelian
obsesionante	"obsessive, haunting, besetting"
ovíparo	oviparous
desaseado	"sleazy, untidy, scraggly"
desatento	"heedless, discourteous"
adriático	Adriatic
*** 4831 - 4840 (/course/185945/spanish-adjectives/484/)	
detractor	against
bifacial	bifacial
consultante	consulting
hidrostático	hydrostatic
incompresible	incompressible
almendrado	nutty
sustituible	replaceable
neolatino	Romance
corvo	"sagging, curved"
inoxidable	stainless
*** 4841 - 4850 (/course/185945/spanish-adjectives/485/)	
unísono	unison
defectivo	defective
bimensual	"bimonthly, twice monthly, fortnightly"
escarchado	"frosty, frosted, crystallized"
galvánico	galvanic
saturnino	saturnine
trillizo	triple
indefectible	"unfailing, indefectible"
imperdible	unmissable
argénteo	argent
*** 4851 - 4860 (/course/185945/spanish-adjectives/486/)	
aumentativo	augmentative
bóer	Boer
grávido	gravid
barrigón	"paunchy, potbellied"
caradura	"shameless, barefaced, cheeky"
cavernario	spelaean
abisinio	Abyssinian
ciliado	ciliated
higroscópico	hygroscopic
indócil	"indocile, indomitable"
*** 4861 - 4870 (/course/185945/spanish-adjectives/487/)	
enternecedor	affecting
hidrópico	"hydropic, dropsical"
particularista	particularist
revocable	revocable
petitorio	petitionary
exotérmico	"exothermic, exothermal"
hipersensible	hypersensitive
despabilado	"perky, awake"
antiespasmódico	antispasmodic
perdonable	"forgivable, pardonable"
*** 4871 - 4880 (/course/185945/spanish-adjectives/488/)	
atenido	kept
lamido	licked
mesolítico	Mesolithic
paramédico	"paramedical, paramedic"
gordinflón	"podgy, pudgy"
atigrado	"tabby, striped"
ciceroniano	Ciceronian
disociativo	dissociative
piojoso	"lousy, riddled with lice, verminous"
palúdico	"malarial, malarious, paludal"
*** 4891 - 4900 (/course/185945/spanish-adjectives/489/)	
machacón	"pest, bore, insistent"
pestífero	"pestilential, pestiferous, pestilent"
pigmentario	pigmentary
sabatino	sabbatine
utopista	Utopian
determinativo	determinative
erógeno	erogenous
abusador	abusive
albigense	Albigensian
mañanero	morning
*** 4891 - 4900 (/course/185945/spanish-adjectives/490/)	
disruptivo	disruptive
premioso	labored
objetable	objectionable
potestativo	optional
hacedero	performable
septuagésimo	seventieth
silogístico	syllogistic
testado	testate
aovado	ovate
enchilado	"hot, spicy"
*** 4901 - 4910 (/course/185945/spanish-adjectives/491/)	
indemostrable	indemonstrable
oscilatorio	oscillatory
parapléjico	paraplegic
jabonoso	soapy
odorífero	odoriferous
relamido	"prim, prim and proper, overdressed"
santurrón	goody
anabólico	anabolic
gatuno	catty
incomestible	inedible
*** 4911 - 4920 (/course/185945/spanish-adjectives/492/)	
mandón	"bossy, domineering, managing"
alotrópico	allotropic
apodíctico	apodictic
artesiano	artesian
despuntado	blunt
ególatra	"egotistical, egocentric"
epigramático	epigrammatic
desmemoriado	forgetful
gálico	Gallic
enfilado	have it in for sb
*** 4921 - 4930 (/course/185945/spanish-adjectives/493/)	
farisaico	"pharisaic, pharisaical"
sálico	Salic
inconquistable	unconquerable
vermiforme	vermiform
osco	crabby
inane	inane
mioceno	Miocene
anabaptista	Anabaptist
émulo	emulous
asoleado	sun-cure
*** 4931 - 4940 (/course/185945/spanish-adjectives/494/)	
andado	"worn, old, used"
gárrulo	garrulous
andariego	restless
chocho	senile
achispado	"tipsy, screwed"
abiótico	abiotic
áptero	apterous
apañado	"breaded, cocky, deluded"
emigratorio	emigratory
lodoso	"muddy, miry"
*** 4961 - 4970 (/course/185945/spanish-adjectives/495/)	
paleográfico	"paleographic, palaeolithic, paleolithic"
sarmentoso	sarmentose
engomado	"sticky, adhesive"
desvariado	become delirious
comatoso	comatose
ulceroso	"ulcerous, cankerous"
desmandado	"wild, obstreperous"
réprobo	reprobate
esferoidal	spheroidal
majo	"nice, hot, pleasant"
*** 5061 - 5070 (/course/185945/spanish-adjectives/496/)	
lupino	lupine
estrábico	"strabismic, strabismal"
nonagenario	nonagenarian
asexuado	sexless
tabulado	tabulate
juntito	"joined, joined together, next to"
manirroto	"extravagant, wasteful"
plumado	"fledged, feathered, plumed"
naranjado	orange
purgativo	purgative
*** 5031 - 5040 (/course/185945/spanish-adjectives/497/)	
preguntón	"nosy, inquisitive"
pupilar	pupilary
salinero	salt
macarrónico	macaronic
anisótropo	anisotropic
sabihondo	"know-it-all, smart-ass"
hombruno	"masculine, mannish"
pietista	pietistic
pluvioso	"rainy, pluvious"
resoluto	resolute
*** 5041 - 5050 (/course/185945/spanish-adjectives/498/)	
descontentadizo	restless
casposo	scurfy
semilunar	semilunar
conminatorio	"threatening, minatory"
adjetival	adjectival
incobrable	bad
basilar	basilar
insospechable	beyond suspicion
crestado	crested
délfico	"Delphic, Delphian"
*** 5071 - 5080 (/course/185945/spanish-adjectives/499/)	
abordable	approachable
gallináceo	gallinaceous
pánico	panic
antihistamínico	antihistamine
apreciativo	appreciative
autógeno	autogenous
gobernable	governable
parnasiano	Parnassian
subconsciente	subconscious
alquitranado	tarry
*** 4971 - 4980 (/course/185945/spanish-adjectives/500/)	
nodular	nodular
escamado	scale
suplicatorio	supplicatory
volteriano	Voltairian
cariado	"carious, rotten"
cuco	"cute, crafty, sly"
anulable	"defeasible, avoidable"
fregado	"mopped, washed"
sexagenario	sexagenarian
sexuado	sexed
*** 4981 - 4990 (/course/185945/spanish-adjectives/501/)	
shakesperiano	"Shakespearean, Shakespearian"
incontaminado	unpolluted
deslavazado	floppy
canallesco	"scummy, caddish, mean"
viperino	serpentine
constelado	starry
eclíptico	ecliptic
desmadejado	lanky
lesbio	lesbian
ritualista	ritualistic
*** 5101 - 5110 (/course/185945/spanish-adjectives/502/)	
microbiológico	microbiological
antihigiénico	unsanitary
insubordinado	insubordinate
yuppie	yuppie
admonitorio	admonitory
carcamal	"decrepit, ancient, over the hill"
dialógico	dialogic
chichi	easy
descocado	fresh
indeterminable	"indeterminable, undeterminable"
*** 5111 - 5120 (/course/185945/spanish-adjectives/503/)	
pelasgo	Pelasgian
prepositivo	"prepositive, prepositional"
gazmoño	priggish
incircunciso	uncircumcised
gayo	"gay, showy, merry"
azogado	"fidgety, restless"
escrofuloso	scrofulous
chiche	"beautiful, delightful, very blond"
encenagado	"depraved, muddy"
flagelante	flagellant
*** 4941 - 4950 (/course/185945/spanish-adjectives/504/)	
escurrido	narrow-hipped
cacho	"you bloody, you damn"
vocinglero	vociferous
excusable	excusable
casquivano	"feckless, harebrained"
acéfalo	headless
inmensurable	"immeasurable, measureless"
mostrenco	strayed
arrebujado	wrapped up
desafecto	"disaffected, malcontent"
*** 5091 - 5100 (/course/185945/spanish-adjectives/505/)	
mollar	mushy
peripatético	peripatetic
sudaca	South American
bígamo	bigamous
modoso	demure
salvable	"savable, salvable, saveable"
estropajoso	"tough, slovenly, sinewy"
canicular	canicular
condigno	condign
margoso	marly
*** 4951 - 4960 (/course/185945/spanish-adjectives/506/)	
incomunicable	incommunicable
monosilábico	monosyllabic
samnita	samnite
criticón	"critical, nit-picking, fault-finding"
lanoso	"woolly, wooly"
batracio	batrachian
jalado	"hasten, hotfoot it"
elogiable	"laudable, praiseworthy"
opalino	opaline
lábil	labile
*** 5131 - 5140 (/course/185945/spanish-adjectives/507/)	
concesivo	concessive
inmemorable	immemorial
interdental	interdental
sebáceo	sebaceous
apetitivo	appetitive
giboso	gibbous
maniaco	"maniac, maniacal"
sedativo	sedative
eolio	"Aeolian, Eolian"
compresible	"compressible, squeezable"
*** 4991 - 5000 (/course/185945/spanish-adjectives/508/)	
valvular	valvular
enarmónico	enharmonic
regañón	nagging
indocto	"unlearned, untutored, unlettered"
endoscópico	endoscopic
guasón	"joker, tease, witty"
causativo	causative
gabacho	"Pyrenean, French, froggy"
ceroso	waxen
engolado	haughty
*** 5081 - 5090 (/course/185945/spanish-adjectives/509/)	
alopático	allopathic
circunciso	circumcised
capitulado	decorated capital
ñoño	"drip, dull, boring"
refutable	"refutable, answerable"
azafranado	saffron
deshilvanado	scrappy
tumultuario	tumultuary
artrítico	arthritic
trifásico	"have pull, have influence, three-phase"
*** 5141 - 5150 (/course/185945/spanish-adjectives/510/)	
adulterino	"adulterine, adulterate"
redicho	"affected, stilted"
antipirético	antipyretic
guapetón	"bully, handsome"
daltónico	colour-blind
pérmico	Permian
misero	"wretched, squalid, mean"
dermatológico	dermatological
añil	indigo
penetrable	"pervious, penetrable"
*** 5151 - 5160 (/course/185945/spanish-adjectives/511/)	
prono	prone
climatérico	climacteric
amedrentador	"frightening, scaring"
cíngaro	"Gypsy, Gipsy"
puerperal	puerperal
saturnal	Saturnian
cagón	shitty
güero	"vain, fair-haired, blond"
cataléptico	cataleptic
resabiado	vicious
*** 5001 - 5010 (/course/185945/spanish-adjectives/512/)	
levítico	levitical
reparable	repairable
escaleno	scalene
aquilino	aquiline
duodenal	duodenal
extralingüístico	extralinguistic
cianhídrico	hydrocyanic
embriagante	intoxicant
parturienta	parturient
semivocal	semivocalic
*** 5161 - 5170 (/course/185945/spanish-adjectives/513/)	
dolicocéfalo	dolichocephalic
febrífugo	febrifuge
glamuroso	"glitzy, swish"
crecidito	"great, large, long"
suertudo	"lucky, fortunate, jammy"
metalífero	metalliferous
plantígrado	plantigrade
latoso	"annoying, plaguey, tedious"
alterable	alterable
angulado	angulate
*** 5011 - 5020 (/course/185945/spanish-adjectives/514/)	
enjundioso	"substantial, fat"
antipatriótico	unpatriotic
verboso	"wordy, verbose, windy"
mantecoso	"buttery, lardy, greasy"
capitular	decorated capital
diletante	"dilettante, amateur"
sentadito	"sat, seated, sitting"
agriado	"sour, turned, angry"
adversativo	adversative
circasiano	Circassian
*** 5021 - 5030 (/course/185945/spanish-adjectives/515/)	
influenciable	"manipulated, pliable, influenced"
refractivo	refractive
insincero	"disingenuous, insincere, glib"
ectópico	ectopic
paquidermo	pachydermatous
usufructuario	"usufructuary, beneficial"
gredoso	"chalky, clayey"
tabicado	cloisonne
frisio	Frisian
harinoso	"mealy, floury"
*** 5051 - 5060 (/course/185945/spanish-adjectives/516/)	
desasido	disengaged
salubre	"healthy, salubrious"
zumbador	humming
revulsivo	"revulsive, salutary lesson"
tonsurado	shaven
humoso	smoky
empollón	"swot, grind"
insociable	unsociable
cafre	"common, savage"
denotativo	denotative
*** 5181 - 5190 (/course/185945/spanish-adjectives/517/)	
ladronesco	burglarious
glaseado	"glazed, glaze"
antituberculoso	antitubercular
epigástrico	epigastric
psicopático	"psychotic, psychopathic"
valetudinario	valetudinarian
citrino	citrine
liliputiense	lilliputian
saledizo	projecting
prenupcial	antenuptial
*** 5211 - 5220 (/course/185945/spanish-adjectives/518/)	
zafado	"brazen, crazy"
pánfilo	gullible
hipersónico	hypersonic
impudente	impudent
intemperante	intemperate
pancromático	panchromatic
pelágico	pelagic
rácano	"scrooge, stingy, tight"
yemenita	Yemeni
emético	emetic
*** 5121 - 5130 (/course/185945/spanish-adjectives/519/)	
sensiblero	"maudlin, soppy, sentimental"
multifloro	multiflorous
aceitunado	olive
operable	operable
gorrón	"pebble, cobblestone, parasite"
afelpado	"plush, plushy"
brilloso	shiny
sigmoideo	sigmoid
canijo	"weak, frail, sickly"
respondón	zappy
*** 5171 - 5180 (/course/185945/spanish-adjectives/520/)	
crucífero	cruciferous
seboso	"greasy, tallowy, filthy"
desabrigado	naked
partitivo	partitive
perspicuo	perspicuous
probabilista	probabilist
patizambo	bandy
disléxico	dyslexic
perifrástico	periphrastic
redondito	"round, circular, rotund"
*** 5191 - 5200 (/course/185945/spanish-adjectives/521/)	
aguardentoso	beery
desfachatado	cheeky
debilucho	dicky
intestado	intestate
pudibundo	prudish
suavizante	"softening, conditioning"
tembleque	"trembling, shaking"
varicoso	varicose
conductivo	conductive
digestible	digestible
*** 5201 - 5210 (/course/185945/spanish-adjectives/522/)	
chungo	"dodgy, bad, crap"
marchoso	"lively, trendy, party goer"
proconsular	proconsular
retornable	returnable
rético	Rhetic
sabeo	"Sabean, Sabaean"
sulfurado	sulphuretted
vanaglorioso	vainglorious
quejica	"whinging, whining, moaning"
braquicéfalo	brachycephalic
*** 5221 - 5230 (/course/185945/spanish-adjectives/523/)	
sobrecalentado	overheated
palmípedo	palmiped
inculpable	innocent
isócrono	isochronous
paliducho	"peaky, palish"
fitófago	phytophagous
remunerativo	"remunerative, gainful"
estulto	stupid
cosquilloso	ticklish
incorporal	incorporeal
*** 5341 - 5350 (/course/185945/spanish-adjectives/524/)	
atronado	reckless
pachucho	"seedy, queerish, overmature"
contranatural	abnormal
abstractivo	abstractive
bilobulado	"bilobate, bilobed"
recortable	cut-out
negable	deniable
eufónico	"euphonic, euphonious"
feculento	"feculent, starchy"
inmaturo	"immature, undeveloped"
*** 5231 - 5240 (/course/185945/spanish-adjectives/525/)	
grumoso	lumpy
pulverulento	pulverulent
referible	referable
antropocéntrico	anthropocentric
barbilampiño	beardless
controvertible	controversial
facticio	"factitious, artificial"
confundible	mistakable
avellanado	nutty
tánico	tannic
*** 5241 - 5250 (/course/185945/spanish-adjectives/526/)	
titilante	"twinkling, scintillating, scintillant"
malagradecido	ungrateful
adamantino	adamantine
fermentable	fermentable
impremeditado	impromptu
incomible	inedible
encalmado	"quiet, becalmed"
atomístico	atomistic
cístico	cystic
econométrico	econometric
*** 5371 - 5380 (/course/185945/spanish-adjectives/527/)	
querendón	amorous
bimano	"bimanous, bimanal"
bimetalista	bimetallist
caulescente	caulescent
epizoótico	epizootic
equipolente	equipollent
carrerista	horsy
exhortatorio	hortatory
inoculador	inoculating
limitable	limitable
*** 5251 - 5260 (/course/185945/spanish-adjectives/528/)	
inoficioso	inofficious
piscívoro	piscivorous
espiritoso	"spirited, spirituous, hard"
circunferencial	circumferential
disímil	dissimilar
inconvertible	"inconvertible, unconvertible"
flatulento	flatulent
polifásico	polyphase
incasable	unmarriageable
antiparlamentario	unparliamentary
*** 5261 - 5270 (/course/185945/spanish-adjectives/529/)	
cretino	"cretinous, stupid, idiotic"
disoluble	"dissoluble, dissolvable"
educable	"educable, teachable"
follón	"gathered skirt, dead firework"
protestón	obstreperous
peñascoso	"rocky, craggy"
malucho	"below par, poorly"
acedo	heartburn
imprevisor	improvident
culero	lazy
*** 5271 - 5280 (/course/185945/spanish-adjectives/530/)	
cuadrumano	quadrumanous
responsivo	responsive
pazguato	"simple, prudish"
lavable	washable
hebdomadario	"weekly, hebdomadal"
dengoso	"faddy, faddish"
fungoso	fungous
impolítico	impolitic
malcontento	malcontent
mauriciano	Mauritian
*** 5281 - 5290 (/course/185945/spanish-adjectives/531/)	
nilótico	Nilotic
plutocrático	plutocratic
salaz	salacious
septicémico	"septicemic, septicaemic"
licoroso	strong
contractivo	contractive
carcunda	"old-fashioned, outdated"
escuchimizado	"skinny, puny"
gladiatorio	gladiatorial
facistol	insolent
*** 5291 - 5300 (/course/185945/spanish-adjectives/532/)	
cipote	"stupid, thick"
tetánico	tetanic
desgobernado	wild
tranquilito	"calm, quiet, tranquil"
hemofílico	haemophilic
protónico	protonic
girante	spinning
antidetonante	antiknock
biconvexo	biconvex
mandria	"funky, worthless"
*** 5301 - 5310 (/course/185945/spanish-adjectives/533/)	
indelicado	indelicate
jalapeño	Jalapan
suspensorio	suspensory
ultrasecreto	top secret
bilabiado	bilabiate
deponente	deponent
físil	fissile
plegadizo	folding
cabruno	goatish
andadero	passable
*** 5311 - 5320 (/course/185945/spanish-adjectives/534/)	
semiconsonante	semiconsonantal
estigio	Stygian
decumbente	decumbent
chaveta	flick-knife
conchudo	"jammy, shelled"
pisiforme	pisiform
pugnaz	pugnacious
estertoroso	stertorous
asténico	asthenic
agotable	exhaustible
*** 5321 - 5330 (/course/185945/spanish-adjectives/535/)	
machote	tough guy
repolludo	headed
polimórfico	polymorphic
amovible	removable
recusable	exceptionable
hemostático	haemostatic
hannoveriano	Hanoverian
helvecio	"Helvetian, Swiss"
conquistable	pregnable
írrito	"be inflamed, become inflamed"
*** 5331 - 5340 (/course/185945/spanish-adjectives/536/)	
billonésimo	billionth
pesadito	"bore, deep, slow"
comulgante	communicant
decasílabo	decasyllabic
delicuescente	deliquescent
depilatorio	depilatory
disociable	dissociable
epiceno	epicene
caballuno	horsy
pícrico	picric
*** 5351 - 5360 (/course/185945/spanish-adjectives/537/)	
protético	prosthetic
róseo	roseate
brahmánico	"brahmanical, brahmanic, brahminic"
pelotillero	buttery
dispéptico	"dyspeptic, dyspepsial"
protectriz	"protective, protecting"
siluriano	Silurian
insonoro	"voiceless, soundless"
anticanceroso	anticancerous
cardiológico	cardiological
*** 5361 - 5370 (/course/185945/spanish-adjectives/538/)	
dipsómano	dipsomaniac
helíaco	heliacal
interlocutorio	interlocutory
adoptable	adoptable
poliinsaturado	polyunsaturated
predicante	predicant
devolutivo	returnable
sesamoideo	sesamoid
flojito	"slow, slack, weak"
acomodadizo	"accommodating, easygoing, appeasable"
*** 5381 - 5390 (/course/185945/spanish-adjectives/539/)	
munífico	munificent
polisílabo	"polysyllabic, polysyllabical"
preglaciar	preglacial
pulsativo	pulsatory
reconciliable	reconcilable
afásico	"aphasic, aphasiac"
astigmático	astigmatic
bifocal	bifocal
quirógrafo	chirographic
armiñado	ermine
*** 5391 - 5400 (/course/185945/spanish-adjectives/540/)	
fibrinoso	fibrinous
flotable	floatable
galiciano	Galician
ictérico	"jaundiced, icteric"
nuncupativo	nuncupative
superactivo	overactive
paratifoideo	paratyphoid
sermoneador	preachy
escleroso	"sclerotic, sclerous"
pistonudo	"topping, smashing"
*** 5401 - 5401 (/course/185945/spanish-adjectives/541/)	
triangulado	triangular
