*** 1 - 10 (/course/195614/spanish-nouns-5/1/)	
"el braquiópodo, el branquiópodo"	branchiopod
(el)(la) cabalista	cabalist
el pábilo	"(candle)wick, rudder stock"
la carpintera	carpenter (fem.)
la colecistitis	cholecystitis
el clon	clone; dead spit; clown
el costeño	coastal dweller (LatAM)
(el)(la) colaboracionista	collaborationist
el globito	(fig.) condom/preservative/rubber; small balloon
la conífera	conifer
*** 11 - 20 (/course/195614/spanish-nouns-5/2/)	
el compromisario	"mediator; elector, delegate (com)"
la Contrarreforma	Counter-reformation
el cuajado	curd
el grosellero	(black) currant (bush)
el deltoides	deltoid
el diabético	diabetic
el guaperas	"pretty boy, heart-throb"
la lavativa	nuisance; enema
(el)(la) exhibicionista	"exhibitionist, showman"
la limadura	"filing (s), swarf"
*** 21 - 30 (/course/195614/spanish-nouns-5/3/)	
la triza	"fragment, piece, shard (t)"
el colado	"(LatAm) gate crasher, cast"
la halitosis	halitosis
el disminuido	disabled person
la hesitación	hesitation
(el)(la) kuwaití	Kuwaiti
el lapón	"native/inhabitant of Lapland, Lapp"
la ratería	"(petty) thieving,  crookedness, dishonesty (r)"
el cortacésped	"lawn mower, mower, lawnmower"
el lusitano	Lusitanian/Portuguese
*** 31 - 40 (/course/195614/spanish-nouns-5/4/)	
la microfibrilla	microfibril
el ultraligero	microlight
la milhojas	millefeuille
el moldavo	Moldavian
el mustélido	"weasel, ferret"
el besuqueo	"kissing and cuddling, necking"
el bobalicón	"nitwit, dumbell"
el omnívoro	omnivore
el pedófilo	"paedophile, pedophile"
el pinnípedo	pinniped
*** 41 - 50 (/course/195614/spanish-nouns-5/5/)	
"el predador, la predadora"	predator
el conservante	preservative
la profanidad	profanity
(el)(la) prosista	"prose writer, prosaist"
la repoblacion	repopulation
el locatario	"tenant, rentner"
la croqueta	"croquette, roll, rissole"
la truhanería	roguery
el enarenado	sanded place
el sargo	seabream
*** 51 - 60 (/course/195614/spanish-nouns-5/6/)	
el escotoma	scotoma
el escudriñador	"scrutator, scrutinizer, scrutineer"
(el)(la) escita	Scythian
(el)(la) secesionista	secessionist
el apartadero	sidetrack
el gandul	"slacker, shirker, loafer"
el endrino	"sloe, blackthorn"
los jardincillos	small gardens
el mamporro	Smite
(el)(la) hispanohablante	Spanish speaker
*** 61 - 70 (/course/195614/spanish-nouns-5/7/)	
el zanco	stilt
la serpentina	"streamer, pennant"
el plumazo	"stroke of the pen, stroke of a pen, at a stroke"
el destiempo	studs
(el)(la) franquista	supporter of Franco
la rauda	swift
el sicofante	sycophant
el tabulador	"tabulator, tab key"
(el)(la) taxidermista	taxidermist
el terrazo	terrazzo
*** 71 - 80 (/course/195614/spanish-nouns-5/8/)	
los tiburtinos	Tiburtines
el trampero	trapper
el lavamiento	washing
la cabrilla	Wavelet
el licaón	wild dog
la muñequera	"wristband, toy-maker, doll-maker"
(el)(la) cafre	savage
la calenturienta	feverish
la chicana	Chicano
la ciudadana	citizen
*** 81 - 90 (/course/195614/spanish-nouns-5/9/)	
el cobayo	guinea pig
el junípero	juniper
la epidemióloga	epidemiologist
el aligustre	privet
(el)(la) matricida	matricide
la monárquica	"monarchist, royalist"
la musicóloga	musicologist
(el)(la) pugilista	"boxer, pugilist, prize fighter"
(el)(la) drogodependiente	drug addict
el fenogreco	fenugreek
*** 91 - 100 (/course/195614/spanish-nouns-5/10/)	
el avasallador	overwhelming
la velita	candle
el luterano	Lutheran
el palto	avocado
el cuásar	quasar
la hiniesta	broom
el sexagenario	sexagenarian
el silfo	sylph
el abalanzo	lunged
la aeromoza	"stewardess, air hostess"
*** 101 - 110 (/course/195614/spanish-nouns-5/11/)	
la afeminación	"effeminacy, camp"
el aleccionamiento	briefing
el aplicador	"applicator, person who applies sth"
la aromaticidad	aromaticity
la autoacusación	self-accusation
el aventón	"push, shove, lift"
la ayudita	little help
el batik	batik
el bautisterio	"baptistry, baptistery"
el becuadro	natural
*** 111 - 120 (/course/195614/spanish-nouns-5/12/)	
el bimestre	"two-month period, period of two months"
la brucita	brucite
el bulero	churchman
el canopo	canopic
la carcacha	"wreck, heap, junker"
el castañazo	Slap
el cerebrito	brainiac
(el)(la) cheroqui	Cherokee
la chocolatera	chocolate pot
el circón	zircon
*** 121 - 130 (/course/195614/spanish-nouns-5/13/)	
la cohibición	self-consciousness
el colirrojo	redstart
el costillaje	ribbing
la criogenia	cryogenics
el cromatógrafo	chromatograph
el decolorante	bleach
la desvalida	helpless
la dextrosa	dextrose
la electroterapia	electropathy
la elefanta	female elephant
*** 131 - 140 (/course/195614/spanish-nouns-5/14/)	
la embrolla	muddled
la emisaria	emissary
la entresaca	thinning
el eretismo	erethism
el escurridor	"wringer, colander, drainer"
el estañado	tinned
la estivación	aestivation
el eucarionte	eukaryote
la fachenda	"splurge, swank"
el filtraje	filtering
*** 141 - 150 (/course/195614/spanish-nouns-5/15/)	
la fosforita	phosphorite
la fotolitografía	"photolithography, photolithograph"
el gallero	cockfighting enthusiast
el granel	heap of corn
la guarnicionería	saddlery
la hipersomnia	hypersomnia
la hipotonía	hypotonia
la horterada	tacky
el husmeo	"nosiness, sniff, smell"
la incrédula	incredulous
*** 151 - 160 (/course/195614/spanish-nouns-5/16/)	
el infamador	slanderer
el leonero	lion man
la licra	lycra
la liña	handline
el lisol	Lysol
(el)(la) logopeda	speech therapist
el macadán	macadam
la marmosa	Marmosa
la micorriza	mycorrhizal
el mixedema	myxedema
*** 161 - 170 (/course/195614/spanish-nouns-5/17/)	
la nevisca	"light snowfall, flurry of snow"
(el)(la) oculista	"optician, ophthalmologist"
el paleozoico	"paleozoic, palaeozoic"
la patrocinadora	patroness
el planchado	"rolling, ironing"
la preceptora	preceptor
la puridad	"forgetfulness, liquid, dainty"
el queche	"ketch, smack"
la radiotelegrafía	"radiotelegraph, radiotelegraphy"
la rala	sparse
*** 171 - 180 (/course/195614/spanish-nouns-5/18/)	
la raquítica	rickety
(el)(la) rastafari	Rastafarian
la reconciliadora	reconciling
el redoblamiento	redoubling
la salsera	"sauceboat, boat"
la sanitaria	toilet
la saponina	saponin
la sembradura	seeding
el serpenteo	wriggle
la sinterización	sintering
*** 181 - 190 (/course/195614/spanish-nouns-5/19/)	
el soroche	"mountain sickness, altitude sickness"
el tallarín	noodle
el tembleque	"shaking fit, the shakes"
el termalismo	Hydrotherapy
la termoelectricidad	thermoelectricity
el tocólogo	obstetrician
el tomógrafo	tomograph
el torpor	torpor
el trépano	trepan
el triquitraque	firecracker
*** 191 - 200 (/course/195614/spanish-nouns-5/20/)	
el utrículo	utricle
el vertedor	"chute, spillway, outlet"
el verticalismo	verticalism
(el)(la) purista	purist
el marinerito	sailor
el chorlo	great-great-grandchild
los santiagueros	faith healer
el pellico	sheepskin
la bodeguera	winemaking
la partidaria	"supporter, follower"
*** 201 - 210 (/course/195614/spanish-nouns-5/21/)	
la cárcava	channel
(el)(la) almeriense	Almeria
el aniquilador	annihilator
el antiácido	antacid
el asmático	asthmatic
el baniano	banyan
la encamada	bedridden
el regüeldo	belch
la benedictina	Benedictine
la narizota	big nose
*** 211 - 220 (/course/195614/spanish-nouns-5/22/)	
el cisticerco	bladder worm
la caléndula	"calendula, marigold, common marigold"
el cartujo	Carthusian
el hervido	"casserole, stew"
la fletada	chartered
el pelón	"child, baby"
la regleta	"circuit board, surge protector, multiple connector"
el trepador	"climber, nuthatch, climbing iron"
la coladera	"colander, strainer, sieve"
los colémbolos	Collembola
*** 221 - 230 (/course/195614/spanish-nouns-5/23/)	
la cosechadora	combine harvester
el preservador	condom
los consanguíneos	consanguineous
el culpado	"culprit, accused"
el disruptor	cutout
la cicloide	cycloid
la danzarina	dancing
el sordo	"deaf person, hearing impaired person"
el beodo	"drunk, sot, drunkard"
el madrugador	"early bird, riser, early riser"
*** 231 - 240 (/course/195614/spanish-nouns-5/24/)	
el efector	effector
los expropiadores	expropiators
la loseta	floor tile
la estribera	footrest
el chismoso	"gossip, gossiping, gossipmonger"
el girocompás	Gyro
el habitador	habitation
la novatada	"hazing, practical joke"
la hipodermis	hypodermis
el interno	"internal, intern, inmate"
*** 241 - 250 (/course/195614/spanish-nouns-5/25/)	
(el)(la) israelí	Israeli
el ropavejero	junkman
el pololo	"knickerbockers, traditional knickers, boyfriend"
el cojo	"lame person, one-legged person"
el lapita	Lapita
el lavandero	laundryman
las ponedoras	laying
la leguminosa	leguminous plant
los salones	"lounge, salon, sitting room"
la lujuriosa	lusty
*** 251 - 260 (/course/195614/spanish-nouns-5/26/)	
el macero	mace-bearer
la manchega	Manchego
la melcocha	marshmallow
el meteco	metic
el cambiador	"moneychanger, editor, investor"
la botarga	motley
el neoplatónico	Neoplatonist
la novelería	novelty
la filis	Phillies
el conuco	"plot, land"
*** 261 - 270 (/course/195614/spanish-nouns-5/27/)	
el procreador	procreator
el sicoanálisis	psychoanalysis
los quiteños	Quito
(el)(la) reservista	reservist
la rasgadura	ripping
el salesiano	salesian
el samoano	Samoan
el tomamuestras	sampler
el ahorrador	saver
los escantillones	scantlings
*** 271 - 280 (/course/195614/spanish-nouns-5/28/)	
el malandrín	scoundrel
los imbornales	scuppers
la marisquería	seafood restaurant
la secuoya	sequoia
(los)(las) chabolistas	shanty
el vertimiento	shedding
los siameses	Siamese
el signatario	signatory
los ambages	"spin, embellishment, detour"
la chillona	squeaky
*** 281 - 290 (/course/195614/spanish-nouns-5/29/)	
el troncho	stalk
los estratificados	stratified
(el)(la) sibarita	"sybarite, epicure"
el sindicado	Syndicate
los tabulados	tabulated
el informático	"tech, IT guy, programmer"
los terápsidos	therapsids
la afta	"thrush, aphtha"
el morrón	thump
los tonsurados	tonsured
*** 291 - 300 (/course/195614/spanish-nouns-5/30/)	
(el)(la) troglodita	"troglodyte, cave dweller"
el ucase	ukase
(el)(la) vietcong	Vietcong
el trapito	washcloth
el crayón	"wax crayon, crayon"
el zurriago	whip
el chochín	wren
(el)(la) yuppie	yuppie
la arrulladora	lulling
la bretona	from Breton
*** 301 - 310 (/course/195614/spanish-nouns-5/31/)	
el cazabe	cassava
la charra	horseman
el ductor	conductor
la confitera	confectioner
la geóloga	geologist
la hiladora	spinner
la ilustradora	illustrator
la instaladora	installer
la jactanciosa	"boaster, braggart"
la lexicógrafa	lexicographer
*** 311 - 320 (/course/195614/spanish-nouns-5/32/)	
el halagador	flatterer
la marisquera	shellfish
la lora	parrot
la pensadora	thinker
la riojana	Rioja
la salmantina	from Salamanca
la simuladora	"simulator, pretender"
el tifo	typhus
los arroceros	gate crasher
el arrullador	lulling
*** 321 - 330 (/course/195614/spanish-nouns-5/33/)	
el tojo	gorse
los centroeuropeos	Central European
el chicano	Chicano
el congoleño	Congolese
el desheredado	disinherited
el asolamiento	desolation
la corcova	hump
el multimillonario	multimillionaire
la siquiatría	psychiatry
el acordonamiento	cordon
*** 331 - 340 (/course/195614/spanish-nouns-5/34/)	
el agio	agio
el ajustador	"fitter, adjuster, adjustor"
el almácigo	"copperwood, gumbo-limbo"
la almohaza	currycomb
el anafe	cooktop
la anosmia	anosmia
(el)(la) anticastrista	anti-Castro
el anticatolicismo	Anti-Catholicism
el apacentamiento	grazing
la apostema	aposteme
*** 341 - 350 (/course/195614/spanish-nouns-5/35/)	
el arminianismo	Arminianism
la asistolia	asystole
el atragantamiento	choking
el auditórium	auditorium
la autotomía	autotomy
el ayuste	splicing
la azorada	embarrassed
la balsamina	balsam apple
el barógrafo	barograph
la bigotera	bow compass
*** 351 - 360 (/course/195614/spanish-nouns-5/36/)	
la bisección	bisection
la boyera	cattle shed
la bravuconería	"bluster, bravado"
el broncoscopio	bronchoscope
la buganvilla	bougainvillea
la bureta	"buret, burette"
la cagada	"shit, crap, poop"
el calentón	"randy devil, horny devil"
el camachuelo	bullfinch
la camomila	camomile
*** 361 - 370 (/course/195614/spanish-nouns-5/37/)	
(el)(la) carmesí	"crimson, red silk"
el carretel	reel
el carteo	declarer play
el casón	Cason
la cerusita	cerussite
la cesionaria	assignee
el charloteo	patter
el colín	breadstick
la confortación	comforting
el conservacionismo	conservationism
*** 371 - 380 (/course/195614/spanish-nouns-5/38/)	
el copal	copal
el crepé	"crepe, pancake, crape"
el cuate	"twin, mate, pal"
el culantrillo	maidenhair
la delicadez	delicacy
el desbaratamiento	disruption
el desgaire	carelessly
el desmote	ginning
el doblamiento	bending
el embrujamiento	bewitchment
*** 381 - 390 (/course/195614/spanish-nouns-5/39/)	
(el)(la) endosante	endorser
el entrecot	"fillet steak, entrecôte"
el episcopologio	Episcopologio
el erector	erector
la esfalerita	sphalerite
la espadilla	"swingle, scull"
el esquilmo	Esquiline
(el)(la) estalinista	Stalinist
la estilística	stylistic
la evanescencia	evanescence
*** 391 - 400 (/course/195614/spanish-nouns-5/40/)	
la exoftalmia	exophthalmos
la expurgación	expurgation
el fermio	fermion
la fluoración	fluorination
la fonolita	clinkstone
la fucsina	fuchsin
la galesa	Wales
la gastadora	spender
el gimoteo	"whining, whine"
la gluma	glume
*** 401 - 410 (/course/195614/spanish-nouns-5/41/)	
el goniómetro	goniometer
el grandullón	big guy
la guacamaya	"macaw, candlebush, Christmas candle"
el helechal	bracken
la hemosiderina	hemosiderin
la heterodoxa	heterodox
la incurabilidad	"incurability, intractability"
la instilación	instillation
la insuflación	insufflation
la judaización	Judaization
*** 411 - 420 (/course/195614/spanish-nouns-5/42/)	
el kaón	kaon
el kinetoscopio	Kinetoscope
la lanolina	lanolin
el lechuguino	beau
el lelo	halfwit
la llevanza	keeping
la lota	burbot
el lustrador	Sheen
el magnetrón	magnetron
el margraviato	margravate
*** 421 - 430 (/course/195614/spanish-nouns-5/43/)	
el matusalén	Methuselah
el mielero	honeypot
el miraguano	kapok
la mohatra	Mohatra
la ninfomanía	nymphomania
la normanda	Norman
el odómetro	odometer
el oropimente	orpiment
(el)(la) oscense	Huesca
el palatinado	palatinate
*** 431 - 440 (/course/195614/spanish-nouns-5/44/)	
la paliación	palliation
el parné	dibs
el pedicuro	"chiropodist, pedicure, pedicurist"
la penetrabilidad	penetrability
el perclorato	perchlorate
el pisón	"ram, rammer"
el plastificante	plasticizer
el pódium	podium
la pravedad	depravity
el prenombre	praenomen
*** 441 - 450 (/course/195614/spanish-nouns-5/45/)	
la prevaricadora	prevaricating
la protestación	protestation
el quera	wanted
la recría	rearing
la refrigeradora	"fridge, refrigerator, icebox"
la rematadora	spiker
el romanismo	Romanism
el runruneo	Whirring
(el)(la) sablista	"borrower, cadger, scrounger"
el sanmartín	Sanmartin
*** 451 - 460 (/course/195614/spanish-nouns-5/46/)	
el secreteo	"to talk confidentially, to whisper"
la segueta	hacksaw
el sermoneo	"preaching, lecture"
el setenario	Setenario
el sintetismo	synthetism
la sofistería	sophistry
el solón	solon
el tacógrafo	tachograph
la tectita	tektite
la telequinesia	telekinesis
*** 461 - 470 (/course/195614/spanish-nouns-5/47/)	
la tornería	turnery
el tracoma	trachoma
el trigrama	trigram
el trisagio	trisagion
el versito	rhyme
el videoteléfono	videophone
la zeugma	zeugma
el deslave	"landslide, rockfall"
la bruñida	burnished
el tallador	carver
*** 471 - 480 (/course/195614/spanish-nouns-5/48/)	
la ciénega	marsh
el acechador	observer
la preparadora	"tutor, personal trainer"
el albaricoquero	apricot tree
el amerindio	Amerind
(el)(la) anticomunista	anti-communist
la autoclave	autoclave
la barbeta	barbette
el chicotazo	"blow with a whip, lash from a whip"
los braquiuros	brachyuran
*** 481 - 490 (/course/195614/spanish-nouns-5/49/)	
el guardafrenos	brakeman
el concuñado	brother's brother-in-law
el corneta	"bugle, cornet, horn"
(el)(la) buscapleitos	bullies
el bosquimano	Bushman
el campero	"camper, four by four"
la conservera	canning
el capotazo	Capotazo
la cautivadora	captivating
el carcinógeno	carcinogen
*** 491 - 500 (/course/195614/spanish-nouns-5/50/)	
el cartesiano	Cartesian
el casuario	cassowary
(los)(las) catastrofistas	catastrophic
(el)(la) cavernícola	"caveman, cave dweller, cavewoman"
el madrás	Chennai
el quiróptero	chiropteran
los cimbros	Cimbri
el berberecho	"cockle, common cockle"
el coloide	colloid
el acondicionador	"conditioner, air conditioner"
*** 501 - 510 (/course/195614/spanish-nouns-5/51/)	
la reguladora	"controller, regulator, buffer"
los conventuales	conventual
las contrarréplicas	counterclaims
el retortijón	"cramp, twisting, gripe"
los cristaloides	crystalloid
el apagador	"damper, switch, extinguisher"
el rehilete	dart
los demarcadores	demarcators
la deprecación	deprecation
la dextrina	dextrin
*** 511 - 520 (/course/195614/spanish-nouns-5/52/)	
el friegaplatos	dishwasher
el chupón	"dummy, pacifier, sucker"
el eyector	ejector
la epigénesis	epigenesis
la erótica	erotica
las erupciones	"eruption, rash, outbreak"
la escarpadura	escarpment
el expatriado	expatriate
la peritación	expert opinion
la florecita	floweret
*** 521 - 530 (/course/195614/spanish-nouns-5/53/)	
los pronosticadores	forecasters
el guardamuebles	furniture repository
la acanaladura	groove
los encañonados	gunpoint
las calabazadas	head butts
el hectolitro	"hectoliter, hectolitre"
(el)(la) ilota	helot
el hemotórax	hemothorax
el corvejón	hock
el pundonoroso	honorable
*** 531 - 540 (/course/195614/spanish-nouns-5/54/)	
el penetrador	indenter
el párvulo	"infant, preschooler"
la itálica	italics
el barquinazo	"jolt, tumble"
(los)(las) malabares	juggling
la agujeta	"lace, stiffness"
la lesbiana	"lesbian, dyke"
la dejada	let
los morritos	Lips
(el)(la) lisboeta	Lisbon
*** 541 - 550 (/course/195614/spanish-nouns-5/55/)	
los higadillos	livers
la hacedora	maker
(los)(las) mandingas	Mandingo
la marcadora	marker
(el)(la) merinas	Merino
el mitón	mitten
la chinela	"mule, slipper"
la mutual	mutual society
el cortaúñas	nail clippers
(el)(la) nominalista	nominalist
*** 551 - 560 (/course/195614/spanish-nouns-5/56/)	
el nucleido	nuclide
la necrología	"obituary, necrology"
las ocles	Ocles
el cajetilla	"pack, packet"
(el)(la) palatal	palatal
las filloas	pancakes
el parapsicólogo	parapsychologist
el petrodólar	petrodollar
el picardo	Picard
la trapacería	"piece of gossip, racket, swindle"
*** 561 - 570 (/course/195614/spanish-nouns-5/57/)	
la castigadora	punishing
la pielonefritis	pyelonephritis
el rosquete	queer
(los)(las) quietistas	quietist
la sindicatura	receivership
el recombinado	recombined
los dormideros	roosts
la gomita	rubber band
el rayado	"ruled lines, stripes"
el sacro	sacrum
*** 571 - 580 (/course/195614/spanish-nouns-5/58/)	
las salesianas	Salesian
las ciperáceas	sedges
las autolesiones	self harm
la lentejuela	"sequin, spangle, paillette"
el sestercio	sesterce
el albañal	sewer
la espaldilla	"shoulder, shoulder blade"
el negrero	"slaver, slave driver, exploiter"
los sonómetros	sonometers
el agorero	"soothsayer, fortune teller"
*** 581 - 590 (/course/195614/spanish-nouns-5/59/)	
el espaciador	space bar
la espectadora	spectatress
el especiero	spice rack
la escarpia	"spike, tenterhook"
el garañón	stallion
la encorvada	stooped
los trompicones	stumble
la gansada	stupid thing
la cantada	sung
la sostenedora	sustaining
*** 591 - 600 (/course/195614/spanish-nouns-5/60/)	
la comprimido	"tablet, pill"
(el)(la) tarraconense	Tarragona
(los)(las) trapenses	Trappist
el soldadote	trooper
el cornete	turbinate
el torzal	"twine, twist"
el vándalo	vandal
las vertebrales	vertebral
la trasnochada	"vigil, watch, sleepless night"
el gorgorito	"warble, trill"
*** 601 - 610 (/course/195614/spanish-nouns-5/61/)	
(el)(la) mandria	weakling
el yuyo	"weed, medicinal herb"
el merecedor	worthy
el zepelín	Zeppelin
la aficionada	"amateur, fan, lover"
la mielga	alfalfa
la astróloga	astrologer
la banquera	banker
el pugilismo	boxing
la presidiaria	convict
*** 611 - 620 (/course/195614/spanish-nouns-5/62/)	
la cornuda	cuckold
el glicógeno	glycogen
la granadera	grenadier
el hilador	spinner
la mallorquina	Majorcan
el marisquero	shellfish
la multiplicadora	multiplier
la perceptora	percipient
la sicóloga	psychologist
el roquero	rocker
*** 621 - 630 (/course/195614/spanish-nouns-5/63/)	
la juglaresa	minstrel
la tanzana	Tanzanian
la tunecina	Tunisian
el matricidio	matricide
la pedorreta	raspberry
el aguacil	dragonfly
la paraplejía	paraplegia
el abotagamiento	swelling
la trancada	stride
el abacá	abaca
*** 631 - 640 (/course/195614/spanish-nouns-5/64/)	
el abacero	"grocer, grocery"
el acodo	offset
la acrofobia	acrophobia
la actea	Actea
el adventismo	Adventism
el aforamiento	gauging
la agregaduría	attache
el albumen	albumen
el alfonsismo	Alfonsism
el ambón	ambo
*** 641 - 650 (/course/195614/spanish-nouns-5/65/)	
el amordazamiento	gagging
la androginia	androgyny
la anfotericina	amphotericin
(el)(la) árcade	Arcadian
la asíntota	asymptote
la autoinmunidad	autoimmunity
la bacaladilla	whiting
el balseo	Balseo
el barbote	bevor
el bayón	Bayon
*** 651 - 660 (/course/195614/spanish-nouns-5/66/)	
el belcebú	Beelzebub
el brabante	brabant
el brazado	armful
el bridón	"snaffle, bridoon"
el calcetero	hosier
la cardiomiopatía	cardiomyopathy
el centollo	spider-crab
el centrosoma	centrosome
la chacinería	pork butcher's
la cianocobalamina	cyanocobalamin
*** 661 - 670 (/course/195614/spanish-nouns-5/67/)	
el climatólogo	climatologist
el cloqueo	cluck
la clorita	chlorite
la cordonera	lacing
la deambulación	ambulation
la decidora	talkative
(el)(la) deísta	deist
el delineador	eyeliner
(el)(la) denigrante	grovel
la desafiadora	challenging
*** 671 - 680 (/course/195614/spanish-nouns-5/68/)	
el desmotador	ginner
el dictáfono	dictaphone
la disipadora	dissipative
la disuasoria	deterrent
la dormilona	sleepyhead
el dribling	dribbling
la dulcamara	nightshade
el electrómetro	electrometer
la electromiografía	electromyography
el elevamiento	upliftment
*** 681 - 690 (/course/195614/spanish-nouns-5/69/)	
la empalagosa	cloying
el emulsionante	emulsifier
el enchufismo	"wirepulling, string pulling"
el endocardio	endocardium
el enriquecedor	enriching
el escotismo	Scotism
la escrituración	deed
el espermaceti	spermaceti
el estatalismo	state ownership
la estrona	estrone
*** 691 - 700 (/course/195614/spanish-nouns-5/70/)	
la extravasación	extravasation
la fiadora	surety
la fisostigmina	physostigmine
la fluoresceína	fluorescein
el fulminato	fulminate
el funámbulo	ropewalker
la glosopeda	foot and mouth disease
la graja	rook
la granujilla	rascal
la grifería	"taps, bathroom fittings, tap shop"
*** 701 - 710 (/course/195614/spanish-nouns-5/71/)	
el hampón	thug
la helioterapia	heliotherapy
el holmio	holmium
el huevón	dude
el icor	ichor
la improductividad	unproductive
el íncubo	incubus
el infrasonido	infrasound
el intensificador	intensifier
el intuicionismo	intuitionism
*** 711 - 720 (/course/195614/spanish-nouns-5/72/)	
la jarretera	garter
el jazminero	jasmine
el kiswahili	Kiswahili
la lactación	lactation
la laureada	laureate
el levirato	levirate
el lichi	lychee
la llenura	"fullness, fulness"
el maderaje	woodwork
la magnesita	magnesite
*** 721 - 730 (/course/195614/spanish-nouns-5/73/)	
la mahometana	"Mohammedan, Mahometan"
la manejadora	handler
el marrasquino	maraschino
la megaestrella	megastar
la melosidad	mellow
la micoplasma	mycoplasma
(el)(la) mineralogista	mineralogist
el miñón	mignon
la molinería	milling
el monegasco	Monegasque
*** 731 - 740 (/course/195614/spanish-nouns-5/74/)	
el mordedor	biter
(el)(la) mordiente	mordant
la mufla	muffle
la neuropsiquiatría	neuropsychiatry
el noray	bollard
el origenismo	Origenism
(el)(la) ortodoncista	orthodontist
el ostrero	oyster catcher
(el)(la) ovoide	ovoid
la pacana	pecan
*** 741 - 750 (/course/195614/spanish-nouns-5/75/)	
la paleozoología	paleozoology
la parvedad	paucity
el perdiguero	retriever
el pertiguero	beadle
el petete	dummy
la piezoelectricidad	piezoelectricity
la polidipsia	polydipsia
la polinesia	Polynesia
el poliploide	polyploid
la politóloga	political scientist
*** 751 - 760 (/course/195614/spanish-nouns-5/76/)	
el popularismo	popularism
el posoperatorio	postoperative
la psicastenia	psychasthenia
la raridad	"rarity, rareness, exception"
la redecoración	redecoration
el redescuento	rediscount
el reumatólogo	rheumatologist
la revulsión	revulsion
la riñonera	"fanny pack, belt pouch, bum bag"
la salicina	salicin
*** 761 - 770 (/course/195614/spanish-nouns-5/77/)	
el segundogénito	second born
la siestecita	"catnap, forty winks, snooze"
el soporífero	"soporific, narcotic, sleeping pill"
la taiwanesa	Taiwanese
la tajadera	chopper
el taquillaje	"takings, box-office receipts, gate-money"
el telecomando	telecommand
la tendenciosidad	tendentiousness
la termosfera	thermosphere
la terrina	terrine
*** 771 - 780 (/course/195614/spanish-nouns-5/78/)	
el tocho	"tome, large volume, brick"
(el)(la) trasparente	transparent
la tripita	shag
la trovadora	troubadour
(el)(la) vallista	hurdler
(el)(la) vicegerente	vicegerent
la virgulilla	prime
el vitro	vitro
el voceo	"shouting, yelling, bawling"
el moquete	punch on the nose
*** 781 - 790 (/course/195614/spanish-nouns-5/79/)	
el cristalero	glass cabinet
el ribereño	riverside dweller
la bravuconada	boast
el enfriador	"cooler, cooling plant"
la atarjea	"sewage pipe, drain, reservoir"
el pañero	"draper, dry-goods dealer, clothier"
las paredes	walls
la actinomicosis	actinomycosis
la alosa	alewife
la anquilostomiasis	ankylostomiasis
*** 791 - 800 (/course/195614/spanish-nouns-5/80/)	
el anticlímax	anticlimax
los ausetanos	Ausetani
los misticetos	baleen
el hilván	basting
los hayucos	beech mast
(el)(la) apostante	"bettor, backer"
la bita	bitt
la breca	bleak
la patochada	blunder
el boa	"boa, boa constrictor, feather boa"
*** 801 - 810 (/course/195614/spanish-nouns-5/81/)	
el pesado	bore
el almohadillado	bossage
el abrebotellas	bottle opener
el rompedor	breaker
(el)(la) contrayente	bride and groom
la rebaba	"burr, bur"
las hanegas	bushels
las aclaradas	clarified
la clasificadora	Classification
el garro	claw
*** 811 - 820 (/course/195614/spanish-nouns-5/82/)	
(los)(las) cluniacenses	Cluny
la mamarrachada	cobblers
(el)(la) cenobita	coenobite
(el)(la) conviviente	cohabitant
(los)(las) colosenses	Colossians
(el)(la) cajista	compositor
el coselete	"corselet, corslet"
la repregunta	cross-examination
los daditos	cubes
el decilitro	"deciliter, decilitre"
*** 821 - 830 (/course/195614/spanish-nouns-5/83/)	
el albarán	"delivery note, despatch note"
las melladuras	dents
el dilatador	dilator
el doméstico	"domestic, servant"
las cagarrutas	droppings
el zopenco	"dunce, clot"
(el)(la) elamita	Elamite
(los)(las) iguales	equal
la exorbitancia	"exorbitance, extravagance, exorbitancy"
la medrosa	fearful
*** 831 - 840 (/course/195614/spanish-nouns-5/84/)	
el espantamoscas	fly-swat
el guardamano	fore
el franquiciado	franchisee
la polaina	"gaiter, puttee, leggings"
el gacetero	gazetteer
el gnóstico	Gnostic
la telecabina	gondola
el gránulo	granule
el pulgón	greenfly
el guiador	guider
*** 841 - 850 (/course/195614/spanish-nouns-5/85/)	
el golfillo	"guttersnipe, gamin, monkey"
los cíngaros	gypsies
el hostigador	harasser
el endurecedor	hardener
el helicoide	helicoid
el heleno	Hellene
la arreada	herded
la portañuela	his fly
la holografía	"holography, holograph"
el hidrante	hydrant
*** 851 - 860 (/course/195614/spanish-nouns-5/86/)	
los hidrozoos	hydrozoans
la indirecta	"insinuation, hint"
(los)(las) intervencionistas	interventionist
la chatarrería	junk yard
el lapidario	lapidary
la lugartenencia	lieutenancy
la ventolina	light air
el lanchero	lighterman
la logomaquia	logomachy
(el)(la) machista	male chauvinist
*** 861 - 870 (/course/195614/spanish-nouns-5/87/)	
el imao	MAOIs
(los)(las) maronitas	Maronites
(el)(la) mendicante	mendicant
las anfetas	meth
la microonda	microwave
(el)(la) mini	"mini, litre glass UK, liter glass US"
los molinares	Molinares
las musáceas	Musa
las micenas	mycenae
las capuchinas	nasturtiums
*** 871 - 880 (/course/195614/spanish-nouns-5/88/)	
la parida	"new mom, woman who has recently given birth, stupid remark"
la problemita	niggle
la adelfa	oleander
el olécranon	olecranon
la oriflama	Oriflame
los ortópteros	Orthoptera
la mimbrera	osier bed
los repintes	overpainting
(el)(la) pasionista	Passionist
la pegmatita	pegmatite
*** 881 - 890 (/course/195614/spanish-nouns-5/89/)	
el chupatintas	penpusher
los trepados	perched
los persecutores	persecutors
la persuasiva	persuasiveness
la pestífera	pestiferous
los cartoneros	pickers
la reineta	pippin
la bocamina	pithead
el chapetón	rain shower
el asentador	razor strop
*** 891 - 900 (/course/195614/spanish-nouns-5/90/)	
(el)(la) juerguista	"reveller, hellbender, merry-maker, bacchanal"
el fusilero	"rifleman, fusilier"
la fragosidad	roughness
la escabrosidad	"roughness, ribaldry, riskiness"
el sabino	Sabine
los becados	scholarships
el raspón	scrape
el sietecolores	seven colors
la ripia	shingle
(los)(las) situacionistas	situationists
*** 901 - 910 (/course/195614/spanish-nouns-5/91/)	
la broqueta	skewer
el espectrograma	spectrogram
la sentadilla	squat
(el)(la) sufragista	"suffragette, suffragist"
los surferos	surfers
la silepsis	syllepsis
(el)(la) simbolista	symbolist
la sinéresis	syneresis
la incitadora	tease
el texano	Texan
*** 911 - 920 (/course/195614/spanish-nouns-5/92/)	
la delga	thin
la labrada	tilled
los tonganos	Tongans
los tripanosomas	trypanosomes
el tunicado	tunicate
la vestal	"vestal virgin, vestal"
la aguadora	Water Carrier
la soldadora	welder
el disputador	wrangler
la aparcera	sharecropper
*** 921 - 930 (/course/195614/spanish-nouns-5/93/)	
la barcia	chaff
la boyarda	boyar
la capitalina	inhabitant of the capital
la condiscípula	classmate
la endocrinóloga	endocrinologist
el hematíe	"red blood cell, erythrocyte"
la espartana	Spartan
(el)(la) fratricida	fratricide
la fumadora	smoker
la hotelera	hotelier
*** 931 - 940 (/course/195614/spanish-nouns-5/94/)	
la inmunóloga	immunologist
la granjera	farmer
la maldecida	damned
el mandarino	Mandarin person
la molinera	miller
la moscareta	flycatcher
la bordadura	embroidery
la visigoda	Visigoth
el cacahuate	"peanut, groundnut"
el estomatólogo	dentist
*** 941 - 950 (/course/195614/spanish-nouns-5/95/)	
el neanderthal	Neanderthal
el cananeo	Canaanite
el fabricador	fabricator
la huerfanita	orphan
el incapacitado	disabled person
la acuciosidad	diligence
la afeitada	shaved
la agarrada	"fight, argument, row"
el alcanforero	camphor
el alfiletero	needle case
*** 951 - 960 (/course/195614/spanish-nouns-5/96/)	
la alucinada	hallucinated
el amillaramiento	millage
el amonestador	Warning
el antepuerto	outer port
la antisepsia	antisepsis
la anuria	anury
el apilador	stacker
el arrufo	sheer
la ataguía	cofferdam
la atipicidad	atypical
*** 961 - 970 (/course/195614/spanish-nouns-5/97/)	
la atopia	atopy
el autocine	drive-in cinema
(el)(la) bajante	descendant
el ballico	ryegrass
la bandejita	salver
el barato	street market
la bastardilla	"italics, italic type, italic font"
el beagle	beagle
la biogenética	genetic engineering
el bolómetro	bolometer
*** 971 - 980 (/course/195614/spanish-nouns-5/98/)	
el borboteo	bubble
el bronceador	"tanning lotion, fake tan, tan in a bottle"
la cadeneta	chain stitch
la calumniadora	slanderous
la cañaheja	fennel stalk
la cantaleta	"repetitive song, silly song, whining"
la carcelera	"jailor, jailer, warder"
el carcinoide	carcinoid
el cartonaje	carton
el cejador	Cejador
*** 981 - 990 (/course/195614/spanish-nouns-5/99/)	
la cerillera	Match Girl
el chandal	track-suit
el chirimoyo	cherimoya
la chucha	fuck
el circunflejo	circumflex
(el)(la) coagulante	coagulant
(el)(la) confesante	confessing
la correhuela	Morning Glory
el correteo	scamper
la desfibrilación	defibrillation
*** 991 - 1000 (/course/195614/spanish-nouns-5/100/)	
el desplomo	collapsed
el docetismo	Docetism
la dominadora	dominating
el dormán	dolman
el dragomán	dragoman
la dulcificación	sweetening
el embargue	impound
el empotramiento	Recess
el envalentonamiento	"arrogancy, Dutch courage, arrogance"
la escualidez	squalor
*** 1001 - 1010 (/course/195614/spanish-nouns-5/101/)	
el etnomusicólogo	ethnomusicologist
la extravertida	extraverted
la fenacetina	phenacetin
el ferrocianuro	ferrocyanide
(el)(la) figurinista	costume
el filosofismo	philosophism
la fisga	fish spear
la flebotomía	phlebotomy
el futbolito	foosball
el gabro	gabbro
*** 1011 - 1020 (/course/195614/spanish-nouns-5/102/)	
el gentilismo	gentilism
(el)(la) geriatra	geriatrician
el glasé	icing
el gordolobo	mullein
el greco	Greco
(el)(la) griñón	wimple
la guardarropía	wardrobe
el haraquiri	harakiri
el heladero	ice-cream man
el hidroala	hydrofoil
*** 1021 - 1030 (/course/195614/spanish-nouns-5/103/)	
el hidrocele	hydrocele
la impetra	implores
la inadaptabilidad	inadaptability
la incivilidad	incivility
el incógnito	incognito
la infecundidad	"infertility, barrenness"
la ininteligibilidad	unintelligibility
la interlínea	interline
la irrevocabilidad	irrevocability
el isocianato	isocyanate
*** 1031 - 1040 (/course/195614/spanish-nouns-5/104/)	
el jipijapa	panama
el lagópodo	grouse
la lanosidad	"woolliness, wooliness"
el legrado	"curettage, scraping, D and C"
la lienza	stringline
la limnología	limnology
la lobectomía	lobectomy
la malaca	malacca
el malato	malate
el máser	maser
*** 1041 - 1050 (/course/195614/spanish-nouns-5/105/)	
el meditador	meditator
el mesolítico	Mesolithic
el miometrio	myometrium
el moldeamiento	shaping
la negrilla	bold
el omento	omentum
el ontologismo	ontologism
(el)(la) optometrista	optometrist
el ostiario	ostiary
el panislamismo	Pan-Islamism
*** 1051 - 1060 (/course/195614/spanish-nouns-5/106/)	
la paradita	Paradita
el pastorcito	shepherd
el pebete	"potpourri, fuse, fuze"
el pejesapo	angler
(el)(la) piragüista	canoeist
el pirotécnico	pyrotechnist
la pituita	pituita
la predestinada	predestined
la premoriencia	predecease
(el)(la) prensista	pressman
*** 1061 - 1070 (/course/195614/spanish-nouns-5/107/)	
el prevaricato	malfeasance
la proletaria	proletarian
la proscrita	Outlaw
la psicofisiología	psychophysiology
la quisquillosa	fussy
la rancidez	"rancidity, rancidness"
la rebalsa	overflows
el reenganche	reclosing
la refección	refection
la resbalosa	slippery
*** 1071 - 1080 (/course/195614/spanish-nouns-5/108/)	
el sabelianismo	Sabellianism
el segundero	seconds
el serpentario	serpentarium
el simún	"simoom, simoon, samiel"
el sincrociclotrón	synchrocyclotron
la sobrecama	"coverlet, counterpane"
la sopita	soup
el sublevamiento	uprising
la substracción	subtraction
la talasoterapia	Thalassotherapy
*** 1081 - 1090 (/course/195614/spanish-nouns-5/109/)	
el talmud	Talmud
el taquímetro	tachymeter
la teledifusión	telecast
la tetina	"teat, nipple"
la tiendita	commissary
el tocoferol	tocopherol
el traqueo	jolting
la traspiración	transpiration
la turbonada	squall
la ventriloquia	ventriloquism
*** 1091 - 1100 (/course/195614/spanish-nouns-5/110/)	
la vocinglería	boisterousness
el huno	Hun
el ibero	Iberian
la quijotada	quixotic act
la galardonada	award winner
el macarra	"lout, thug, vulgar"
el malsín	"slanderer, informer, taleteller"
la reguera	"irrigation channel, mooring rope, cable"
las adiposas	adipose
el volado	"affair, lie"
*** 1101 - 1110 (/course/195614/spanish-nouns-5/111/)	
(los)(las) alauíes	Alawites
la aliseda	alder grove
el antihistamínico	antihistamine
el aristotélico	Aristotelian
los balineses	Balinese
el manteamiento	blanketing
la blusita	blouse
el bostoniano	Bostonian
la chapucería	"botchery, botch"
el embotellador	bottler
*** 1111 - 1120 (/course/195614/spanish-nouns-5/112/)	
la ladrillera	bricked
las burbujitas	bubbles
el bufet	buffet
el entredós	"cabinet, insertion"
el episcopal	"Cæremoniale Episcoporum, Ceremonial of Bishops"
(el)(la) caníbal	cannibal
el trebejo	chessman
el cincelador	Chipper
los ciliados	ciliates
la cinemateca	Cinematheque
*** 1121 - 1130 (/course/195614/spanish-nouns-5/113/)	
los aporreados	clubbed
el posavasos	coaster
(el)(la) conservacionista	conservation
el contradictor	"contradictor, contradictory"
la coordinada	coordinated
el tentadero	corral
(el)(la) cosmopolita	cosmopolitan
la vaquera	cowgirl
el coracero	cuirassier
el chuleta	"cutlet, chop, divot"
*** 1131 - 1140 (/course/195614/spanish-nouns-5/114/)	
los dárdanos	Dardanians
la tachadura	"deletion, obliteration, erasure"
el maquinador	"deviser, plotter"
el doctrinario	"doctrinaire, doctrinarian"
el dinasta	dynast
el flexible	"electric cord, flex, cable"
el esmaltado	"enamel, varnishing, enamelling"
(el)(la) enciclopedista	"encyclopedist, encyclopaedist"
(los)(las) anglohablantes	English speakers
la barrabasada	evil thing
*** 1141 - 1150 (/course/195614/spanish-nouns-5/115/)	
(el)(la) evolucionista	evolutionist
el desconchado	"flaw, chip"
el flechero	Fletcher
la cantadora	"folksinger, chorine"
la fontanela	fontanelle
el baboso	"fool, idiot, slug"
el cerquillo	"fringe, bangs"
los rapacejos	fringes
la fungicida	fungicide
(los)(las) azotacalles	"gadabout, idler, loafer"
*** 1151 - 1160 (/course/195614/spanish-nouns-5/116/)	
el gasterópodo	gastropod
el gay	"gay, homosexual"
el habanero	"habanero chili, habanero pepper"
el postizo	hairpiece
el portahelicópteros	helicopter carrier
la hematites	"hematite, haematite"
el cañamón	hempseed
los hipidos	hiccups
los cacharreros	homebuilders
el identificativo	Id
*** 1161 - 1170 (/course/195614/spanish-nouns-5/117/)	
(el)(la) idealista	idealist
el inmortal	immortal
los javaneses	Javanese
el dicterio	"jibe, taunt, jeer"
el encintado	kerb
el lagrimal	lacrimal
la laminadora	laminator
los cristalinos	"lens, crystalline lens"
el lepidóptero	lepidopteran
(el)(la) guardavía	"lineman, linesman, signalman"
*** 1171 - 1180 (/course/195614/spanish-nouns-5/118/)	
los loquios	lochia
el suelto	loose change
los tórtolos	lovebirds
el maltés	Maltese
las malváceas	Malvaceae
la pesebrera	manger
el masturbador	masturbator
(el)(la) medievalista	medievalist
la metrorragia	metrorrhagia
las malandanzas	misfortunes
*** 1181 - 1190 (/course/195614/spanish-nouns-5/119/)	
los miomas	myomas
el tapacubos	nave plate
el necton	nekton
los neocatólicos	neo-Catholics
los ollares	nostrils
la postilla	"note, marginal note, footnote"
(los)(las) observantes	observant
la veladora	"oil lamp, candle"
el cortapapeles	paper knife
la chirivía	parsnip
*** 1191 - 1200 (/course/195614/spanish-nouns-5/120/)	
el pavero	Pavero
el balín	pellet
los lápices	pencil
el portaplumas	penholder
la peonía	peony
la falena	phalaena
la filarmónica	Philharmonic
el bruñido	polishing
los trajineros	porters'
el pretoriano	"praetorian, pretorian"
*** 1201 - 1210 (/course/195614/spanish-nouns-5/121/)	
la probatura	Pronatura
(el)(la) proteccionista	protectionist
el psicofármaco	psychotropic
el arrancador	puller
la purpúrea	purple
la gradilla	rack
el reconocedor	recognizer
la reveladora	revealing
la rinoplastia	rhinoplasty
el rodio	rhodium
*** 1211 - 1220 (/course/195614/spanish-nouns-5/122/)	
el retozo	"romp, friskiness"
la segundo	second
los servomecanismos	servomechanisms
el ofidio	snake
el solecismo	solecism
la abiogénesis	spontaneous generation
los espolines	spurs
los estampadores	stampers
la chaira	steel
el subforo	subforum
*** 1221 - 1230 (/course/195614/spanish-nouns-5/123/)	
los cazasubmarinos	submarine chasers
el submúltiplo	submultiple
el superconductor	superconductor
los supernumerarios	supernumerary
la sinovitis	synovitis
la milésima	thousandth
las tetitas	titties
el tongo	Tongo
el tremor	tremor
el triglicérido	triglyceride
*** 1231 - 1240 (/course/195614/spanish-nouns-5/124/)	
los fideicomisarios	"trustee, trust"
(el)(la) omeya	Umayyad
las desempleadas	unemployed
(el)(la) utopista	Utopian
el bañadero	vat
la venusina	Venusian
el vinatero	"vintner, wine merchant"
la virago	virago
(el)(la) virgo	"Virgo, hymen"
los sabihondos	wiseacres
*** 1241 - 1250 (/course/195614/spanish-nouns-5/125/)	
la oficiala	woman officer
el gañido	"yelp, whine, whimper"
la boxeadora	boxer
la carnicera	butcher
la demagoga	demagogue
la desertora	"defector, deserter, runaway"
la folclórica	folk
la pandillera	"gangster, mobster"
la gaucha	South American cowboy
la neozelandesa	New Zealander
*** 1251 - 1260 (/course/195614/spanish-nouns-5/126/)	
la lusa	Portuguese
la putería	whoring
la recitadora	reciter
el calcañar	heel
la tinerfeña	Tenerife
la zamba	half-breed
la zaragozana	Zaragoza
el coleccionador	collector
el bogotano	Bogota
el capitalino	inhabitant of the capital
*** 1261 - 1270 (/course/195614/spanish-nouns-5/127/)	
el manoteo	gesticulation
la bandolina	"mandolin, mandoline"
la nemotecnia	mnemonics
el tamborín	tambourine
la aconitina	aconitine
el agarrotamiento	"tightening, stiffening, seizing up"
la aguachirle	"slops, weak drink, trifle"
la aguaita	Aguaita
la alboroza	elated
el alergólogo	allergist
*** 1271 - 1280 (/course/195614/spanish-nouns-5/128/)	
la amigdalectomía	tonsillectomy
el amole	whet
el anabaptismo	Anabaptism
la androsterona	androsterone
el anexionismo	annexationism
el animalismo	animalism
la anteposición	preposing
el aporreo	dressing-down
la arañada	scratched
el archipámpano	panjandrum
*** 1281 - 1290 (/course/195614/spanish-nouns-5/129/)	
el arraigamiento	rooting
la asiria	Assyria
la atestiguación	"attestation, testimony"
la ática	Attica
el atomizador	"atomizer, spray, atomiser"
el atrezo	props
el australopiteco	Australopithecus
la autocontención	self-containment
el autoencendido	self-ignition
la beatlemanía	Beatlemania
*** 1291 - 1300 (/course/195614/spanish-nouns-5/130/)	
el behaviorismo	"behaviourism, behaviorism"
la billarda	Billarda
el bimetalismo	bimetallism
la brema	bream
el cabrilleo	whitecaps
el cabujón	cabochon
la cachiporra	"blackjack, truncheon, bludgeon"
la calcopirita	chalcopyrite
el canalizo	fairway
el carborundo	carborundum
*** 1301 - 1310 (/course/195614/spanish-nouns-5/131/)	
el cegador	"flatterer, boot-licker, brown-nose"
la celidonia	celandine
la centaurea	knapweed
la certitud	certitude
el chalaneo	horse-trade
el chanciller	chancellor
el chinito	Chinese man
la chorra	stream
el clausulado	clauses
el cleptómano	kleptomaniac
*** 1311 - 1320 (/course/195614/spanish-nouns-5/132/)	
la colodra	Colodra
la combadura	"bend, camber"
la conmensurabilidad	commensurability
el córnico	Cornish
la cosmetología	cosmetology
el cronometrador	timekeeper
el densímetro	densimeter
el desapoderamiento	divestment
la desbocada	runaway
el desmenuzamiento	comminution
*** 1321 - 1330 (/course/195614/spanish-nouns-5/133/)	
el discóbolo	discobolus
la ecolocación	echolocation
la endolinfa	endolymph
el engendrador	begetter
la enloquecedora	maddening
el escaqueo	shirking
la esclerodermia	scleroderma
el escobazo	"quick sweep, blow with a broom"
el esfigmomanómetro	sphygmomanometer
el espeque	handspike
*** 1331 - 1340 (/course/195614/spanish-nouns-5/134/)	
el estenógrafo	stenographer
el exprimidor	"squeezer, wringer, juicer"
el exteriores	"exterior, outside"
la fasciculación	fasciculation
la fenicia	phenicia
el flexor	flexor
el francmasón	"freemason, mason"
el gasómetro	gasometer
la generatriz	generatrix
el gladio	gladiolus
*** 1341 - 1350 (/course/195614/spanish-nouns-5/135/)	
la grandecita	biggie
la hidrocortisona	hydrocortisone
el hindustaní	Hindustani
la hornblenda	hornblende
la iberoamericana	Iberoamerican
la ilegibilidad	illegibility
el impétigo	impetigo
el inclinómetro	inclinometer
la incolumidad	safety and protection
el instituidor	institutor
*** 1351 - 1360 (/course/195614/spanish-nouns-5/136/)	
la juglaría	minstrelsy
el lapo	"bash, wipe"
el lari	lari
la laterita	laterite
la lechosa	milky
el lexicólogo	lexicologist
el logogrifo	logogriph
el ludismo	Luddism
la maculada	Immaculate
el magníficat	Magnificat
*** 1371 - 1380 (/course/195614/spanish-nouns-5/137/)	
el muletero	muleteer
(el)(la) naturópata	naturopath
la naturopatía	naturopathy
el navarca	navarch
el nescafé	Nescafe
el nidito	nest
el nitrobenceno	nitrobenzene
el obscurecimiento	obscuration
el ofuscamiento	"daze, dimness, bewilderment"
el pachulí	patchouli
*** 1361 - 1370 (/course/195614/spanish-nouns-5/138/)	
el maque	lacquer
el medicucho	quack
el membrillero	quince
el meningococo	meningococcal
el menorquín	Menorca
el menospreciador	contemptuous
la mielinización	myelination
el militantismo	militancy
el monipodio	Monipodio
el muaré	moire
*** 1381 - 1390 (/course/195614/spanish-nouns-5/139/)	
el pañito	corn dodger
el paramagnetismo	paramagnetism
la pátera	patera
el perdonador	pardoner
el perecimiento	perishability
el pergeño	concocted
el peristaltismo	peristalsis
el picrato	picrate
la pídola	leapfrog
la pinaza	pinnace
*** 1391 - 1400 (/course/195614/spanish-nouns-5/140/)	
la piocianina	pyocyanin
la piridoxina	pyridoxine
la plastificación	plasticization
el plasto	plastid
el playero	beach
el plomazo	bummer
el pomar	orchard
el praliné	praline
la prefación	preface
la preservadora	sparing
*** 1401 - 1410 (/course/195614/spanish-nouns-5/141/)	
la prorrogación	"prorogation, renewal"
el prosador	proser
la ptialina	ptyalin
el puñalito	little dagger
el puñito	little fist
el quiromántico	palmist
la rasqueta	scraper
el rebozuelo	chanterelle
el recipiendario	recipient
el reclusorio	prison
*** 1411 - 1420 (/course/195614/spanish-nouns-5/142/)	
el renio	rhenium
la renovadora	renewing
la retardación	"retardation, slowing down, delaying"
el rocino	Rocino
la ruedecilla	"small wheel, roller castor"
el sandio	Sanzio
el seise	choirboy
el semicilindro	hemicylinder
el senequismo	Senecanism
el serbo	Serb
*** 1431 - 1440 (/course/195614/spanish-nouns-5/143/)	
la tronada	thunderstorm
la troza	log
la variz	varicose vein
el velacho	foretopsail
la vicegobernadora	Lt. Governor
el vivandero	sutler
el yoyó	yo-yo
(el)(la) zulú	Zulu
el camellero	camel-driver
la gatera	cat flap
*** 1421 - 1430 (/course/195614/spanish-nouns-5/144/)	
el sudsudeste	SSE
el techador	roofer
la teratología	teratology
la tercerilla	Tercerilla
la touche	touch
el toxicólogo	toxicologist
la tramposa	"cheat, trickster"
el trasmallo	trammel
el trismo	lockjaw
el trompeteo	fanfare
*** 1441 - 1450 (/course/195614/spanish-nouns-5/145/)	
la plántula	seedling
(el)(la) absolutista	absolutist
la afroamericana	African American
el agárico	agaric
los anfípodos	amphipods
las anacardiáceas	Anacardiaceae
el anglicano	Anglican
el araucano	Araucan
(el)(la) archivista	archivist
las arqueadas	arcuate
*** 1451 - 1460 (/course/195614/spanish-nouns-5/146/)	
el ateo	atheist
el machetero	axer
el bacteriófago	bacteriophage
el batracio	batrachian
el aletazo	"beat of the fin, wingbeat"
la berma	"berm, shoulder, roadside"
el sombrerazo	big hat
la palanquilla	billet
la galletera	biscuit
(el)(la) bonapartista	Bonapartist
*** 1471 - 1480 (/course/195614/spanish-nouns-5/147/)	
las crismeras	chrismatories
los acianos	"cockatrice, bachelor's button"
el congregante	congregant
el copépodo	copepod
el coriza	coryza
la ladilla	crab louse
la manualidad	craft
las crasuláceas	crassulacean
(el)(la) criminalista	criminalist
(el)(la) vil	cur
*** 1461 - 1470 (/course/195614/spanish-nouns-5/148/)	
los rebotadores	bouncers
las bromeliáceas	bromeliads
la chocarrería	buffoonery
la marrullería	"cajolery, cajolement"
la cántiga	Cantiga
la carretada	cartload
(el)(la) célibe	celibate
el certificador	certifier
el fletador	charterer
el chocolatero	chocolatier
*** 1481 - 1490 (/course/195614/spanish-nouns-5/149/)	
el curie	curie
la monería	cuteness
los lacticinios	dairy products
el colgador	dangler
la desalentadora	daunting
los cazatorpederos	destroyers
el digesto	digest
la diócesi	Diocese
el turbador	disturber
(los)(las) donatistas	Donatists
*** 1491 - 1500 (/course/195614/spanish-nouns-5/150/)	
el palero	drainer
el epicedio	epicede
el ergio	erg
los euriptéridos	eurypterids
el falconete	falconet
los falleros	Fallas
el quinceañero	fifteen
las flageladas	flagellate
(el)(la) frutal	fruit tree
los financiadores	funders
*** 1501 - 1510 (/course/195614/spanish-nouns-5/151/)	
el acotado	game preserve
el gonococo	gonococcal
las gorgonias	gorgonians
el saludador	greeter
la hacanea	hackney
la cefalalgia	headache
la helmintiasis	helminthiasis
la secuestradora	"hijacker, kidnapper, abductor"
la melosa	honeyed
el carpe	hornbeam
*** 1511 - 1520 (/course/195614/spanish-nouns-5/152/)	
los equisetos	horsetails
las liliáceas	Hostas
el himnario	"hymnal, hymnbook"
el hipocondrio	hypochondrium
la entretela	"interlining, wadding, backing"
los tornasolados	iridescent
(los)(las) islamitas	Islamists
el gorrón	"journal, pivot, sponger"
la botonera	keypad
los kilovoltios	kilovolts
*** 1521 - 1530 (/course/195614/spanish-nouns-5/153/)	
la laceración	laceration
la ponchada	"large amount, bowlful of punch"
las lesionadas	lesioned
las lupercales	Lupercalia
la lustración	lustration
el maniqueo	"Manichaean, extremist"
(los)(las) maristas	Marist
la meningoencefalitis	meningoencephalitis
el metalúrgico	"metalworker, metallurgist"
la microficha	microfiche
*** 1531 - 1540 (/course/195614/spanish-nouns-5/154/)	
(el)(la) moabita	Moabite
el mocasín	"moccasin, loafer"
la importunación	molestation
la montada	mounted
los mozambiqueños	Mozambican
el asaltador	mugger
la basca	"nausea, feeling of sickness, queasy feeling"
(el)(la) nazarí	Nazari
la nereida	nereid
las oblatas	Oblate
*** 1571 - 1580 (/course/195614/spanish-nouns-5/155/)	
el pesquisidor	"searching, inquiry"
(el)(la) semivocal	semivowel
la tija	shank
el jarrete	shin
los pantaloncillos	shorts
el plateado	silver-plating
el picatoste	sippet
(el)(la) quitanieves	"snowplow, snowplough"
el solicitador	solicitor
el sud	south
*** 1541 - 1550 (/course/195614/spanish-nouns-5/156/)	
los odontocetos	odontocetes
la empaquetadora	"packing, gasket"
el álabe	paddle
(el)(la) buscapersonas	pager
el palé	pallet
las alverjas	peas
la fanerógama	phanerogam
(los)(las) filipenses	Philippians
el fotolito	photolith
(el)(la) fisonomista	physiognomist
*** 1551 - 1560 (/course/195614/spanish-nouns-5/157/)	
la torrija	piece of French toast
la porqueriza	"pigsty, piggery"
la tocada	played
(los)(las) puntillistas	pointillist
los pontoneros	pontoneers
el garlito	pound
(el)(la) progresista	"progressive, progressist"
los promovedores	promoters
el prosélito	proselyte
(el)(la) protestante	Protestant
*** 1561 - 1570 (/course/195614/spanish-nouns-5/158/)	
la publicadora	publisher
la pugnacidad	pugnacity
la ferroviaria	railway
el escariador	reamer
los remadores	rowers
el gomero	rubber tree
los salmónidos	salmonids
el sanctasanctórum	"sanctum, sanctum sanctorum"
el fular	scarf
los escifozoos	scyphozoans
*** 1581 - 1590 (/course/195614/spanish-nouns-5/159/)	
las nalgadas	spanking
el voceras	spokeswomen
los aliñados	sprinkled
el remilgo	"squeamishness, primness, complaint"
los dares	standards
(el)(la) huelguista	"striker, picket"
(el)(la) estructuralista	structuralist
el subcontrato	subcontract
el súcubo	succubus
(el)(la) suplicante	suppliant
*** 1601 - 1610 (/course/195614/spanish-nouns-5/160/)	
(los)(las) lazaristas	Vincentians
(los)(las) belicistas	warmongers
las cereras	wax-makers
los jerónimos	we jerónimos
el zurriagazo	Zurriagazo
la afgana	Afghan
el moledor	grinder
el boxer	boxer
la cartógrafa	"cartographer, mapmaker"
el escualo	dogfish
*** 1591 - 1600 (/course/195614/spanish-nouns-5/161/)	
el liguero	"suspender belt, garter belt"
las tangaras	tanagers
la gacha	"thin paste, slops"
los remontados	traced
la transaminasa	transaminase
la agachada	"trick, trickery, duck"
el alborotador	"troublemaker, brawler"
la cercha	truss
la ramilla	twig
los urocordados	urochordates
*** 1611 - 1620 (/course/195614/spanish-nouns-5/162/)	
la chapucera	bungler
la doctoranda	PhD
la fabricadora	fabricator
la geógrafa	geographer
el bisoñé	toupee
la rosarina	Rosario
la tecnóloga	technologist
la tibetana	Tibetan
la vasalla	vassal
la aleya	verse
*** 1631 - 1640 (/course/195614/spanish-nouns-5/163/)	
la actinolita	actinolite
el agarrador	gripper
la aguileña	"columbine, aquilegia"
el ahuecamiento	cupping
la albacora	albacore
el alcoholímetro	"breathalyser, alcoholometer"
el alfilerillo	Brad
la algoritmia	algorithmics
el amigacho	PAL
el amperaje	amperage
*** 1621 - 1630 (/course/195614/spanish-nouns-5/164/)	
(el)(la) imponente	depositor
el búlgaro	Bulgarian
el checoslovaco	Czechoslovak
el comprometedor	compromising
el desdentado	toothless
el isabelino	Elizabethan
el jactancioso	"boaster, braggart"
el otomano	Ottoman
la centroeuropea	Central European
la nipona	Japanese
*** 1671 - 1680 (/course/195614/spanish-nouns-5/165/)	
la cobalamina	cobalamin
la cobradora	"conductress, clippie"
el colinabo	"kohlrabi, swede"
el collie	collie
la colocasia	taro
la colostomía	colostomy
el compensador	compensator
la conjugada	conjugated
(el)(la) consistorial	town hall
la constructividad	constructiveness
*** 1641 - 1650 (/course/195614/spanish-nouns-5/166/)	
el anapesto	"anapaest, anapest"
la anglofobia	Anglophobia
la apendicectomía	appendectomy
la aquilea	Achilles
la aramea	Aramaic
la arduidad	arduousness
el arrastramiento	"crawl, shuffling"
el arseniato	arsenate
(el)(la) asonante	"assonant, vowel rhyme"
la astrolatría	astrolatry
*** 1681 - 1690 (/course/195614/spanish-nouns-5/167/)	
el corralillo	"corral, pen, playpen"
la corruptibilidad	corruptibility
el corselete	corselet
el cortadillo	"lump, small glass"
la cosecante	cosecant
la criolita	cryolite
la crisopeya	Crisopeya
el cronólogo	chronologer
la cursilada	corny
la declividad	declivity
*** 1651 - 1660 (/course/195614/spanish-nouns-5/168/)	
la atestación	attestation
el aumentativo	augmentative
el automedonte	Automedon
el azolve	"sediment, deposit"
el biftec	steak
el braguero	"truss, brace"
el braguetazo	marriage for money
el buldog	bulldog
el cardiograma	cardiogram
la cataplexia	cataplexy
*** 1661 - 1670 (/course/195614/spanish-nouns-5/169/)	
la cefalosporina	cephalosporin
el cencerreo	"jangle, tinkling, tinkle"
la censuradora	censorious
el cepellón	rootball
el cheviot	"tweed, cheviot"
el chillón	"small nail, panel pin, moaner"
el ciclopropano	cyclopropane
el cidro	"citron, citrus"
(el)(la) citarista	sitar
el clueco	broody
*** 1691 - 1700 (/course/195614/spanish-nouns-5/170/)	
el decúbito	decubitus
el desbridamiento	debridement
la desconsoladora	distressing
la descontinuación	discontinuation
el descote	Descote
el desenredo	disentanglement
la desinsectación	disinfestation
el desmotado	ginned
el despeño	plunged
el despiezo	exploded
*** 1711 - 1720 (/course/195614/spanish-nouns-5/171/)	
el enfurruñamiento	sulk
la enmascarada	masked
el enturbiamiento	cloud
la escoda	bushhammer
el espónsor	sponsor
el estatuderato	stadtholdership
la estereotomía	sternotomy
el estrobo	strobe
el estucador	plasterer
el europio	europium
*** 1701 - 1710 (/course/195614/spanish-nouns-5/172/)	
el despique	debeak
el desposeimiento	dispossession
el destapador	opener
el destripamiento	disembowelment
la diaconisa	deaconess
la discontinuación	"discontinuation, discontinuance"
la disformidad	warp
el disprosio	dysprosium
el dosímetro	dosimeter
el enardecimiento	inflaming
*** 1721 - 1730 (/course/195614/spanish-nouns-5/173/)	
la exnovia	Ex-Girlfriend
el fagocito	phagocyte
el falopio	tubes
el farfán	Farfan
el folletito	pamphlet
el fonólogo	phonologist
la formalina	formalin
la freidora	"deep-fryer, electric fryer"
la fulanita	twinkie
la gachí	"skirt, doll, bird"
*** 1731 - 1740 (/course/195614/spanish-nouns-5/174/)	
el gafete	badge
el galeoto	Galeotti
la galla	"bird, girl"
el gambiano	Gambian
la gammaglobulina	gammaglobulin
(el)(la) generalista	generalist
la giberelina	gibberellin
la gonadotrofina	gonadotrophin
el gotoso	gouty
la guirlanda	garland
*** 1741 - 1750 (/course/195614/spanish-nouns-5/175/)	
el heptágono	heptagon
el hexagrama	hexagram
el hipocorístico	"pet name, affectionate form"
la hondureña	Honduras
el ibicenco	Ibiza
la incongruidad	incongruity
la inexpugnabilidad	impregnability
la interficie	interfacing
la josa	advantageous
la legra	"scoop, scraper"
*** 1751 - 1760 (/course/195614/spanish-nouns-5/176/)	
la libertina	libertine
el librador	drawer
la limosnera	beggar
el machote	tough guy
la mahonesa	mayonnaise
la maloclusión	malocclusion
el mamey	"mammee, mamee, mamey"
la mamoplastia	mammoplasty
la mandarria	sledgehammer
el mariposeo	fluttering
*** 1761 - 1770 (/course/195614/spanish-nouns-5/177/)	
el mendelevio	mendelevium
la mendiguez	beggary
el mesotrón	mesotron
el metacentro	metacentre
la metida	"putting, insertion"
el metomentodo	busybody
la microinformática	microcomputers
el microsurco	microgroove
la minicámara	mini camera
la minicomputadora	minicomputer
*** 1771 - 1780 (/course/195614/spanish-nouns-5/178/)	
(el)(la) mistral	mistral
el monomaníaco	monomaniac
la mundanalidad	worldliness
el necrófilo	"necrophile, necrophiliac"
el negrón	scoter
el neocatolicismo	neo-Catholicism
la nesciencia	nescience
el nietecito	grandson
el numismático	numismatist
el nutrimiento	nurturing
*** 1781 - 1790 (/course/195614/spanish-nouns-5/179/)	
el oftalmoscopio	ophthalmoscope
la oriundez	"ancestry, and"
el orozuz	licorice
el pamplonés	Pamplona
la papaverina	papaverine
el pastón	Paxton
el pedantismo	"pedantism, pedanticism"
el peñazo	Peñaza
el pentateuco	Pentateuch
la perceptibilidad	perceptibility
*** 1791 - 1800 (/course/195614/spanish-nouns-5/180/)	
el periodicucho	rag
el periquín	Periquín
la perspicuidad	perspicuity
el persuasor	persuader
el pesillo	assay balance
la plancheta	planchet
la plantadora	planter
la plebeyez	plebeian
la polifagia	polyphagia
la políglota	"polyglot, linguist"
*** 1801 - 1810 (/course/195614/spanish-nouns-5/181/)	
la popelina	poplin
el portafusil	sling
la primeriza	gilt
la propagadora	propagator
el propino	propyne
la prorrata	"division, split, share"
el protio	protium
el prurigo	prurigo
el psicrómetro	psychrometer
el publirreportaje	infomercial
*** 1811 - 1820 (/course/195614/spanish-nouns-5/182/)	
la pudicicia	"pudicity, pudency"
la pulseada	wrestling
el quincenario	fortnightly
el quintín	Quentin
la radioayuda	navaid
la radioscopia	radioscopy
la reprobadora	reproving
el rimador	"rhymer, rhymester"
la riñonada	chines
la saloma	"chantey, shanty, chanty"
*** 1821 - 1830 (/course/195614/spanish-nouns-5/183/)	
la sanjuanada	Sanjuanada
la serviola	cathead
el sesquicentenario	sesquicentennial
la siderita	siderite
la siringe	syrinx
el socaire	lee
el sofismo	"sophism, casuistry, quip"
la solanina	solanine
el solazo	scorching sun
el solito	alone
*** 1831 - 1840 (/course/195614/spanish-nouns-5/184/)	
el somorgujo	loon
la sorpresita	surprise
la sovietización	Sovietization
el subarrendamiento	sublease
la subcampeona	runners
la suberina	suberin
(el)(la) subintendente	superintendent
la subyugadora	subduing
el súmmum	acme
el superrealismo	superrealism
*** 1841 - 1850 (/course/195614/spanish-nouns-5/185/)	
(el)(la) suricata	meerkat
el telesquí	ski-lift
la termoclina	thermocline
el tetrámero	tetramer
el tingladillo	clinker
la tiroglobulina	thyroglobulin
el tontorrón	"dink, dimwit"
la tortillera	"dyke, dike, lesbian"
el trabuquete	trebuchet
el tragacanto	tragacanth
*** 1861 - 1870 (/course/195614/spanish-nouns-5/186/)	
el empaquetador	packer
el vericueto	rough path
(el)(la) dietista	dietician
el veintidós	"twenty-two, twenty-second"
el veintitrés	"twenty-three, twenty-third"
el caraqueño	Caracas person
la administrada	administered
(el)(la) adoptante	adopter
los lejitos	afar
(los)(las) africanistas	Africanists
*** 1851 - 1860 (/course/195614/spanish-nouns-5/187/)	
el trastrocamiento	reversal
la trioleína	triolein
la trombosis	thrombosis
el tumbadillo	cuddy
el tutu	ballet skirt
el uretano	urethane
el ventoso	burglar
la vírgula	virgule
(el)(la) yudoca	judoka
el retrógrado	"retrograde, stuffy"
*** 1871 - 1880 (/course/195614/spanish-nouns-5/188/)	
el exalumno	alumnus
la amarilis	amaryllis
(el)(la) anabaptista	Anabaptist
los anostráceos	anostraceans
los arahuacos	Arawaks
el arboricultor	arborist
el artejo	article
(los)(las) asociales	asocial
el ateles	ateles
la chirla	baby clam
*** 1881 - 1890 (/course/195614/spanish-nouns-5/189/)	
la empacadora	baler
los bisayos	Bisayan
el blocao	blockhouse
los bombachos	bloomers
el ensalmador	"bonesetter, quack"
el trinquis	boose
los patucos	booties
la internada	"break, breakaway"
los briófitos	bryophytes
la galga	"burial platform, rash, yellow ant"
*** 1891 - 1900 (/course/195614/spanish-nouns-5/190/)	
el antropófago	"cannibal, anthropophagite"
los capadocios	Cappadocian
la carantoña	"caress, buttering up, blandishment"
el redaño	caul
los tajadores	choppers
el cromóforo	chromophore
el crisólito	chrysolite
el circasiano	Circassian
(los)(las) civilistas	Civilistas
los coacusados	codefendants
*** 1901 - 1910 (/course/195614/spanish-nouns-5/191/)	
la coetánea	coeval
la coña	coif
el columbario	columbarium
el coheredero	coparcener
el copartidario	copartisan
(los)(las) cris	creese
los baldados	crippled
las crucíferas	cruciferous
(el)(la) conquense	Cuenca
la cultivadora	cultivator
*** 1911 - 1920 (/course/195614/spanish-nouns-5/192/)	
el expendedor	"dealer, retailer"
el dialogismo	dialogism
el diplococo	diplococcus
la desamortizadora	disentailment
el diurético	diuretic
la chupada	"drag, pull, suck"
la cajonera	drawers
las chorreaduras	drippings
(el)(la) dualista	dualist
los idumeos	Edomites
*** 1921 - 1930 (/course/195614/spanish-nouns-5/193/)	
los briones	embryos
el empírico	"empiric, empiricist"
la encefalomielitis	encephalomyelitis
la endorfina	endorphin
el epiciclo	epicycle
el équido	equine animal
el escalope	"escalope, scallop, escallop"
(los)(las) etimologistas	etymologists
el ejemplario	EXEMPLARY
el formante	formant
*** 1931 - 1940 (/course/195614/spanish-nouns-5/194/)	
la estantigua	"fright, apparition, thing"
la ñoñería	"fussiness, shyness, insipidness"
la galeaza	galleass
el acopiador	gatherer
(el)(la) carcamal	geezer
el guardamonte	guard
la gomorresina	gum rosin
el agareno	Hagrite
los semipesados	heavyweight
el helicón	helicon
*** 1941 - 1950 (/course/195614/spanish-nouns-5/195/)	
el henrio	henry
(el)(la) heraldista	"heraldist, armourist, armorist"
las heroidas	Heroides
los chupetones	hickeys
la hipotiposis	hypotyposis
los iranios	Iranians
el sota	"jack, knave"
la gramola	jukebox
la kilocaloría	kilocalorie
los kilolitros	kiloliters
*** 1951 - 1960 (/course/195614/spanish-nouns-5/196/)	
el kilotón	kiloton
el lantánido	lanthanide
(el)(la) latinista	Latin scholar
el leccionario	lectionary
el lebrato	leveret
(el)(la) liliputiense	lilliputian
la lunación	lunation
los lujuriosos	lustful
el lírico	lyrist
el macarrón	"macaroon, sheath, sleeve"
*** 1961 - 1970 (/course/195614/spanish-nouns-5/197/)	
(el)(la) malgache	madagascan
las majuelas	Majuelas
los maltusianos	Malthusians
los mamposteros	masons
los masoretas	Massoretes
la meninge	meninges
el menstruo	"menses, menstruation"
(el)(la) metalurgista	metallurgist
(el)(la) metodista	Methodist
la desorientadora	misleading
*** 1971 - 1980 (/course/195614/spanish-nouns-5/198/)	
los monotipos	monotypes
las mutiladas	mutilated
el amotinado	"mutineer, rioter"
el nanosegundo	nanosecond
(el)(la) naturista	naturist
el nautilo	"nautilus, pearly nautilus"
(los)(las) neutralistas	neutralist
la liendre	nit
el ocelo	ocellus
el octosílabo	"octosyllabic, octosyllable"
*** 1981 - 1990 (/course/195614/spanish-nouns-5/199/)	
el disyuntor	on-off switch
la onicomicosis	onychomycosis
la operada	operated
(el)(la) sobresaliente	"outstanding, distinction"
los canaletes	paddles
(el)(la) libelista	pamphleteer
el partisano	partisan
el paternóster	paternoster
las mondaduras	peelings
las pernetas	Pernetas
*** 1991 - 2000 (/course/195614/spanish-nouns-5/200/)	
el perojo	Perojo
las obvenciones	perquisites
las piperáceas	piperaceae
la faneca	pout
los pozancos	Pozancos
(el)(la) preceptista	preceptist
los premonitores	premonitory
los prensadores	pressers
los procordados	Prochordates
el profiláctico	"prophylactic, condom"
*** 2001 - 2010 (/course/195614/spanish-nouns-5/201/)	
los cuasicontratos	quasi
el quídam	Quidam
los radiolarios	radiolarians
el reciario	retiarius
los rotíferos	rotifers
la salvilla	"salver, cruet"
el marés	"sea, ocean"
el sellador	sealant
la selenita	selenite
el semiconductor	semiconductor
*** 2011 - 2020 (/course/195614/spanish-nouns-5/202/)	
el servomotor	servomotor
los sextillizos	sextuplets
el corista	showgirl
(el)(la) feriante	showman
la eslava	"Slav, Slavic, Slavonic"
las despabiladeras	snuffers
(los)(las) sudistas	Southerners
(los)(las) rigoristas	sticklers
las paladas	strokes
el incontrolado	"strong-arm man, violent person"
*** 2021 - 2030 (/course/195614/spanish-nouns-5/203/)	
los domingueros	sunday
el empollón	"swot, grind, wonk"
las sinodales	Synod
el siracusano	Syracusan
(los)(las) tanquistas	tankers
el tétano	tetanus
el teutón	Teuton
el hambriento	"the hungry, the starving, hungry people"
(los)(las) tesalonicenses	Thessalonians
el breñal	thicket
*** 2031 - 2040 (/course/195614/spanish-nouns-5/204/)	
el treintañero	thirtysomething
los trilladores	threshers
(el)(la) tolteca	Toltec
el tóxico	"toxic, poison, toxin"
la vagabunda	"tramp, vagabond, wanderer"
los teucros	Trojans
el turcomano	Turkmen
los insubordinados	unruly
los úrsidos	ursids
el gofre	waffle
*** 2041 - 2050 (/course/195614/spanish-nouns-5/205/)	
(el)(la) sionista	Zionist
el zuavo	Zouave
la aduladora	"flatterer, bootlicker"
la obispa	bishop
el mediero	sharecropper
la cananea	Canaanite
el morueco	ram
la checoslovaca	Czechoslovak
la deformadora	deforming
la dictadora	dictator
*** 2051 - 2060 (/course/195614/spanish-nouns-5/206/)	
el coala	koala
la neoclásica	neoclassical
la oceanógrafa	oceanographer
la peruana	Peruvian
la recoleta	Recollect
la sexagenaria	sexagenarian
la sudamericana	South American
la tapicera	upholsterer
la teóloga	theologian
el adivinador	diviner
*** 2061 - 2070 (/course/195614/spanish-nouns-5/207/)	
la barbada	bearded
el barcelonés	from Barcelona
el dulcero	confectioner
la endibia	"chicory, endive"
el frambueso	raspberry
el hispanoamericano	Spanish American
el maldecido	damned
el zancudo	mosquito
el recoleto	Recollect
el removimiento	removal
*** 2071 - 2080 (/course/195614/spanish-nouns-5/208/)	
el tísico	consumptive
el wagneriano	Wagnerian
la detenida	"detainee, prisoner"
el nipón	Japanese
el abadiato	abbacy
la abscisión	abscission
la acedía	heartburn
la acerbidad	acerbity
el acoplador	coupler
la advenediza	"upstart, parvenu"
*** 2081 - 2090 (/course/195614/spanish-nouns-5/209/)	
la afrentosa	outrageous
la aguardada	awaited
la albita	albite
el andrógeno	androgen
la anglofilia	Anglophilia
el anglófilo	Anglophil
el antiferromagnetismo	antiferromagnetism
la apoderada	"attorney, agent, proxy"
el apretamiento	tightening
el apropiador	appropriator
*** 2091 - 2100 (/course/195614/spanish-nouns-5/210/)	
la armenia	Armenia
la armuelle	orach
el arrugamiento	wrinkling
el aserrador	sawyer
el asuntito	little matter
(el)(la) atlantista	Atlanticist
la autogamia	autogamy
el autopiloto	autopilot
la azadilla	Azadilla
la balneoterapia	balneotherapy
*** 2101 - 2110 (/course/195614/spanish-nouns-5/211/)	
la báltica	Baltic
el báratro	Barathrum
la barriguilla	Barriguilla
el barrueco	baroque pearl
la batalladora	feisty
el baturrillo	"hodgepodge, gallimaufry, hotchpotch"
el bencilo	benzyl
el blastómero	blastomere
la bofia	"the fuzz, heat"
la boyada	drove of oxen
*** 2121 - 2130 (/course/195614/spanish-nouns-5/212/)	
el caravasar	caravanserai
el cárcamo	sump
la catecolamina	catecholamine
el cateo	"prospect, fail, search"
el cauri	cowrie
la celestina	"go-between, matchmaker, celestine"
la céltica	Celtic
la cerusa	White Lead
la chamusquina	singe
el chantillí	Chantilly
*** 2141 - 2150 (/course/195614/spanish-nouns-5/213/)	
el criptón	krypton
el cuadrángulo	"quad, quadrangle"
el cuaquerismo	Quakerism
la culpada	blamed
la dactilografía	dactylography
(el)(la) darwinista	Darwinian
el deanato	deanery
el derechismo	rightism
la dermatóloga	dermatologist
el derribador	Grounding
*** 2111 - 2120 (/course/195614/spanish-nouns-5/214/)	
el broncodilatador	bronchodilator
la buhonería	peddling
la bullabesa	"bouillabaisse, fish soup"
el buteno	butene
el caballaje	horsepower
el cabrahígo	Cabrahigo
la cachava	Cachava
la calabacita	zucchini
el canesú	yoke
la cangreja	spanker
*** 2131 - 2140 (/course/195614/spanish-nouns-5/215/)	
el churumbel	samophlange
el cinerama	cinerama
el cochinito	pig
el colutorio	mouthwash
el comedorcito	dinette
la compaginada	collated
el compaginador	sorter
la confidenta	confidante
el conoide	conoid
la copta	Coptic
*** 2151 - 2160 (/course/195614/spanish-nouns-5/216/)	
el desalojamiento	"displacement, eviction"
el descamino	embezzlement
la descastada	outcast
el descuaje	uprooting
el desencaje	disengagement
el deshacedor	undoer
la despistada	clueless
la desterrada	banished
la diastasa	diastase
la dimisionaria	resigning
*** 2161 - 2170 (/course/195614/spanish-nouns-5/217/)	
la dipsomanía	dipsomania
el dóberman	dobermans
el donatismo	Donatism
el dórico	Doric
la electroacústica	electroacoustics
el electuario	electuary
el encenagamiento	siltation
el encorvamiento	droop
el engrasador	nipple
el engullidor	guzzling
*** 2171 - 2180 (/course/195614/spanish-nouns-5/218/)	
el ensilaje	silage
el ensordecimiento	devoicing
el erico	Erico
la escanciadora	cupbearer
el espray	spray
la estala	Estala
la estimativa	estimate
la estólida	stolid
la evocadora	evocative
el exnovio	ex-boyfriend
*** 2181 - 2190 (/course/195614/spanish-nouns-5/219/)	
el extravertido	extrovert
(el)(la) fagotista	bassoonist
la falsificadora	"counterfeiter, forger"
el fibrocartílago	fibrocartilage
la filarmonía	philharmonic orchestra
la fitohormona	phytohormone
el fluoroscopio	fluoroscope
el fotomatón	photobooth
(el)(la) fumista	"joker, stove repairman"
la gallinaza	manure
*** 2191 - 2200 (/course/195614/spanish-nouns-5/220/)	
la gandulería	"idleness, dodgery"
el garrafón	demijohn
la griseofulvina	griseofulvin
la herniación	herniation
el hidrargirismo	hydrargirism
el hipogastrio	hypogastrium
la hiponimia	hyponymy
el holoceno	Holocene
el hospitalillo	small hospital
la incomunicabilidad	inability to communicate
*** 2201 - 2210 (/course/195614/spanish-nouns-5/221/)	
la inculpada	accused
el indecoro	"indecorum, indelicacy"
la induración	induration
la inefabilidad	ineffability
la infructuosidad	fruitlessness
la inhospitalidad	inhospitality
(el)(la) intimista	intimate
la irisación	"iridescence, irisation"
el izquierdazo	left hook
la jaulita	little cage
*** 2211 - 2220 (/course/195614/spanish-nouns-5/222/)	
la labradorita	moonstone
la lacaya	Lucaya
la lacha	menhaden
la ladronzuela	thief
el largor	Waistline
el laringoscopio	laryngoscope
la lepisma	silverfish
la litigación	litigation
el llevador	courier
la maletera	"boot, trunk, saddlebag"
*** 2221 - 2230 (/course/195614/spanish-nouns-5/223/)	
la mancheta	masthead
la maneta	handle
(el)(la) maoísta	Maoist
el marañón	"cashew, cashew nut"
la maricona	"queer, fagot, fag"
el matraqueo	rattling
(el)(la) mecanicista	mechanistic
el medianero	"dividing wall, party wall"
el mendelismo	Mendelianism
la mercera	mercer
*** 2231 - 2240 (/course/195614/spanish-nouns-5/224/)	
la mesocracia	mesocracy
el metimiento	downthrow
(el)(la) minimalista	minimalist
la minusvalidez	disability
el mitrado	mitred
la mocosita	Mocosita
el monedaje	seigniorage
el mongolismo	mongolism
el mueblecito	piece of furniture
el muesli	muesli
*** 2241 - 2250 (/course/195614/spanish-nouns-5/225/)	
la multiconferencia	conference
el negligé	negligee
el olorcito	"smell, odour, scent"
la ortofonía	audiologists
la otología	otology
la paleobotánica	paleobotany
el panóptico	panopticon
el papayo	"papaya, pawpaw, papaw"
la paralizadora	Paralytic
la parmesana	parmigiana
*** 2251 - 2260 (/course/195614/spanish-nouns-5/226/)	
la pegajosidad	stickiness
la perdonadora	forgiving
el peristoma	peristome
el perseguimiento	chasing
la pescozada	Pescozada
la pignoración	pledge
el pizzero	pizza maker
la platónica	Platonic
el polarímetro	polarimeter
el polímetro	multimeter
*** 2261 - 2270 (/course/195614/spanish-nouns-5/227/)	
(el)(la) polvorista	Polvorista
la poncha	strikes out
(el)(la) potril	Potril
el preuniversitario	Foundation Degree
la propiciadora	propitiating
la pudinga	pudding stone
el queque	"cake, bun"
la quimosina	chymosin
la ramplonería	vulgarity
el reentrenamiento	retraining
*** 2271 - 2280 (/course/195614/spanish-nouns-5/228/)	
el relajador	relaxant
el rematante	highest bidder
la remediadora	remedial
el ristre	lance-rest
el romboedro	rhombohedron
el rotograbado	rotogravure
la rubicundez	ruddiness
el sabelio	Sabellius
el salicor	saltwort
la santurrona	sanctimonious
*** 2281 - 2290 (/course/195614/spanish-nouns-5/229/)	
la sectaria	sectarian
la sembrada	planted
el semidiámetro	semidiameter
el sequito	"retinue, entourage, train"
la serosidad	serosity
la silogística	syllogistic
el sobregiro	"overdraft, over-rotation"
la subnormalidad	subnormality
el supino	supine
el tantán	tom-tom
*** 2291 - 2300 (/course/195614/spanish-nouns-5/230/)	
(el)(la) taoísta	Taoist
el tarará	tared
la tecnicidad	technicality
(el)(la) telecámara	video unit
el termoscopio	thermoscope
la timadora	grifter
el tiradero	"shooting range, rubbish dump, garbage dump"
la tiritona	shivering
la tonificación	toning
el torón	strand
*** 2301 - 2310 (/course/195614/spanish-nouns-5/231/)	
la tortuguita	turtle
el traslapo	"overlap, lap"
la trinquetilla	staysail
la tuerta	eyed
el ugarítico	Ugaritic
el ungimiento	anointment
la untuosidad	greasiness
la vicaria	vicarious
la vincapervinca	periwinkle
el viscosímetro	viscometer
*** 2311 - 2320 (/course/195614/spanish-nouns-5/232/)	
la vociferación	vociferation
el volterianismo	Voltairianism
el wáter	"toilet, closet, john"
el zapapico	"pickax, pickaxe"
el plumífero	"quilted anorak, hack"
la guarrería	"filthy thing, filth"
el atravesado	troublemaker
la gestante	expectant mother or woman
el portamaletas	"roof rack, boot, trunk"
el enceste	basket
*** 2331 - 2340 (/course/195614/spanish-nouns-5/233/)	
el anélido	annelid
los antiandrógenos	antiandrogens
la aracnoides	arachnoid
el ario	Aryan
el asperges	asperges
la tasadora	"assessor, appraiser"
las azarías	Azariah
los baltos	Balts
el zambombazo	bang
el raquero	beachcomber
*** 2351 - 2360 (/course/195614/spanish-nouns-5/234/)	
los briozoos	bryozoans
el carapacho	carapace
las carnívoras	carnivorous
las carocas	Carocas
los carolinos	Carolinians
las escolopendras	centipedes
los cefalocordados	Cephalochordata
el impugnador	Challenger
(los)(las) chovinistas	chauvinists
el quitón	chiton
*** 2321 - 2330 (/course/195614/spanish-nouns-5/235/)	
la estacha	"line, mooring rope"
la abdominal	"abdominals, crunches, six-pack"
el encubridor	accessory after the fact
(el)(la) adventista	Adventist
la africada	affricate
los alfonsinos	Alfonsists
(el)(la) americanista	Americanist
la analítica	analytics
la anfractuosidad	anfractuosity
los angiomas	angioma
*** 2341 - 2350 (/course/195614/spanish-nouns-5/236/)	
las chumaceras	bearings
la cabilla	belaying pin
la mutua	benefit society
(los)(las) estraperlistas	black marketeers
el echador	"boaster, ejector"
(los)(las) obligacionistas	bondholders
(el)(la) pelotilla	bootlicking
el borato	borate
los braquiópodos	brachiopods
el clavito	brad
*** 2361 - 2370 (/course/195614/spanish-nouns-5/237/)	
el clinch	clinch
el cadillo	cocklebur
el acomplejado	complexed
el corporal	"corporal, altar cloth"
la corticoide	corticoid
la corveta	corvette
los áulicos	courtiers
el rajado	"coward, chicken"
la resquebrajadura	crazing
las criptógamas	cryptogams
*** 2371 - 2380 (/course/195614/spanish-nouns-5/238/)	
el entresacado	culled
las cupresáceas	Cupressaceae
los rizadores	curlers
la parroquiana	"customer, habitue, regular"
(los)(las) dálmatas	Dalmatian
las datileras	date palm tree
las desafinaciones	detuning
el badén	"dip, ditch, ford"
el mantelito	doily
el dominguillo	Dominguillo
*** 2381 - 2390 (/course/195614/spanish-nouns-5/239/)	
el bebedero	"drinking fountain, water fountain, water trough"
los abejones	drones
el druso	"druse, druze"
la dríade	Dryad
el eclesiastés	Ecclesiastes
el malversador	"embezzler, peculator"
(el)(la) empirista	empiricist
el epinicio	epinicion
el ético	ethics
el excavador	"excavator, digger"
*** 2391 - 2400 (/course/195614/spanish-nouns-5/240/)	
la excoriación	"excoriation, chafing"
los expectorantes	expectorants
los cetreros	falconers
el felón	felon
el guardafuego	"fender, fireguard"
el apaleador	Flogger
la folía	Folia
(el)(la) formalista	formalist
el fornicador	fornicator
los fornicarios	fornicators
*** 2401 - 2410 (/course/195614/spanish-nouns-5/241/)	
la echadora	fortune teller
el gabacho	"Frenchy, frog, froggy"
los frisios	friesians
el gallón	gallon
la genovesa	Genoese
(el)(la) gentil	gentile
el jerbo	gerbil
el gargajo	"gob, phlegm, sputum"
el orífice	goldsmith
el universitario	"graduate, academic"
*** 2411 - 2420 (/course/195614/spanish-nouns-5/242/)	
el herbazal	grassland
el ultramarinos	"groceries, grocery store"
los asteros	hastati
los hemípteros	Hemiptera
las esperanzadoras	hopeful
la callosa	horny
los ictiosaurios	ichthyosaurs
el igualadino	Igualada
los inmunosupresores	immunosuppressive
la importadora	importing
*** 2421 - 2430 (/course/195614/spanish-nouns-5/243/)	
la improvisadora	improviser
la tomada	inroad
el iroqués	Iroquois
el jíbaro	Jivaro
la vigueta	joist
el guasón	"joker, teaser, jester"
el remolón	"lagger, skulk, laggard"
la embustera	"liar, cheat, fabricator"
la linfangitis	lymphangitis
el maléolo	malleolus
*** 2431 - 2440 (/course/195614/spanish-nouns-5/244/)	
los mangueros	mangeros
(el)(la) anormal	"mentally hadicapped, retard"
la microcámara	microchamber
la cuarentona	middle-aged man
(el)(la) militarista	militarist
los minadores	miners
la incomprendida	misunderstood
el monstruito	monster
los montevideanos	Montevideo
la colmenilla	morel
*** 2441 - 2450 (/course/195614/spanish-nouns-5/245/)	
la papera	mumps
(el)(la) mutualista	mutual
los noveleros	novelero
(el)(la) oscurantista	obscurantist
el ocupador	occupier
el balconaje	of balconies
los ancianitos	old people
el opistótonos	opisthotonos
(los)(las) oposicionistas	oppositional
los oratorianos	Oratory
*** 2451 - 2460 (/course/195614/spanish-nouns-5/246/)	
los tomacorrientes	outlets
(el)(la) pacifista	pacifist
el palmero	palmer
(el)(la) panteísta	pantheist
los parapléjicos	paraplegic
los pelagianos	Pelagians
el rábula	pettifogger
(los)(las) plutócratas	plutocrats
el pólux	Pollux
los poríferos	Porifera
*** 2461 - 2470 (/course/195614/spanish-nouns-5/247/)	
el vaticinador	predictor
el aguijonazo	prick
(los)(las) antiabortistas	Pro-Life
la alzaprima	prying
la psitacosis	"psittacosis, parrot disease, parrot fever"
el pómez	pumice
las punturas	punctures
los persevantes	pursuivants
los picnogónidos	pycnogonids
los cuatrillizos	quadruplets
*** 2491 - 2500 (/course/195614/spanish-nouns-5/248/)	
los espaldones	shoulders
el siberiano	Siberian
la semifusa	sixty-fourth note
la chancla	"slipper, flip flop, flip-flop"
la agachadiza	snipe
los cocainómanos	snowbird
el agrio	sour juice
los espermatozoos	spermatozoa
el espermicida	spermicide
los estatuarios	statutory
*** 2471 - 2480 (/course/195614/spanish-nouns-5/249/)	
los almadieros	rafters
los rezones	reasons
el reciclador	recycler
el referencial	reference
las revendedoras	resellers
los caballones	ridges
las roelas	Roelas
la fresquera	"safe, meatsafe"
el saboyano	Savoyard
los escamados	Scaled
*** 2481 - 2490 (/course/195614/spanish-nouns-5/250/)	
el omoplato	"scapula, shoulder blade"
los acojonados	scared shitless
el rebuscador	scavenger
(el)(la) escoliasta	scholiast
el cohombro	sea cucumber
el chamarilero	secondhand dealer
(los)(las) laicistas	secularists
la sembradora	"seed drill, seeder, sowing machine"
el siluro	"sheatfish, bullhead"
las tejoletas	sherds
*** 2521 - 2530 (/course/195614/spanish-nouns-5/251/)	
el volteriano	Voltairian
la camareta	wardroom
el palanganero	washstand
el blanquete	whitewash
los vitivinicultores	winemakers
la adivinadora	diviner
las alienadas	"alienated person, mentally ill"
la chechena	Chechen
la desdentada	toothless
la desheredada	disinherited
*** 2501 - 2510 (/course/195614/spanish-nouns-5/252/)	
(el)(la) almacenista	storer
(el)(la) trotacalles	streetwalker
(el)(la) subnormal	"subnormal, nutcase"
(el)(la) sufí	Sufi
las sulfonamidas	sulfonamides
el taiwanés	Taiwan
los degustadores	Taster
el tedéum	Te Deum
los telepredicadores	televangelists
las empulgueras	"thumbscrew, screws"
*** 2561 - 2570 (/course/195614/spanish-nouns-5/253/)	
el apaleo	drub
el arcontado	"archonship, archontate"
la áster	aster
la astrodinámica	astrodynamics
el asturianismo	Asturianism
la audibilidad	audibility
el audiómetro	audiometer
la augita	augite
la autoexploración	self-exploration
la autoexpulsión	Eject
*** 2531 - 2540 (/course/195614/spanish-nouns-5/254/)	
(el)(la) infanticida	infanticide
la isabelina	Elizabethan
la legisladora	"legislator, lawgiver"
la rescatadora	rescuer
la saboteadora	saboteur
la salvadoreña	Salvadoran
el filantropismo	philanthropy
el tostado	"roasting, toasting"
la desplazada	displaced
la abada	abbey
*** 2571 - 2580 (/course/195614/spanish-nouns-5/255/)	
el aventurismo	adventurism
el baladro	Baladros
la bartola	paunch
el becerrillo	Becerrillo
la bibliomanía	bibliomania
el bioensayo	bioassay
la bocota	bunghole
el boje	bogie
el bolonio	Bolonio
la borgoñona	Burgundian
*** 2511 - 2520 (/course/195614/spanish-nouns-5/256/)	
el turiferario	thurifer
los tiznaos	Tiznaos
la tomatera	tomato
los transuránicos	transuranic
las bujerías	trinkets
(el)(la) zarista	tsarist
la alforza	"tuck, hem"
los urodelos	urodelans
los valentinianos	Valentinians
(el)(la) excombatiente	vet
*** 2541 - 2550 (/course/195614/spanish-nouns-5/257/)	
el abocamiento	abouchement
el achicador	"bailer, scoop, baler"
la adaza	Adaza
el aerotransporte	airlift
el afeamiento	disfigurement
la agitadora	agitator
el agujón	stinger
la ajera	Ajera
el alazor	safflower
el algodoncillo	milkweed
*** 2591 - 2600 (/course/195614/spanish-nouns-5/258/)	
la carbonita	carbonite
la cardada	carded
la cardiomegalia	cardiomegaly
la catorcena	Fourteenth
el cebón	porker
la cerería	chandlery
el chape	"tress, braid, pigtail"
la chapeta	Chapeta
el chayote	"squash, vegetable pear"
la chilladora	Screech
*** 2551 - 2560 (/course/195614/spanish-nouns-5/259/)	
la alhacena	Alhacena
el altocúmulo	altocumulus
la ámala	love it
el amín	amin
el anestesiólogo	anesthesiologist
el anfión	Amphion
la anglomanía	Anglomania
la angulema	Angoulême
el antiespasmódico	antispasmodic
el antineutrón	antineutron
*** 2581 - 2590 (/course/195614/spanish-nouns-5/260/)	
la borracha	drunkard
la borradura	"erasure, effacement, obliteration"
el botellero	"bottle rack, bin"
la boza	"down, bum fluff, peach fuzz"
el brontosaurio	brontosaurus
el calambrazo	electric shocks
el caldeamiento	warming
el cancro	canker
el capirotazo	"flip, flick"
el caravanero	caravan
*** 2601 - 2610 (/course/195614/spanish-nouns-5/261/)	
la cianamida	cyanamide
el cingalés	"Singhalese, Cingalese"
el colgadizo	"piece of roofing, flat roof"
el condrosarcoma	chondrosarcoma
el conidio	conidium
la contraescarpa	counterscarp
(el)(la) contrapuntista	contrapuntist
la contumelia	contumely
la copiosidad	copiousness
el corazoncillo	Saint-John's-wort
*** 2611 - 2620 (/course/195614/spanish-nouns-5/262/)	
la correligionaria	coreligionist
el demagógico	demagog
la demandadera	Demandadera
el dentudo	toothy
la denunciación	denunciation
la denunciadora	denunciatory
el depresor	depressor
la desagradecida	ungrateful
el descansadero	Shepards
el desengrase	degreasing
*** 2621 - 2630 (/course/195614/spanish-nouns-5/263/)	
el desmaño	iniquity
el desmoche	topping
el despachito	little office
la disoluta	dissolute
el divulgativo	informative
la domada	Taming
el dublinés	Dublin
el edificador	builder
la edilidad	aedileship
la eglantina	"eglantine, sweetbrier"
*** 2631 - 2640 (/course/195614/spanish-nouns-5/264/)	
el eléboro	hellebore
el embaldosado	"tiling, flooring"
el empapelador	paperhanger
el emparedamiento	immurement
el emponzoñamiento	envenomation
el endosatario	endorsee
el enfrenamiento	bremsstrahlung
la engañadora	deceptive
el envanecimiento	"conceit, vanity"
el erebo	Erebus
*** 2641 - 2650 (/course/195614/spanish-nouns-5/265/)	
el escarnecedor	mocker
la espadita	little sword
el esternocleidomastoideo	sternocleidomastoid
la excrescencia	excrescence
la exosfera	exosphere
la experimentadora	experimenter
la expoliadora	exploitative
el expresidiario	ex-convict
la extracta	extracted
la ficoeritrina	phycoerythrin
*** 2651 - 2660 (/course/195614/spanish-nouns-5/266/)	
el fonendoscopio	phonendoscope
la fototerapia	phototherapy
(el)(la) funcionalista	functionalist
la gelignita	"gelignite, jelly"
el gitanismo	Gypsyism
la gorrona	"journal, scrounger, sponger"
el gravímetro	gravimeter
el guarnimiento	reeving
el hermoseamiento	beautification
la hipocicloide	hypocycloid
*** 2661 - 2670 (/course/195614/spanish-nouns-5/267/)	
el hipónimo	hyponym
el hocino	Hoshino
el idiazábal	Idiazábal
la igualadora	equalizing
la implacabilidad	implacability
la individua	individual
la inductora	inducing
el inocentón	dupe
la inquietadora	disquieting
la intelectiva	intellectual
*** 2671 - 2680 (/course/195614/spanish-nouns-5/268/)	
la intercomunión	intercommunion
la isoleucina	isoleucine
la jabonería	soap factory
el jet	"jet, jet plane, jet set"
la jodienda	fucking
el jurisprudente	jurisprudent
el kinesiólogo	kinesiologist
la ladeada	Cocked
el laparoscopio	laparoscope
la lechigada	"litter, brood"
*** 2701 - 2710 (/course/195614/spanish-nouns-5/269/)	
el recocido	annealing
el refractómetro	refractometer
la reinona	Reinón
la remolona	dragged its feet
la renegada	renegade
el revolvedor	stirrer
la rezaga	lingers
el rodapié	"skirting board, skirting, baseboard"
el saborcillo	slight taste
el samarugo	Samarugo
*** 2681 - 2690 (/course/195614/spanish-nouns-5/270/)	
la lustrina	shiny material of alpaca
el micho	puss
el mingitorio	urinal
el nano	"elder brother, friend, chum"
la neuroglia	glia
la pacha	"baby's bottle, small flat bottle"
el paragüero	"umbrella stand, umbrella maker"
el parlanchín	"chatterbox, talker"
el peripatético	Peripatetic
la proctología	proctology
*** 2691 - 2700 (/course/195614/spanish-nouns-5/271/)	
el prolapso	"prolapse, prolapsus"
la pulidora	polisher
el pulidor	"polisher, buff"
la punica	Punic
el rallo	"grater, rasp"
la ramplona	vulgar
la raptora	enrapturing
el rastrillaje	raking
la rasuradora	razor
la reciprocación	reciprocation
*** 2721 - 2730 (/course/195614/spanish-nouns-5/272/)	
la supererogación	supererogation
la tabuladora	tabulator
el tamandúa	tamandua
(el)(la) tarahumara	Tarahumara
la tiempla	tightens
la tifoidea	typhoid
el toallero	"towel rail, towel rack"
la tomatada	Tomatada
el triásico	Triassic
el vaciadero	dump
*** 2711 - 2720 (/course/195614/spanish-nouns-5/273/)	
la sardónice	sardonyx
el secretillo	little secret
la secuestración	sequestration
la sedosidad	silkiness
la semisuma	semisum
el servofreno	servobrake
la sofrenada	pull
el spaniel	spaniel
el subyugador	subjugator
la sumaca	two-master
*** 2731 - 2740 (/course/195614/spanish-nouns-5/274/)	
el vasodilatador	vasodilator
la venturina	aventurine
la vigorosidad	vigor
(el)(la) vinícola	wine producer
el zumbador	buzzer
el tragón	"glutton, pig"
el congelado	freezing
la tontera	"trivial matter, stupid thing"
(el)(la) radioyente	radio listener
los accipítridos	accipiters
*** 2741 - 2750 (/course/195614/spanish-nouns-5/275/)	
(los)(las) adamitas	Adamites
(los)(las) adenoides	adenoids
los desaconsejados	advised against
los eolios	Aeolians
(los)(las) alópatas	allopathic
el andorrano	Andorran
la angulosidad	angularity
(el)(la) anticlerical	anticlerical
el antillano	Antillean
la antitoxina	"antitoxin, antivenin"
*** 2761 - 2770 (/course/195614/spanish-nouns-5/276/)	
(el)(la) dental	"beam, dental, dental sound"
(el)(la) beatnik	beatnik
el begardo	Beghard
el berberisco	Berber
el motero	biker
el carrocero	body-builder
los bolivarianos	Bolivarian
el listillo	bright spark
la bronquiectasia	bronchiectasis
las topadoras	bulldozers
*** 2751 - 2760 (/course/195614/spanish-nouns-5/277/)	
(el)(la) acuarelista	aquarellist
la arteritis	arteritis
el articulador	articulator
la aspirada	aspirate
los acometedores	assailants
el sobrado	"attic, garret"
(el)(la) autonomista	autonomist
la enartrosis	ball and socket
(el)(la) bantú	Bantu
(los)(las) baptistas	Baptists
*** 2771 - 2780 (/course/195614/spanish-nouns-5/278/)	
los calamones	cabochons
los californios	Californians
(el)(la) canonista	canonist
los caprimulgiformes	Caprimulgiformes
el cartagenero	Cartagena
el causador	causer
el silletazo	chair shot
el cerero	Chandler
el escarmentado	chastened
el cloramfenicol	chloramphenicol
*** 2781 - 2790 (/course/195614/spanish-nouns-5/279/)	
las clorofitas	chlorophytes
(el)(la) limpiacristales	cleaner
(el)(la) soplapollas	cocksucker
(los)(las) conceptualistas	conceptualist
el confederado	confederate
los adjudicadores	contracting
la albardilla	"coping, small cushion, bard"
las nécoras	crabs
los crinoideos	crinoids
el viajador	cruiser
*** 2791 - 2800 (/course/195614/spanish-nouns-5/280/)	
(el)(la) machacante	crushing
los gritadores	crying
el cristalito	crystallite
el cuboide	cuboid
los decalitros	"decaliter, decalitre"
(los)(las) derrotistas	defeatists
los discernidores	discerning
las disyuntas	disjunct
la ahogada	drowned
el montaplatos	dumbwaiter
*** 2801 - 2810 (/course/195614/spanish-nouns-5/281/)	
la tijerillas	earwigs
las enantes	enanthic
los exámenes	"examination, exam, review"
la extorsionada	extorted
la falsada	falsified
el cebadero	feedlot
las ferroaleaciones	ferroalloys
los fringílidos	finches
los pescadores	"fisher, fisherman"
la asquerosidad	foulness
*** 2811 - 2820 (/course/195614/spanish-nouns-5/282/)	
(los)(las) ludópatas	gamblers
los garranchos	Garranchos
la georgiana	Georgian
el acicalado	getting oneself ready
los necrófagos	ghouls
el calificador	grader
los colgaderos	hangers
la quedada	hangout
el helminto	helminth
el helvético	Helvetian
*** 2821 - 2830 (/course/195614/spanish-nouns-5/283/)	
el polipasto	hoist
(el)(la) homeópata	"homeopath, homoeopath, homeopathist"
el hidroplano	hydroplane
la imaginativa	imagination
los indiciados	indexed
(el)(la) internacionalista	internationalist
(el)(la) jacobita	Jacobite
la jeremiada	jeremiad
el coscojar	kermes oak
los kilociclos	kHz
*** 2831 - 2840 (/course/195614/spanish-nouns-5/284/)	
(el)(la) kosovar	Kosovo
los curdos	Kurds
los cordones	"lace, cord, cordon"
(el)(la) legalista	legalist
(los)(las) leninistas	Leninist
el leotardo	leotard
los lesbios	Lesbians
el levantino	Levantine
el lengüetazo	lick
la islilla	little island
*** 2851 - 2860 (/course/195614/spanish-nouns-5/285/)	
la orquitis	orchitis
los pulpejos	pads
el palatino	palatine
las papaveráceas	papaveraceous
el parquímetro	parking meter
el pequinés	peke
el arrumaco	petting
los filodendros	philodendron
los fotoconductores	photoconductors
los oxiuros	pinworms
*** 2841 - 2850 (/course/195614/spanish-nouns-5/286/)	
el maderero	"lumberjack, lumberman"
el macabeo	Maccabean
los malcontentos	malcontents
la guarrada	"mess, filthy mess, disgusting mess"
los minicomputadores	minicomputers
los bravíos	mischievously
(el)(la) monoteísta	monotheist
(los)(las) mitologistas	Mythologists
los letreritos	name cards
los onicóforos	onychophorans
*** 2871 - 2880 (/course/195614/spanish-nouns-5/287/)	
la pollita	pullet
el penado	punishable
el empujador	pusher
el cuasidelito	quasi delict
la increpación	"rebuke, objurgation"
(los)(las) reusenses	Reus
las mazarotas	risers
el roblón	rivet
el arrastrado	"rogue, rascal, down-and-out"
(el)(la) tolete	"rowlock, oarlock"
*** 2861 - 2870 (/course/195614/spanish-nouns-5/288/)	
los placentarios	placental
la neumoconiosis	pneumoconiosis
los abrillantados	polished
el polisíndeton	polysyndeton
los vulgarizadores	popularizers
(el)(la) prerrafaelista	pre-Raphaelite
el premolar	premolar
el pretensor	pretensioner
los prociónidos	procyonids
los aprovechadores	profiteers
*** 2881 - 2890 (/course/195614/spanish-nouns-5/289/)	
los sacramentarios	sacramentaries
el saduceo	Sadducee
los salentinos	Salento
las salicáceas	Salicaceae
la ojota	"sandal, flip-flop"
la garrapatea	scrawls
los escrofulosos	scrofulous
los engastados	seamed
el abusón	"selfish person, bully, abuser"
las semejas	semblance
*** 2911 - 2920 (/course/195614/spanish-nouns-5/290/)	
el escrutador	"teller, scrutineer, scrutator"
el trastazo	"thump, bump"
la escombrera	"tip, slagheap, dump"
los tolosanos	Toulouse
el travestido	transvestite
los triarios	triarii
la trillada	trite
los umbilicales	umbilical
los desconocedores	unfamiliar
(los)(las) uscoques	Uskoks
*** 2891 - 2900 (/course/195614/spanish-nouns-5/291/)	
el sesquiplano	sesquiplane
el chalote	"shallot, scallion"
la esquilada	sheared
el descamisado	shirtless
el espetón	"skewer, spit"
los achinados	slanted
el hondero	slinger
los fisgones	Sneakers
el michelín	"spare tyre, roll of fat, spare tire"
los gurriatos	sparrows
*** 2901 - 2910 (/course/195614/spanish-nouns-5/292/)	
las vinazas	stillage
el tachón	"stud, crossing out, deletion"
la jabonadura	suds
la barredura	sweep
el goloso	"sweet tooth, sweet-tooth"
las dulce	"sweet, candy"
el liquidámbar	sweetgum
el tapaculo	Tapaculos
el telamón	telamon
los teleósteos	teleost
*** 2931 - 2940 (/course/195614/spanish-nouns-5/293/)	
la acreedora	creditor
la albaceteña	Albacete
la moledora	grinder
la apuntadora	prompter
la bibliófila	"bibliophile, booklover"
las borregas	"yearling sheep, sheep, follower"
la cardióloga	cardiologist
el divieso	"furuncle, boil, carbuncle"
el presidiario	convict
la corintia	Corinthian
*** 2921 - 2930 (/course/195614/spanish-nouns-5/294/)	
las vejiguillas	vesicles
los vomitorios	vomitoria
los arrimaderos	wainscoting
el andar	walk
los watios	watts
las encañizadas	weirs
el trompazo	whack
la emperrada	who was determined
las mujeres	"women, ladies"
la leñadora	"woodcutter, woodsman, lumberjack"
*** 2961 - 2970 (/course/195614/spanish-nouns-5/295/)	
la acariciadora	caressing
la aclorhidria	achlorhydria
la acomodadora	usherette
el acumulamiento	buildup
el adsorbato	adsorbate
el agiotaje	"jobbery, jobbing, speculation"
la albuminuria	albuminuria
la aldabilla	latch
la alfana	Alphane
el alfolí	storehouse
*** 2951 - 2960 (/course/195614/spanish-nouns-5/296/)	
el salador	salter
el calenturiento	feverish
el linotipo	linotype
el pelador	peeler
el refinador	refiner
la ginesta	broom
el gargarismo	"gargling, gargle"
la arrocera	gate crasher
la abombada	convex
(el)(la) academicista	academic
*** 2941 - 2950 (/course/195614/spanish-nouns-5/297/)	
la enlazadora	linker
la evacuada	evacuated
la extrusora	extruder
la hispanoamericana	Spanish American
la holgazana	"idler, laggard, bum"
el guarro	"pig, hog"
el alcabalero	tax collector
la refinadora	refiner
la refugiada	refugee
el salinero	salter
*** 2971 - 2980 (/course/195614/spanish-nouns-5/298/)	
el alinde	Alinde
el almizclero	musk deer
la alometría	allometry
la alpina	Alpine
el amasamiento	kneading
la amerindia	Amerindian
la amigabilidad	friendliness
la anástrofe	Anastrophe
el anatolio	Anatolian
el ándito	Andito
*** 2991 - 3000 (/course/195614/spanish-nouns-5/299/)	
el arruinamiento	"ruin, ruination"
el asecho	stalking
la asoleada	sunstroke
el astrocitoma	astrocytoma
el atlántico	Atlantic
el atosigamiento	mobbing
la autopropulsión	self-propelled
(el)(la) autostopista	hitch-hiker
el azuzador	teasing
la babera	beaver
*** 2981 - 2990 (/course/195614/spanish-nouns-5/300/)	
la anglófona	English-speaking person
la aniquiladora	annihilating
la anona	"anona, annona"
el anticipador	anticipator
el antifonario	"antiphonary, antiphonal"
la antiguerrillera	guerrilla
la antipirina	antipyrine
el arbitrador	arbitrator
la aristoloquia	aristolochia
la arriada	lowered
*** 3001 - 3010 (/course/195614/spanish-nouns-5/301/)	
la babilonia	Babylon
el bacinete	lavatory pan
el badián	badian
el bafle	baffle
la baritina	"barytes, barite"
la batayola	nettings
la becada	woodcock
el benzol	benzol
la betarraga	beetroot
la bigornia	anvil
*** 3011 - 3020 (/course/195614/spanish-nouns-5/302/)	
la bioelectricidad	bioelectricity
la bizquera	squint
el bobillo	bobbin
la bonachona	natured
el bonetillo	Bonetillo
la bramadera	bullroarer
la bromatología	bromatology
el bujedo	Bujedo
el cabalgador	Cabalgador
el cabracho	scorpionfish
*** 3021 - 3030 (/course/195614/spanish-nouns-5/303/)	
el cachupín	Cachupín
la cagalera	"diarrhoea, the shits, the runs"
el camarico	Camarico
la cañafístola	canafistola
el caracoleo	snailing
la caraja	karaya
el cartelero	"poster, billsticker, billposter"
el casamentero	"matchmaker, marriage broker"
el castóreo	castoreum
la cayada	Cudgel
*** 3031 - 3040 (/course/195614/spanish-nouns-5/304/)	
la chalota	shallot
el cheurón	chevron
el cianato	cyanate
el cimbel	decoy
el cobardón	coward
la colegiada	collegial
la coloquíntida	bitter apple
el colorímetro	colorimeter
(el)(la) comanche	Comanche
la confutación	refutation
*** 3041 - 3050 (/course/195614/spanish-nouns-5/305/)	
la contadora	accountant
el copernicano	Copernican
el coquetón	lady-killer
el coreo	choree
la corruptora	corrupting
la cremería	creamery
el crispamiento	twitching
el cromatograma	chromatogram
el cubilote	cupola
el cunero	nursery
*** 3051 - 3060 (/course/195614/spanish-nouns-5/306/)	
la curabilidad	curability
la dactilógrafa	"fingerprint expert, dactylographist"
el dactilógrafo	"dactylographist, fingerprint expert"
el debelador	conqueror
el decigramo	"decigram, decigramme"
el declarador	declarer
la descocada	Flapper
la desestabilizadora	destabilizing
la desmaña	clumsiness
el desmoldeo	discharge mould
*** 3061 - 3070 (/course/195614/spanish-nouns-5/307/)	
el desparramamiento	scattering
el diamagnetismo	diamagnetism
el dicharachero	"wit, chatterbox"
la difusora	diffusing
el dinamarqués	Danish
la discinesia	dyskinesia
la distocia	dystocia
la dobladilla	Hemming
el doctrino	Doctrino
la dolicocefalia	dolichocephaly
*** 3081 - 3090 (/course/195614/spanish-nouns-5/308/)	
el encanecimiento	graying
el encrespamiento	frizz
la energúmena	possessed person
la enfriadora	chiller
la engrasadora	grease
el ensuciamiento	soiling
la equipolencia	equipollence
la escansión	scansion
el escarabajeo	Skarabäus
(el)(la) esgrimista	fencer
*** 3071 - 3080 (/course/195614/spanish-nouns-5/309/)	
la dulzona	sweetish
la ecocardiograma	echocardiogram
el electrocardiógrafo	electrocardiograph
la electromecánica	electromechanical
el eliminador	eliminator
la emasculación	emasculation
el embadurnador	Dauber
el embaidor	cheat
el emparejador	jogger
la emuladora	Emulator
*** 3101 - 3110 (/course/195614/spanish-nouns-5/310/)	
la fluorización	fluoridation
el foxterrier	fox terrier
la fraudulencia	"fraudulence, fraudulency"
la frescachona	buxom
la fresca	"cool, cheek, nerve"
el fricasé	fricassee
el fueraborda	outboard
la fúrcula	furcula
el furúnculo	"furuncle, boil"
la fusibilidad	fusibility
*** 3091 - 3100 (/course/195614/spanish-nouns-5/311/)	
la espiramicina	spiramycin
la estereotipa	stereotypes
(el)(la) estilita	stylite
la estopilla	cheesecloth
el estrujón	"squeeze, pressing"
el exmarido	ex-husband
la exmujer	ex wife
el explicador	explainer
la ficocianina	phycocyanin
la figuranta	figurante
*** 3121 - 3130 (/course/195614/spanish-nouns-5/312/)	
el hayal	beech grove
el hebillaje	buckles
el helenio	elecampane
la hemina	hemin
la hioscina	hyoscine
la hiperpirexia	hyperpyrexia
el hurgón	rake
el husmeador	sniffer
la ideóloga	ideologue
la incitativa	incentive
*** 3131 - 3140 (/course/195614/spanish-nouns-5/313/)	
la incombustibilidad	incombustibility
la incorrupción	imperishable
la incredibilidad	incredibility
la inescrutabilidad	inscrutability
la inhibitoria	inhibitory
el injuriador	injurious
la insubsistencia	insubstantiation
la interrogadora	interrogator
la intrincación	intricacy
la irrespetuosidad	disrespect
*** 3111 - 3120 (/course/195614/spanish-nouns-5/314/)	
la gabacha	"Frenchy, froggy, frog"
(el)(la) gafe	"hoodoo, jinx"
el gangueo	"twang, snuffle"
la geobiología	geobiology
(el)(la) gesticulante	gesticulating
la gincana	"gymkhana, treasure hunt"
el grifón	griffon
la guasábara	Guasábara
el guitarrillo	small guitar
la habilitada	enabled
*** 3141 - 3150 (/course/195614/spanish-nouns-5/315/)	
el jilguerillo	Jilguerillo
la joyera	jeweler
la jumera	Jumera
el kaláshnikov	Kalashnikov
el ladrador	barking
el ladronicio	thievery
el lamedor	licker
la lavada	washed
la lechaza	milt
el lechoncillo	"sucking pig, piglet"
*** 3161 - 3170 (/course/195614/spanish-nouns-5/316/)	
el maligno	"the devil, the evil one"
el manitú	manitou
el mará	Mara:
la marcasita	marcasite
el marojal	Pyrenean oak
la marsellesa	Marseillaise
el mecedor	"rocking, swinging"
la melenita	mane
la melómana	music lover
la menesterosa	needy
*** 3151 - 3160 (/course/195614/spanish-nouns-5/317/)	
el levador	levator
la lincomicina	lincomycin
el livonio	Livonian
la llanera	plains
el locativo	locative
la lotera	lottery
el macrófago	macrophage
la magnetohidrodinámica	MGD
el mágnum	magnum
el majzén	makhzen
*** 3171 - 3180 (/course/195614/spanish-nouns-5/318/)	
(el)(la) mennonita	Mennonite
la mensurabilidad	measurability
(el)(la) mercadante	Mercadante
el mercal	Mercal
la micropaleontología	micropalaeontology
el mieloblasto	myeloblast
la minestrone	minestrone
el mingote	Mingote
la modicidad	reasonableness
la mofadora	scoffing
*** 3181 - 3190 (/course/195614/spanish-nouns-5/319/)	
el mofador	"scoffer, mocker, sneerer"
el monociclo	unicycle
la monotipia	monotype
el nebulizador	nebulizer
la neomicina	neomycin
el nobelio	nobelium
el novador	vative
la nubilidad	nubility
la nupcial	nuptial
el oteador	Lookout
*** 3191 - 3200 (/course/195614/spanish-nouns-5/320/)	
el otorrino	ENT
el oviscapto	ovipositor
el panteonero	gravedigger
el parquecito	little park
la partidura	parting
la pedicura	"pedicure, pedicurist"
el pediluvio	footbath
la pegunta	Pegunta
(el)(la) pendolista	Penman
el pentasílabo	pentasyllable
*** 3201 - 3210 (/course/195614/spanish-nouns-5/321/)	
el percloruro	perchloride
(el)(la) perista	"fence, receiver of stolen goods"
(el)(la) personalista	personalistic
la pina	"pineapple, cone, pinecone"
la pinchadura	puncture
el pistache	pistachio
la plegadura	"folding, crease, plication"
el pleocroísmo	pleochroism
el polígamo	polygamist
el polisón	bustle
*** 3211 - 3220 (/course/195614/spanish-nouns-5/322/)	
el postín	"ostentation, show"
el precámbrico	Precambrian
la presuntuosidad	"presumptuousness, presumption"
el pretorianismo	"praetorianism, pretorianism"
el preventorio	preventorium
la prófuga	fugitive
la psicofísica	psychophysical
el pudrimiento	putrescence
la pulserita	wrist
la quelación	chelation
*** 3221 - 3230 (/course/195614/spanish-nouns-5/323/)	
el quersoneso	chersonese
el quinceno	Quinceno
la quiropráctica	chiropractor
la radioelectricidad	radioelectricity
la radiotoxicidad	radiotoxicity
la rayada	striped
el reconstituyente	tonic
(el)(la) recortable	cut-out
el refundidor	reviser
la remachadora	Riveter
*** 3231 - 3240 (/course/195614/spanish-nouns-5/324/)	
el repelón	Repelon
el resbalador	slider
la reserpina	reserpine
la resiembra	reseeding
la ricia	having jaundice
el rondel	"rondel, roundel"
el saucillo	Saucillo
el secretito	secret
el skay	leatherette
el somnambulismo	"somnambulism, sleepwalking"
*** 3241 - 3250 (/course/195614/spanish-nouns-5/325/)	
la suculencia	"succulence, lushness, richness"
la sudanesa	Sudanese
el sugestionador	suggestionist
la sulfadiazina	sulfadiazine
la tabica	riser
la temblona	tremulous
el tensiómetro	tensiometer
la ternilla	brisket
el tetón	lug
el tinaco	"pot, water tank"
*** 3251 - 3260 (/course/195614/spanish-nouns-5/326/)	
el tiritón	shiver
la tortillería	tortilla
la trabuca	blunderbuss
el trasportador	transporter
la trecha	narrow
el trefilado	wiredrawing
la trenca	"duffel coat, parka, duffle coat"
el turbogenerador	turbogenerator
el ultraortodoxo	ultra-Orthodox
el ululato	"hoot, ululation"
*** 3261 - 3270 (/course/195614/spanish-nouns-5/327/)	
el varado	man without a regular job
el velludillo	velveteen
el venerador	venerator
el ventano	Ventano
la viada	Viada
la vienesa	Viennese
la vinatería	liquor store
la vindicadora	Vindicator
la vitrocerámica	hob
el yodoformo	iodoform
*** 3281 - 3290 (/course/195614/spanish-nouns-5/328/)	
(el)(la) actuante	acting
las aguadillas	Aguadillas
la altercación	altercation
las analectas	"analects, analecta"
el ansiolítico	"anxiolytic, tranquiliser"
el silvicultor	arboriculturist
el argivo	Argive
los macanazos	batons
los almenares	battlements
la sitiadora	besieging
*** 3271 - 3280 (/course/195614/spanish-nouns-5/329/)	
el zangoloteo	jiggle
la zidovudina	zidovudine
la zonación	zonation
la zumaya	goatsucker
la vinagrera	vinegar bottle
el centroamericano	Central American
el adiestrador	trainer
(el)(la) cooperativista	member of a cooperative
el colegislador	co-legislator
el corrupto	a corrupt person
*** 3291 - 3300 (/course/195614/spanish-nouns-5/330/)	
las blanqueadoras	bleaching
el intermitente	"blinker, turn signal, indicator"
el nuevito	brand new
los empanados	breaded
la capellina	brimmed
los magullones	bruises
el bubón	bubo
los empavesados	buntings
los alcaparrones	capers
el carbonado	carbonaceous
*** 3301 - 3310 (/course/195614/spanish-nouns-5/331/)	
las talladuras	carvings
el entubado	cased
la castañuela	"castanet, castanets, damselfish"
los celestinos	Celestine
la centrifugadora	centrifuge
la coagulopatía	coagulopathy
los cocotales	coconut palms
(el)(la) colectivista	collectivist
(el)(la) colonialista	colonialist
el cooperador	cooperator
*** 3311 - 3320 (/course/195614/spanish-nouns-5/332/)	
el cordelero	cordelier
el cosario	corsair
el cuchillero	cutler
los cirenaicos	Cyrenaics
el datáfono	dataphone
la ilusa	deluded
el temblante	"dither, trembler"
los quiciales	doorposts
el burlete	draught excluder
el eritreo	Eritrean
*** 3331 - 3340 (/course/195614/spanish-nouns-5/333/)	
las fumariáceas	Fumariaceous
la pindonga	"gadabout, trollop"
la galerada	"galley, pull"
(el)(la) germanista	Germanist
el germinal	germinal
las regaladas	given away
el espigador	gleaner
la gafa	"grapple, grapnel, grappling hook"
el cigarrón	grasshopper
la desolladura	graze
*** 3361 - 3370 (/course/195614/spanish-nouns-5/334/)	
la postrimería	latter end
(los)(las) linotipistas	linotypists
la piernecita	little leg
los taladores	loggers
la guapa	lovely
la grajea	lozenge
las lúes	lues
el lugre	lugger
el malaquías	malachi
la colectora	manifold
*** 3321 - 3330 (/course/195614/spanish-nouns-5/335/)	
los euterios	eutherian
los malpensados	evil-minded
el exterminador	exterminator
(los)(las) extorsionistas	extortionists
el criticón	faultfinder
el menudillo	fetlock
la mentirijilla	fib
las mentirillas	fibs
la financiera	finance company
el currutaco	"foppish, swanky, nob"
*** 3341 - 3350 (/course/195614/spanish-nouns-5/336/)	
las rectificadoras	grinding
la griseta	grisette
la varada	grounding
el talonazo	heel kick
el hegeliano	Hegelian
los hirudíneos	hirudinea
los hitlerianos	Hitler
el hotentote	Hottentot
(el)(la) higienista	hygienist
las impuridades	impurities
*** 3371 - 3380 (/course/195614/spanish-nouns-5/337/)	
el jaspeado	marbling
los marsos	Marsi
la mastoides	mastoid
el metatarsiano	metatarsal
el microcircuito	microcircuit
el microfilme	microfilm
las treintañeras	milf
los mimbrales	Mimbrales
los ministradores	ministering
el modernizador	modernizing
*** 3381 - 3390 (/course/195614/spanish-nouns-5/338/)	
el mogol	Mogul
el molar	molar
(el)(la) monofisita	Monophysite
los monopolizadores	monopolists
la morilla	Morel
(los)(las) muslimes	Muslims
el servilletero	"napkin ring, serviette ring, serviette holder"
la pinocha	needles
los ponederos	nests
la entalladura	notch
*** 3351 - 3360 (/course/195614/spanish-nouns-5/339/)	
(los)(las) jaliscienses	Jalisco
la japonesita	Japanese girl
la jumenta	jennet
los jerosolimitanos	Jerusalemites
los josefinos	Josephites
el quilómetro	kilometer
el kilopondio	kilopond
el jaez	"kind, sort, harness"
el lagomorfo	lagomorph
la lanzuela	Lanzuela
*** 3391 - 3400 (/course/195614/spanish-nouns-5/340/)	
(el)(la) nudista	nudist
el anglosajón	"Old English, Anglo-Saxon"
los olivicultores	olive growers
(los)(las) omaguas	Omaguas
el tuerto	one-eyed person
los ostracodermos	ostracoderms
el chanclo	"overshoe, clog, galosh"
la enjalma	packsaddle
los cuévanos	panniers
la paratiroides	parathyroids
*** 3401 - 3410 (/course/195614/spanish-nouns-5/341/)	
el parhelio	parhelion
el parisién	Parisian
(el)(la) modelista	patternmaker
la pelucona	pelucon
los peones	"peon, pawn, laborer"
el politicastro	"petty politician, politician, politicaster"
los pintauñas	pinto
el pisano	Pisan
los placodermos	placoderms
las plantagináceas	Plantaginaceae
*** 3411 - 3420 (/course/195614/spanish-nouns-5/342/)	
los afelpados	plush
las podocarpáceas	Podocarpaceae
las poligonáceas	polygonaceae
los pontificales	pontifical
el prosimio	prosimian
los cateadores	prospectors
las proteáceas	Proteas
los pacatos	prudish
los psitácidos	psittacidae
los psitaciformes	psittaciformes
*** 3431 - 3440 (/course/195614/spanish-nouns-5/343/)	
el recauchutado	retread
el retrocohete	retrorocket
(el)(la) revisionista	revisionist
el rizoide	rhizoid
los remachados	riveted
la ruda	rue
(los)(las) sagitarios	Sagittarians
los sansimonianos	Saint-Simonian
los samoyedos	Samoyeds
las sanies	sanies
*** 3421 - 3430 (/course/195614/spanish-nouns-5/344/)	
los motones	pulley blocks
los cuadrumanos	quadrumana
el andurrial	"quagmire, detour, godforsaken place"
los quirites	Quirites
la ranciedad	"rancidity, rankness, rancidness"
el crótalo	"rattlesnake, pit viper"
los reales	real
(los)(las) redentoristas	Redemptorist
(el)(la) relativista	relativist
los mitigadores	relievers
*** 3441 - 3450 (/course/195614/spanish-nouns-5/345/)	
la escaldadura	scald
el bohordo	scape
el cismático	schismatic
los fondillos	seat
la exclaustrada	secularised
la semiconsonante	semiconsonant
las servillas	Servillas
la argentada	silvery
la solar	"site, plot, ancestral home"
los escaramuzadores	skirmishers
*** 3461 - 3470 (/course/195614/spanish-nouns-5/346/)	
las cabareteras	strippers
la sulfamida	sulfamide
el táctico	tactician
el abstemio	"teetotaler, total abstainer"
el borne	terminal
el terpeno	terpene
el tánatos	thanatos
la termia	therm
el palillero	Toothpick
(los)(las) cursillistas	trainees
*** 3451 - 3460 (/course/195614/spanish-nouns-5/347/)	
la ahumada	smokesignal
el mojado	"soaking, drenching"
(los)(las) sociolingüistas	sociolinguists
los portalámparas	Socket
el blandengue	softie
las alcayatas	spikes
los manchurrones	splotches
la espondilosis	spondylosis
las fumigadoras	sprayers
el portaobjeto	stage
*** 3471 - 3480 (/course/195614/spanish-nouns-5/348/)	
los triplicados	triplicate
(los)(las) tiranicidas	tyrannicides
el pajero	wanker
la timonera	wheelhouse
el susurrador	whisperer
la furcia	"whore, tart, hooker"
los cercopitécidos	World monkeys
la zoospora	zoospore
la algodonera	cotton grower
la amoladora	grinder
*** 3481 - 3490 (/course/195614/spanish-nouns-5/349/)	
el beneficiador	benefactor
la birmana	Burmese
la bogotana	Bogota
la cerdita	"piggy, piglet"
el forúnculo	"furuncle, boil, carbuncle"
la comprometedora	compromising
la conciudadana	fellow citizen
la compañerita	classmate
la congoleña	Congolese
el cok	coke
*** 3491 - 3500 (/course/195614/spanish-nouns-5/350/)	
la cosaca	Cossack
la empleadora	employer
la esquizofrénica	"schizophrenic, schizo"
la franciscana	Franciscan
la gansa	"goose, gander"
la hipnotizadora	"hypnotist, mesmerist"
la isleña	islander
el colorín	goldfinch
la jorobada	"humpback, hunchback"
la mestiza	"mongrel, mestizo"
*** 3501 - 3510 (/course/195614/spanish-nouns-5/351/)	
la neurocirujana	neurosurgeon
la peladora	peeler
la perpetradora	perpetrator
la pordiosera	"beggar, mendicant"
el fiscalizador	tax collector
la segoviana	Segovia
(el)(la) hispalense	Seville person
la súbdita	"subject, national, citizen"
el trasformador	transformer
la urdidora	warping
*** 3521 - 3530 (/course/195614/spanish-nouns-5/352/)	
la sicodelia	psychedelia
el lingotazo	slug
la aprovechada	"opportunist, scrounger"
el abonamiento	fertilization
(el)(la) absentista	"absentee, absentee landlord"
el acobardamiento	Pinning
el acrobatismo	tumbling
el adanismo	Adamism
el adormecedor	numbing
la afeitadora	"razor, shaver"
*** 3511 - 3520 (/course/195614/spanish-nouns-5/353/)	
la vicesecretaría	Deputy Secretary
la wagneriana	Wagnerian
la zoóloga	zoologist
el taponazo	pop
el alfabetizado	literate
la barbuda	bearded
el extrusor	extruder
el guanábano	soursop
la mondonguera	tripe
el pirulí	lollipop
*** 3531 - 3540 (/course/195614/spanish-nouns-5/354/)	
la afrikaner	Afrikaner
la afufa	Afufa
el agostamiento	withering
la agrafia	agraphia
el aguilón	"gable, boom, jib"
el alberque	Hostel Out
el albuminoide	albuminoid
la alejandrina	Alexandrian
la alentada	encouraged
el alergeno	allergen
*** 3551 - 3560 (/course/195614/spanish-nouns-5/355/)	
el anorexígeno	anorectic
el ansarón	gosling
la antecedencia	antecedence
la anteportada	bastard title
el archibebe	redshank
la argumentadora	argumentative
el arsenito	arsenite
la artralgia	arthralgia
el asincronismo	asynchronism
el atendedor	Attendant
*** 3541 - 3550 (/course/195614/spanish-nouns-5/356/)	
el almenaje	crenellation
(el)(la) almorávide	almoravid
el alótropo	allotrope
el alquilador	"renter, hirer, tenant"
la amigdalina	amygdalin
el amilo	amyl
el amoralismo	amoralism
el andarín	walker
el andullo	"plug, pudding"
el anegadizo	to flooding
*** 3571 - 3580 (/course/195614/spanish-nouns-5/357/)	
el basset	basset
el batimiento	paddling
la bearnesa	bearnaise
el bellotero	Acorn
el bicromato	bichromate
el bierzo	birthplace
el bies	bias
el bígamo	bigamist
(el)(la) billarista	billiard
el bisulfuro	"bisulfide, bisulphide"
*** 3561 - 3570 (/course/195614/spanish-nouns-5/358/)	
el atenuador	attenuator
la atracadora	"robber, thief"
el averiguador	inquirer
la azoemia	azotemia
(el)(la) bactericida	"bactericide, germicide"
el baleo	Baleo
la ballestera	Ballestera
la balota	ballot
la bardana	burdock
el barrigón	"pot belly, paunch, gut"
*** 3581 - 3590 (/course/195614/spanish-nouns-5/359/)	
el bíter	bitters
el blastema	blastema
el bocín	Bocin
la bollera	dyke
la cabezona	bighead
el calabrote	hawser
el canalículo	canaliculus
el cangrejito	little crab
el cangro	CanGro
la canturía	bass motion
*** 3591 - 3600 (/course/195614/spanish-nouns-5/360/)	
la caponera	caponier
el cardán	cardan
el careto	fronted
el cariblanca	Barnacle
el castrador	castrating
la catilinaria	diatribe
la caucásica	caucasian
la cavernosidad	hollowness
la centinodia	knotweed
(el)(la) cerealista	cereal
*** 3601 - 3610 (/course/195614/spanish-nouns-5/361/)	
el cesamiento	stopping
el chadiano	Chadian
el charlador	"cackler, creeper"
la charleta	Charlet
la chinchona	Peruvian bark
el chipirón	"European squid, baby cuttlefish"
el chirumen	nous
la choricera	Choricera
la chuletita	Chuletita
la cicatera	stingy
*** 3611 - 3620 (/course/195614/spanish-nouns-5/362/)	
el ciclamen	cyclamen
el ciclamor	redbud
el ciclorama	cyclorama
la cimarrona	Maroon
el cirineo	Cyrene
la citogenética	cytogenetic
la cítola	citole
el claretiano	Claretian
el clarión	clarion
la cleta	cle
*** 3631 - 3640 (/course/195614/spanish-nouns-5/363/)	
(el)(la) congregacionista	Congregationalist
el contuso	blunt
el coronal	coronal
la corsetera	corset
la cucheta	bunk
la cuculla	Cuculla
el curalotodo	cure-all
el dacrón	Dacron
la demagógica	demagogic
la denominadora	Denominator
*** 3641 - 3650 (/course/195614/spanish-nouns-5/364/)	
el derrubio	scouring
el desecador	desiccator
el desesperanzador	hopeless
el desfavor	disfavor
el desfibrado	defiberized
el deslucimiento	dinginess
el desmadejamiento	unraveling
la desmagnetización	demagnetization
(el)(la) desnudista	stripper
la desolladora	hide-puller
*** 3621 - 3630 (/course/195614/spanish-nouns-5/365/)	
el clíper	clipper
el cocó	coconut
el cohetero	rocketeer
la coladura	"straining, seepage, faux pas"
la colapez	isinglass
el cólquico	autumn crocus
el combinador	combiner
el comilón	greedy person
el compadraje	cronyism
el comparendo	"subpoena, summons"
*** 3651 - 3660 (/course/195614/spanish-nouns-5/366/)	
la destructibilidad	destructibility
(el)(la) desviacionista	deviant
el detenedor	retainer
la dinamia	dynamics
la discrasia	dyscrasia
el disector	dissector
el dodecágono	dodecagon
el dolmán	Dolman
la domínica	Dominica
la dragontea	snakeroot
*** 3661 - 3670 (/course/195614/spanish-nouns-5/367/)	
(el)(la) droguista	"druggist, dope fiend"
la duerna	Duerna
el dulcémele	dulcimer
el duunvirato	duumvirate
el duunviro	duumvir
la ecocardiografía	echocardiography
la ectomorfia	ectomorphy
la ejecutora	executrix
el electromiograma	electromyogram
la embolada	stroke
*** 3671 - 3680 (/course/195614/spanish-nouns-5/368/)	
la embriogenia	embryogenesis
la encalladura	"stranding, running around"
el enriado	retted
el entonamiento	attunement
el entontecimiento	stultification
el entretejimiento	interweaving
la entrevía	"gauge, gage"
el entristecimiento	saddening
el episcopalismo	episcopacy
la escenógrafa	set designer
*** 3701 - 3710 (/course/195614/spanish-nouns-5/369/)	
el fusor	fuser
el garduño	sneak thief
(el)(la) gazuza	Gazuza
el gingko	ginkgo
la glotona	gluttonous
el golfín	Golfín
la golpeadora	striker
el granulocito	granulocyte
el grátil	luff
el guardasol	sunshade
*** 3681 - 3690 (/course/195614/spanish-nouns-5/370/)	
el escogimiento	culling
el espejeo	sheen
la esponjosidad	sponginess
el esportón	large basket
la estibina	stibnite
el estroboscopio	stroboscope
(el)(la) excanciller	former Foreign Minister
el excitador	exciter
la exesposa	ex-wife
la expendedora	"retailer, dealer"
*** 3691 - 3700 (/course/195614/spanish-nouns-5/371/)	
(el)(la) expolicía	ex-cop
el fabriquero	churchwarden
la felpilla	chenille
el fermentador	fermenter
la filfa	"canard, hoax"
(el)(la) filocomunista	pro-Communist
la fotoluminiscencia	photoluminescence
el frenólogo	phrenologist
la frigia	Phrygia
la frigoría	frigorie
*** 3711 - 3720 (/course/195614/spanish-nouns-5/372/)	
la guayabera	"loose shirt, guayabera"
la guindola	boatswain's chair
el hamburgués	Hamburg
la harpillera	"sacking, bagging"
la hedentina	stench
la hemorroísa	hemorrhage
la hidromancia	hydromancy
la hielera	"cool box, cooler"
la hipercapnia	hypercapnia
la hipoclorhidria	hypochlorhydria
*** 3731 - 3740 (/course/195614/spanish-nouns-5/373/)	
la inepta	inept
la infrecuencia	infrequency
el injertador	grafting
(el)(la) interiorista	interior
el jambaje	platband
el japón	Japan
el jimio	jimp
la jindama	funk
el kilohercio	kilohertz
el latitudinarismo	latitudinarianism
*** 3721 - 3730 (/course/195614/spanish-nouns-5/374/)	
el hiposulfito	hyposulphite
la hispanofilia	hispanophilia
la horcajadura	"crotch, fork"
el horcajo	"fork, yoke"
la hornaza	furnace
el ictiosauro	ichthyosaurus
la indefectibilidad	indefectibility
(el)(la) indicante	the indexing
la indivisa	undivided
la indochina	IndoChina
*** 3741 - 3750 (/course/195614/spanish-nouns-5/375/)	
el lavaje	Wash
el lebrijano	Lebrija
el legador	bequeather
la lionesa	Lyon
el listel	listello
la lítote	understatement
la llavera	wardess
el lobatón	Lobaton
el lulismo	Lullism
el lunario	lunary
*** 3751 - 3760 (/course/195614/spanish-nouns-5/376/)	
la luteína	lutein
la magrura	leanness
el magullamiento	bruising
el majá	pounder
la malagueta	allspice
la malasia	Malaysia
la maniquea	Manichean
el marión	Marion
el marrubio	horehound
la mayorazga	Mayorazga
*** 3761 - 3770 (/course/195614/spanish-nouns-5/377/)	
la mazada	buttermilk
(el)(la) memorista	memoirist
la metamatemática	metamathematics
(el)(la) mierdecilla	little shit
el miradero	vantage point
el mistagogo	mystagogue
el moqueo	runny nose
el morellano	Morella
el morfinismo	morphinism
la morquera	Morquera
*** 3771 - 3780 (/course/195614/spanish-nouns-5/378/)	
el mosconeo	droning
la mundología	savoir vivre
el muradal	Muradal
el musicógrafo	musicographer
el narigón	conk
la nasalidad	nasality
la neumática	pneumatics
la neurita	neurite
el neuroepitelio	neuroepithelium
la nictalopía	nyctalopia
*** 3781 - 3790 (/course/195614/spanish-nouns-5/379/)	
(el)(la) nororiental	Northeast
la numerosidad	numerosity
la ocultadora	concealing
el ocultador	"concealer, conspirator"
el oligoceno	Oligocene
la opalescencia	opalescence
(el)(la) osteópata	osteopath
la ostricultura	ostreiculture
la paidología	pedology
el pajarero	shinned
*** 3791 - 3800 (/course/195614/spanish-nouns-5/380/)	
la palamenta	Palamenta
el palpador	probe
el pancho	"paunch, belly, potbelly"
la pánfila	Panfilo
el pano	"cloth, towel"
el pantalonero	trouser
el paráclito	Paraclete
el paralizador	paralyser
el parro	parish
la partecita	small part
*** 3801 - 3810 (/course/195614/spanish-nouns-5/381/)	
(el)(la) pasota	person who couldn't care less
la paulina	Pauline
la payasa	"clown, buffoon, joker"
el pedorreo	farting
el pegado	band-aid
la peinada	combing
el percherón	"percheron, shire horse"
el perfeccionador	perfecter
el peripato	Peripato
el permitidor	enabler
*** 3811 - 3820 (/course/195614/spanish-nouns-5/382/)	
el petifoque	flying jib
el picogordo	hawfinch
el pincelito	flat
la piorrea	"pyorrhoea, pyorrhea"
la pirausta	Borer
el pistachero	"pistachio, pistache"
el planchazo	howler
la plastia	plasty
el plioceno	Pliocene
el pluscuamperfecto	"pluperfect, past perfect"
*** 3831 - 3840 (/course/195614/spanish-nouns-5/383/)	
la probabilística	probabilistic
el pródromo	prodrome
la profanadora	defiler
la proterva	wanton
la psicodinámica	psychodynamic
el quelato	chelate
la quisquillosidad	nitpicking
el quitador	remover
la rabera	tang
el rabinismo	rabbinism
*** 3821 - 3830 (/course/195614/spanish-nouns-5/384/)	
la podadora	lawn-mower
la podagra	podagra
el polisario	Polisario
la pomología	pomology
el pordioseo	begging
la portabandera	flagman
el porteo	portage
la posesora	possessor
el premiador	Rewarder
la prensadora	"press, pressing machine"
*** 3851 - 3860 (/course/195614/spanish-nouns-5/385/)	
el regularizador	regularizing
la remanga	rolls up
(el)(la) requirente	requesting
el resolutivo	operative
la respingona	snub
la retardadora	retardant
la retrógrada	retrograde
el retroproyector	overhead projector
la revesa	Revesa
el rezumo	oozing
*** 3861 - 3870 (/course/195614/spanish-nouns-5/386/)	
la ricahembra	Ricahembra
la rimbombancia	"bombast, flamboyance, flamboyancy"
la rinconera	"corner table, corner unit"
el ring	ring
el rodador	wheeler
(el)(la) rotulista	signwriter
la ruedecita	small wheel
la sabanilla	"piece of cloth, altar cloth"
el sacho	weeding hoe
la saladura	salting
*** 3841 - 3850 (/course/195614/spanish-nouns-5/387/)	
la raciocinación	ratiocination
la rajada	cracked
la ramilletera	flower girl
el ramoneo	browse
(el)(la) rapista	rapist
la ratera	"pickpocket, sneak thief, filcher"
el raticida	rat poison
la reculada	"backward movement, recoil, retreat"
(el)(la) reduccionista	reductionist
el regalador	gift-giver
*** 3871 - 3880 (/course/195614/spanish-nouns-5/388/)	
el salsifí	salsify
la sardinera	sardine
la sarnosa	mangy
el sesteo	siesta
el sextario	hin
la sienita	syenite
la siestita	nap
el silguero	Silguero
el sinergismo	synergism
el sobrenaturalismo	supernaturalism
*** 3881 - 3890 (/course/195614/spanish-nouns-5/389/)	
el sobrepuesto	appliqué
el solador	tiler
el solárium	solarium
el subalcaide	Assistant Warden
(el)(la) subjetivista	subjectivist
el suspensorio	jockstrap
el tacaño	"piker, miser, skinflint"
el tartajeo	stutter
la tarusa	Tarusa
la tempestividad	timeliness
*** 3891 - 3900 (/course/195614/spanish-nouns-5/390/)	
la tensón	Tenson
el termosifón	thermosyphon
la terpsícore	terpsichore
la tetraplejía	tetraplegia
el tetrápodo	tetrapod
el timol	thymol
el timonero	steersman
la tobillera	ankle support
el tocinero	pork butcher
la tofana	Tofana
*** 3901 - 3910 (/course/195614/spanish-nouns-5/391/)	
la tordella	Fieldfare
el tragador	swallower
el tramador	framer
la trapacera	tricky
(el)(la) trapisondista	"intriguer, fiddler"
la traquita	trachyte
el trasudado	transudate
el travelín	dolly
el trecén	Troezen
la tremolita	tremolite
*** 3911 - 3920 (/course/195614/spanish-nouns-5/392/)	
la tromboembolia	thromboembolism
el tropico	tropic
la trovera	Trovera
la tutía	Tuti
el urato	urate
el vacunador	vaccinator
el velarte	broadcloth
el ventalle	fanning
el ventanaje	windows
la verdasca	Verdasca
*** 3921 - 3930 (/course/195614/spanish-nouns-5/393/)	
la vilorta	lacrosse
el virólogo	virologist
la vituperadora	vituperative
la vocinglera	vociferous
el vocinglero	roarer
el zamarreo	shaking of
el zaparrastroso	scruffy
la zapatera	"shoemaker, cobbler"
el zoófito	zoophyte
la zurdera	left-handedness
*** 3941 - 3950 (/course/195614/spanish-nouns-5/394/)	
las alcohólicas	alcoholic
la alantoides	allantois
las amarantáceas	Amaranthaceae
los amazónicos	Amazon
la angiosperma	angiosperm
(el)(la) anexionista	annexationist
los antozoos	anthozoans
(el)(la) antifascista	anti-fascist
(los)(las) antifranquistas	antifrancoist
los antisueros	antisera
*** 3931 - 3940 (/course/195614/spanish-nouns-5/395/)	
el binóculo	prince-nez
el mariscador	gatherer of fish
la limonera	lemon tree
el acantocéfalo	acanthocephalan
los adoptadores	adopters
el ringorrango	"adornment, flourish"
el herrete	"aglet, tag"
los agnatos	agnates
el ambientador	air freshener
la aerovía	"airway, air route"
*** 3951 - 3960 (/course/195614/spanish-nouns-5/396/)	
el apoteósis	apotheosis
el manzanar	Apple Orchard
las arborescencias	arborescences
el reposabrazos	armrest
los ascomicetes	ascomycetes
los asistidos	assisted
los astrógrafos	astrographs
el respetable	audience
la autocatálisis	autocatalysis
las andaderas	baby-walker
*** 4021 - 4030 (/course/195614/spanish-nouns-5/397/)	
la psicofonía	EVP
la escoriación	excoriation
el fulminante	"explosive, squib"
el encadenado	"fading, dissolve"
los faliscos	Faliscans
los masoveros	farmers'
los pinreles	feet bare
los consiervos	fellow servants
las virolas	ferrules
el fiduciario	"fiduciary, trustee, executor"
*** 3981 - 3990 (/course/195614/spanish-nouns-5/398/)	
las calderadas	cauldronfuls
la celinda	Celinda
los centigramos	"centigram, centigramme"
la cinceladura	chiselling
la condritis	chondritis
las cromolitografías	chromolithographs
los crisopacios	chrysoprases
los cachuelos	chub
el aplaudidor	clapper
la azotalenguas	cleavers
*** 3991 - 4000 (/course/195614/spanish-nouns-5/399/)	
los celentéreos	coelenterates
los colúbridos	colubrids
(el)(la) connacional	compatriot
la lentilla	"contact lens, contact"
las copiadoras	copiers
los mastuerzos	"cress, dolt, dope"
el criptozoólogo	cryptozoologist
los ctenóforos	ctenophores
los culícidos	Culicidae
las salivaderas	cuspidors
*** 4001 - 4010 (/course/195614/spanish-nouns-5/400/)	
las aduaneras	customs
la ciclosis	cyclosis
los ciclóstomos	cyclostomes
los ciprínidos	cyprinids
la checa	"Czech, Cheka, secret police headquarters"
el decápodo	decapod
la dionisia	denise
la cajilla	deposit box
el discante	descant
la diatomea	diatom
*** 3961 - 3970 (/course/195614/spanish-nouns-5/401/)	
los comanditarios	backers
(el)(la) balear	"Balearic, Balearic Catalan"
el barnacla	barnacle
el baudio	baud
los crisomélidos	beetles
los chorreados	blasted
la moscarda	blow-fly
los zalameros	bootlicker
las bostonianas	Bostonians
las tornapuntas	braces
*** 4041 - 4050 (/course/195614/spanish-nouns-5/402/)	
los gádidos	gadoids
(el)(la) troj	garner
el acoplado	"gate crasher, crasher, camper"
el entretenido	"gigolo, toyboy"
la chismosa	"gossip, rumormonger, gossiping"
los arpeos	grapples
las alambreras	gratings
los urdidos	hatched
las hebdómadas	"hebdomad, week"
el helióstato	heliostat
*** 4011 - 4020 (/course/195614/spanish-nouns-5/403/)	
el digestor	digester
el desorganizador	disruptive
los tergiversadores	distorters
la descreencia	distrust
los azarbes	ditches
los vaguidos	dizzy spells
la dríada	dryad
la enchilada	enchilada
el epitelioma	epithelioma
los etesios	Etesian
*** 4091 - 4100 (/course/195614/spanish-nouns-5/404/)	
los miqueletes	Miqueletes
el descalce	mismatch
los maltratamientos	mistreatments
el mohicano	Mohicans
la monocotiledónea	monocot
(los)(las) monogenistas	monogenists
(el)(la) montanista	Montanist
las moráceas	Moraceae
el moreral	Moreral
los montaneros	mountaineers
*** 3971 - 3980 (/course/195614/spanish-nouns-5/405/)	
los braquicéfalos	brachycephalic
los bulímicos	bulimic
los bosquimanes	Bushmen
los entremetidos	busybodies
la callosidad	callosity
la campánula	"campanula, Canterbury bells, harebell"
las candeleras	candlesticks
las canonesas	canonesses
las cariofiláceas	cariophilaceous
los acarreadores	carriers
*** 4051 - 4060 (/course/195614/spanish-nouns-5/406/)	
el hemofílico	"hemophiliac, haemophiliac, bleeder"
los herbajes	HERBAJES
(el)(la) hermeneuta	hermeneut
(el)(la) hinduista	Hindu
(los)(las) hispanoárabes	Hispano
(el)(la) historicista	historicist
la malvarrosa	hollyhock
las holoturias	holothurians
los ganchitos	hooks
los fogajes	hot flashes
*** 4071 - 4080 (/course/195614/spanish-nouns-5/407/)	
(el)(la) judaizante	Judaist
los lacértidos	lacertids
(los)(las) laodicenses	Laodiceans
las lauráceas	lauraceae
los lavajos	Lavajos
la lanteja	Lenticular
las ligaciones	ligations
los gabarreros	lightermen
el calero	liming
las lináceas	Linaceae
*** 4031 - 4040 (/course/195614/spanish-nouns-5/408/)	
las filminas	filmstrips
la pínula	finlet
la grasera	fitting
las fijadoras	fixing
la convecina	flatmate
los flageladores	floggers
la plumada	"flourish, dash"
el trematodo	fluke
los esmerilados	frosted
el futón	futon
*** 4111 - 4120 (/course/195614/spanish-nouns-5/409/)	
los neuromas	neuroma
la neurosífilis	neurosyphilis
el tirado	no-hoper
el norcoreano	North Korean
los entumidos	numb
(el)(la) orangista	Orangeman
(los)(las) organicistas	organismic
(los)(las) origenistas	Origenists
(los)(las) paneslavistas	Panslavists
(el)(la) papista	papist
*** 4081 - 4090 (/course/195614/spanish-nouns-5/410/)	
los lorquinos	Lorca
(el)(la) lucense	Lugo
el lupino	lupine
los linchadores	lynchers
las queresas	maggots
la marinada	marinade
las meliáceas	Meliaceae
el mendocino	Mendoza
el esmerejón	merlin
(los)(las) microscopistas	microscopists
*** 4121 - 4130 (/course/195614/spanish-nouns-5/411/)	
el bajalato	pashalic
las pasifloráceas	Pasifloráceas
los pasamaneros	passementerie
los peroneos	peroneal
el enchufado	"person with pull, well-connected person, good old boy"
el peruanismo	Peruvianism
los pervertidores	perverting
(los)(las) petrarquistas	Petrarchan
(los)(las) filatelistas	philatelists
la fotolisis	photolysis
*** 4061 - 4070 (/course/195614/spanish-nouns-5/412/)	
el vociferador	Howler
los ictéridos	icterids
la analfabeta	illiterate
el ilirio	Illyrian
la indoeuropea	Indo-European
las interruptoras	interruptive
las isobaras	isobars
los italoamericanos	Italian Americans
la aguamala	jellyfish
la palanqueta	"jimmy, jemmy"
*** 4101 - 4110 (/course/195614/spanish-nouns-5/413/)	
el mullidor	mulcher
los mulateros	muleteers
la micobacteria	mycobacterial
la miositis	myositis
los misidáceos	mysids
los mixomicetes	myxomycetes
el nanoplancton	nanoplankton
las níspolas	naseberry
el nemertino	nemertean
la neura	Neuro
*** 4131 - 4140 (/course/195614/spanish-nouns-5/414/)	
las picias	Picias
las cochiqueras	pigsties
las echadas	pitches
los plantígrados	plantigrade
los emplastes	plasters
el desvalijador	Plunderer
(los)(las) poligenistas	polygenists
la polimiositis	polymyositis
las polipodiáceas	Polypodiaceae
el portalibros	Portalibros
*** 4141 - 4150 (/course/195614/spanish-nouns-5/415/)	
las preselecciones	presets
las primuláceas	primulaceae
el berrendo	pronghorn
el mojigato	"prude, prig, hypocrite"
los cuadernales	pulley
las cuartanas	quartan
el minutito	quick minute
(el)(la) transformista	quick-change artist
las radiotransmisiones	radio transmissions
los trasquilones	raggedly
*** 4151 - 4160 (/course/195614/spanish-nouns-5/416/)	
la semirrecta	ray
las saqueadoras	reavers
el radiorreceptor	"receiver, radioreceiver"
las rehalas	Rehal
el reimplante	reimplantation
el retocador	retoucher
los reóstatos	rheostats
los ribagorzanos	Ribagorza
los hurtadores	robbers
el rodelero	Rodelero
*** 4181 - 4190 (/course/195614/spanish-nouns-5/417/)	
el réflex	SLR
los ablandadores	softeners
la matadura	"sore, gall"
los atravesadores	spanners
el chispero	spark plug
el papelero	stationer
los esterilizadores	sterilizers
los fresales	strawberry plants
los subarrendadores	subletters
los subarrendatarios	subtenants
*** 4161 - 4170 (/course/195614/spanish-nouns-5/418/)	
la pitiriasis	rosea
la serba	"rowanberry, rowan, sorb"
el ruteno	Ruthenian
las roderas	ruts
el sabeo	"Sabaean, Sabean"
el portapliegos	sabretache
los samarios	samarium
las sapindáceas	Sapindaceae
el aserrado	sawing
los dispersores	scatterers
*** 4171 - 4180 (/course/195614/spanish-nouns-5/419/)	
la cuchar	Scoop
(los)(las) escotistas	Scotists
los cogedores	Scraping
(el)(la) semita	Semite
(los)(las) sensualistas	sensualist
los establecedores	setters
la filosa	sharp
el pocero	"sinker, pitman"
el salmer	skew
los mapurites	skunks
*** 4191 - 4200 (/course/195614/spanish-nouns-5/420/)	
los azufrados	sulfur
el supermodelo	supermodel
el superfosfato	superphosphate
el suplantador	supplanter
los tablares	Tablares
los tálpidos	talpids
el taraje	tare
los empajados	thatched
(los)(las) tercermundistas	Third
el cicatero	"tightwad, miser"
*** 4201 - 4210 (/course/195614/spanish-nouns-5/421/)	
los enmaderados	timbered
los bufónidos	toads
los tolmos	Tolmos
las tupayas	treeshrews
la llana	trowel
los colmillazos	tusks
el tirolés	Tyrolean
las úes	UES
la última	ultima
el trastornador	upsetting
*** 4211 - 4219 (/course/195614/spanish-nouns-5/422/)	
los varánidos	varanids
los varsovianos	Varsovians
el vivérrido	viverid
los caminadores	walkers
los anátidos	waterfowl
el yerbajo	weed
los casquivanos	whipper-snapper
los monteses	wildcats
los manojitos	wisps
