*** 1 - 10 (/course/195611/spanish-nouns-2-2/1/)	
el pliego	"(paper) sheet, tender/offer, note paper"
la miniserie	miniseries
el centenario	"centenary, centenarian, centennial"
el carril	"(traffic) lane, rail, track"
la motocicleta	motorcycle
el alcázar	"castel/palace, citadel/fortress, quarterdeck (naut.)"
la evaporación	evaporation
la cornisa	"cornice, ledge, overhang"
la rampa	"ramp, cramp, slope"
el cardo	"thistle, cardoon, (prickly person - fig.)"
*** 11 - 20 (/course/195611/spanish-nouns-2-2/2/)	
la constitucionalidad	constitutionality
la incredulidad	"incredulity, unbelief, disbelief"
el ombligo	"belly button, umbilicus, navel"
la canoa	canoe
el estribillo	"refrain, chorus"
la tónica	"tonic, basic tint/keynote/root note, mood"
el contrapunto	"counterpoint (mus), till stock/tailstock"
la exclusividad	"exclusivity, exclusive rights"
la estufa	"stove/cooker, heater, greenhouse"
la faja	"strip/girdle, wrapper, suspender belt"
*** 21 - 30 (/course/195611/spanish-nouns-2-2/3/)	
la insolencia	insolence
el prefijo	"prefix, code"
"la recomendación, el recomendado"	recommendation
el astillero	"shipyard, dockyard"
la escalinata	"outside staircase, perron"
la variabilidad	variability
el acueducto	aqueduct
la aroma	aroma
la pulpa	"pulp, flesh (p)"
el sesgo	"slant, bias"
*** 31 - 40 (/course/195611/spanish-nouns-2-2/4/)	
la alternancia	alternation
la inmersión	"immersion, dive"
la contundencia	"power of impact, force, forcefulness"
la cicatriz	cicatrice
la concertación	"agreement, pact (c)"
la glándula	gland
(el)(la) terrateniente	"landowner, landholder (t)"
el frontón	"fronton, wide forehead, gable"
el diluvio	"deluge, (the) flood, torrential rain"
la imputación	"imputation, accusation"
*** 41 - 50 (/course/195611/spanish-nouns-2-2/5/)	
el inmueble	"building,  immobile asset"
el racimo	"bunch, cluster (r)"
la duplicación	duplication
la familiaridad	"familiarity, informality"
la ánima ; el alma	"soul, spirit"
la deforestación	deforestation
el supervisor	supervisor
el atraso	"delay, backwardness, arrears"
el preparador	"(personal) tutor, trainer, preceptor"
el disimulo	"dissimulation, slyness"
*** 51 - 60 (/course/195611/spanish-nouns-2-2/6/)	
la enumeración	enumeration
la tortilla	"tortilla, omelette"
el mezquino	mean/stingy person; wart
la degeneración	"degeneration, degeneracy"
la zarzuela	"Spanish operetta, zarzuela, light opera"
la levita	"frock coat, Levite"
la vaina	sheath; pod (plant)
el artesano	"artisan, craftsman"
la fecundidad	"fecundity, fertility"
la estimulación	stimulation
*** 61 - 70 (/course/195611/spanish-nouns-2-2/7/)	
el boletín	"bulletin, journal, circular"
el ensueño	"dream, fantasy, reverie (e)"
el patronato	"patronage, board, board of trustees"
el reencuentro	"reencounter, reunion"
el chiquillo	"kid, nipper (ch)"
la zaga	"defence, back (side), rearguard (z)"
el americano	"American, café americano"
el cofre	"coffer, casket, chest"
el vivo	"alive one; cord, piping,"
"el amado, la amada"	beloved one
*** 71 - 80 (/course/195611/spanish-nouns-2-2/8/)	
el moscón	"blowfly, bluebottle, botfly"
el estiércol	"dung, manure, muck"
(el)(la) maya	"Maya, Mayan, daisy (f)"
la palidez	"paleness, pallor"
el salvamento	"salvage, rescue, saving"
el virreinato	"viceroyship, viceroyalty"
la suciedad	"dirtiness, filthiness"
el fogón	"stove, fireplace"
el supermercado	supermarket
la distensión	"distension, distention, detente"
*** 81 - 90 (/course/195611/spanish-nouns-2-2/9/)	
el epitelio	epithelium
la erección	"erection, setting up"
la neblina	"fog at soil level, haze, mist"
el vals	waltz
el karma	karma
el martín	"martin, kingfisher"
el embarque	"embarkation, loading, shopment"
la topología	topology
la lidia	"(bull)fight, struggle, battle"
la desilusión	"disillusion, disappointment"
*** 91 - 100 (/course/195611/spanish-nouns-2-2/10/)	
el puré	"puree, purée, paste"
el estremecimiento	"shiver, thrill, shudder (e)"
el colonialismo	colonialism
la garra	"claw, paw, talon"
la zanja	"ditch, trench (z)"
el individualismo	"individualism, individuality"
el precursor	"precursor, forerunner, harbinger"
el relanzamiento	relaunching
el antepasado	"ancestor, predecessor, forefather"
la subdivisión	"subdivision, subsection"
*** 101 - 110 (/course/195611/spanish-nouns-2-2/11/)	
la barrica	"cask, barrel (b)"
la correa	"strap, belt, lead (c, x cinturón)"
el mecenas	"maecenas, patron"
la consejera	"(fem.) counselor, adviser, councilor"
la subfamilia	subfamily
la sacristía	"vestry, sacristy"
el gancho	"hook, claw, accomplice (g)"
el latino	"Latin, Latino"
la malversación	"misappropriation, embezzlement, misuse"
el tonto	"fool, idiot (t)"
*** 111 - 120 (/course/195611/spanish-nouns-2-2/12/)	
la histeria	"hysteria, hysterical reaction, fit of hysteria"
la jura	"oath, pledge (j)"
las dieciséis	"sixteenth, sixteen"
el impresor	printer
el asma	asthma
el anta	"tapir, elk, anta (architecture)"
el tocino	"bacon, fat, marbling"
el reo	"accused, culpable, defendant"
el transmisor	"transmitter, sender"
la flexión	"flexion, flection, press-up"
*** 121 - 130 (/course/195611/spanish-nouns-2-2/13/)	
el insomnio	"insomnia, sleeplessness"
el malentendido	misunderstanding
el pecador	sinner
la alfabetización	"literacy, alphabetization, alphabetic order"
el maese	Master
el anfiteatro	"amphitheater, balcony, dissection hall"
el mazo	"mallet, pack, deck of cards"
el paracaídas	parachute
el marinero	"sailor, seaman, seafarer"
la carrocería	"bodywork, body, carriage shop"
*** 131 - 140 (/course/195611/spanish-nouns-2-2/14/)	
el directorio	"directory, directorate, board"
el exportador	exporter
el misticismo	mysticism
el sometimiento	"submission, subjugation"
el susurro	"whisper, rustle, murmur"
la angular	"angle, corner/recess; angle profile"
la reaparición	"recurrence, reappearance, return"
el analfabetismo	illiteracy
la acústica	acoustics
la sillería	"ashlar, chair making, chair shop"
*** 141 - 150 (/course/195611/spanish-nouns-2-2/15/)	
la psicosis	"psychosis, mental illness, mass psychosis"
la inactividad	"inactivity, dormancy, quiescence"
el yelmo	helmet
el perito	expert
la temeridad	"temerity, recklessness, impudence"
el armisticio	armistice
la repulsa	"repulse, rebuff, revulsion"
el torso	torso
el bono	"bond, award, bonus"
la calumnia	"libel, calumny, slander"
*** 151 - 160 (/course/195611/spanish-nouns-2-2/16/)	
el infortunio	"misfortune, mischance, adversity"
la cuelga	hanging (of fruit)
la antítesis	"antithesis, opposite"
la diana	"target, bull's-eye, reveille"
el lacayo	"lackey, footman, flunkey"
el léxico	"lexicon, vocabulary, glossary"
el páramo	"moor, heathland, moorland"
el opuesto	"opposite, inverse"
la elasticidad	"give, elasticity, resilience"
el coloquio	"colloquium, colloquy, conversation"
*** 161 - 170 (/course/195611/spanish-nouns-2-2/17/)	
el azote	"scourge, whip, lash"
el blasón	"blazon, crest, armorial bearings"
la avería	"damage, failure, breakdown"
la inmensidad	"immensity, immenseness"
(el)(la) delincuente	"offender, delinquent, culprit"
la entereza	"strength, self-possession, composure"
la reversión	reversion
el quite	"distraction, drawing away, parry"
la hormona	hormone
la plegaria	"prayer, supplication, pleading"
*** 171 - 180 (/course/195611/spanish-nouns-2-2/18/)	
el pub	"pub, bar"
el trazo	"stroke, line"
el extremismo	extremism
la galera	"galley, horse-drawn carriage, covered wagon"
el sufijo	"suffix, postfix"
el visir	vizier
el zinc	zinc
la pasarela	"catwalk, footbridge, gangway"
la injuria	"insult, slander, injury"
la calabaza	"pumpkin, gourd, calabash"
*** 181 - 190 (/course/195611/spanish-nouns-2-2/19/)	
el rapto	"abduction, kidnapping, rapture"
la hectárea	hectare
el traidor	"traitor, betrayer"
el antropólogo	anthropologist
la soltura	"skill, fluency, agility"
el curador	"curator, healer"
la problemática	"problem, difficulty, quandary"
el estrado	"dais, platform, stage"
el muñeco	"doll, puppet, dummy"
el estrato	"layer, stratum, stratus"
*** 191 - 200 (/course/195611/spanish-nouns-2-2/20/)	
la tanda	"series, round, batch"
el paisano	"country man, compatriot, civilian"
la ebullición	"boiling, ebullition, ebullience"
el altiplano	plateau
el plutonio	plutonium
la rectitud	"rectitude, fairness, honesty"
el comprador	"buyer, purchaser, shopper"
el contraataque	counterattack
el flash	"flash, flashback, newsflash"
el revuelo	"disturbance, stir, commotion"
*** 201 - 210 (/course/195611/spanish-nouns-2-2/21/)	
la nebulosa	"nebula, mist, haze"
la poetisa	poetess
la vivencia	experience
la abstinencia	"abstinence, abstention, withdrawal"
la próstata	prostate
la añadidura	"addition, annex, extra"
el fulgor	"glow, gleam, brilliance"
el poncho	poncho
la ternera	"veal, calf, heifer calf"
la osadía	"audacity, daring, boldness"
*** 211 - 220 (/course/195611/spanish-nouns-2-2/22/)	
la ventura	"fortune, luck, happiness"
(el)(la) tenista	tennis player
el brigadier	brigadier
la blancura	whiteness. white
el acorazado	"battleship, ironclad, dreadnought"
el pavor	"dread, terror"
la reencarnación	reincarnation
el mandamiento	"commandment, command, order"
el rehén	hostage
la profusión	"profusion, abundance, plenty"
*** 221 - 230 (/course/195611/spanish-nouns-2-2/23/)	
el pragmatismo	pragmatism
la virginidad	"virginity, maidenhood, maidenhead"
el yunque	"anvil, incus"
el emir	emir
el orificio	"orifice, hole"
el maremoto	"tidal wave, tsunami"
la indefensión	"defencelessness, helplessness"
la sábana	"sheet, bed sheet"
el mote	"nickname, moniker"
el educador	educator
*** 231 - 240 (/course/195611/spanish-nouns-2-2/24/)	
el etanol	ethanol
el féretro	"coffin, bier, pall"
la instrumentación	"instrumentation, orchestration, implementation"
la corrida	"run, bullfight, spunk"
la celebridad	"celebrity, renown, fame"
la epopeya	"epic, epos, saga"
la maleza	"undergrowth, brush, scrub"
el vuelco	"upset, overturning, capsizing"
la castilla	Castile
la ferocidad	"ferocity, savagery, fierceness"
*** 241 - 250 (/course/195611/spanish-nouns-2-2/25/)	
la urna	"urn, ballot box, vase"
la chiquilla	"kid, nipper"
la fundadora	foundress
la flaqueza	"frailty, failing, thinness"
la incineración	"incineration, cremation"
la lápida	"stone, tablet, tombstone"
el sobretodo	"raincoat, overcoat"
la juana	"grass, marijuana"
el epicentro	"epicenter, epicentre"
la carpeta	"folder, portfolio, file"
*** 251 - 260 (/course/195611/spanish-nouns-2-2/26/)	
el tapiz	"tapestry, carpet, wall hanging"
el erotismo	"eroticism, sexiness"
la evangelización	evangelism
la plancha	"iron, plate, slab"
el sabotaje	sabotage
el filólogo	philologist
el bordado	"embroidery, needlework, embroidered figure"
el aeródromo	"airfield, aerodrome, airdrome"
la sufra	backband
la incompatibilidad	incompatibility
*** 261 - 270 (/course/195611/spanish-nouns-2-2/27/)	
el polinomio	polynomial
el brindis	"toast, party"
la sensatez	"sanity, reasonableness, sobriety"
la butaca	"armchair, easy chair, theater seat"
el postgrado	postgraduate
la propensión	"propensity, leaning, disposition"
el refrán	"saying, proverb, adage"
la fealdad	"ugliness, eyesore, hideousness"
el antagonismo	"antagonism, hostility, opposition"
la hemorragia	"hemorrhage, haemorrhage, hemorrhage US"
*** 271 - 280 (/course/195611/spanish-nouns-2-2/28/)	
la ensalada	"salad, mixture, mixed salad"
la prontitud	"promptness, rapidity, quickness"
la falacia	"fallacy, lie"
el zumo	juice
el polímero	polymer
el presentimiento	"presentiment, feeling, foreboding"
la racionalización	"rationalization, rationalizing"
los sustituidos	substituted
el pincel	"brush, paintbrush"
el prisma	"prism, point of view, perspective"
*** 281 - 290 (/course/195611/spanish-nouns-2-2/29/)	
el comediante	comedian
el bastión	"bastion, bulwark"
la obstrucción	"blockage, obstruction, block"
la lujuria	"lust, carnal desire, self-indulgence"
el posicionamiento	positioning
el vestigio	"vestige, trace, hangover"
la arbitrariedad	"arbitrariness, arbitrary act, impulse"
la complicación	"complication, added difficulty, unforeseen difficulty"
el destello	"flash, sparkle, glint"
el conjuro	"incantation, spell, conjuration"
*** 291 - 300 (/course/195611/spanish-nouns-2-2/30/)	
el esmalte	"enamel, varnish, glaze"
la yuca	"cassava, agave, manioc"
el derribo	"demolition, the shooting down"
la aleación	alloy
la connotación	connotation
la hepatitis	hepatitis
la nacionalización	"nationalization, nationalisation, naturalization"
el almidón	starch
el limbo	limbo
el atrio	"atrium, hall, lobby"
*** 301 - 310 (/course/195611/spanish-nouns-2-2/31/)	
el estorbo	"hindrance, nuisance, impediment"
el alcantarillado	"sewerage, sewage system"
el invasor	invader
el níquel	nickel
la vacilación	"hesitancy, vacillation, hesitation"
la fonda	"inn, tavern, establishment"
el acordeón	accordion
la forja	"forge, forging, smithy"
el primitivo	primitive
la compraventa	"buying and selling, purchasing contract, second-hand store"
*** 311 - 320 (/course/195611/spanish-nouns-2-2/32/)	
el chalé	"chalet, villa, detached house"
el jaque	"check, checkmate, menace"
la campiña	countryside
la declinación	"declination, decline, declension"
el memorial	memorial
el palio	"pallium, pall, canopy"
la asfixia	"asphyxiation, asphyxia, suffocation"
el establo	"barn, stall, byre"
el pésame	condolence
la insulina	insulin
*** 321 - 330 (/course/195611/spanish-nouns-2-2/33/)	
el tocador	"dresser, powder room, jewellery box"
la periodicidad	"periodicity, regularity"
el saxofón	saxophone
la subclase	subclass
el perdedor	loser
la apología	"apology, apologia, defense of"
el zumbido	"buzzing, hum, ringing"
la demagogia	"demagogy, demagoguery"
los desaparecidos	the missing persons
la ingesta	"intake, consumption"
*** 331 - 340 (/course/195611/spanish-nouns-2-2/34/)	
el empiezo	"start, beginning"
el arrebato	"rapture, fury, fit"
la realeza	royalty
la herradura	horseshoe
la comadre	"midwife, mother, sister"
la prevaricación	"prevarication, perversion of justice"
el cociente	quotient
el soneto	sonnet
la impronta	"stamp, imprint, impression"
el surf	surfing
*** 341 - 350 (/course/195611/spanish-nouns-2-2/35/)	
la concienciación	"consciousness-raising, raising awareness"
la cartografía	"mapping, cartography"
la predicación	"preaching, predication"
la orfebrería	"working with precious metals, goldsmithing, silversmithing"
la puntería	"aim, marksmanship, aiming"
el cianuro	cyanide
la ponderación	"deliberation, praise"
el armazón	"frame, framework, armature"
la grava	"gravel, grit, loose stone"
el refinamiento	"refinement, polish, cruelty"
*** 351 - 360 (/course/195611/spanish-nouns-2-2/36/)	
el sarcasmo	"sarcasm, irony"
(el)(la) alguacil	"bailiff, sheriff, constable"
la cepa	"family, vine, grapevine"
la suegra	mother-in-law
la viruela	"pox, smallpox, variola"
la losa	"slab, flagstone, cement floor"
el tajo	"work, workplace, cut"
el llenado	fill
el jarro	"pitcher, mug, tankard"
el atolón	atoll
*** 361 - 370 (/course/195611/spanish-nouns-2-2/37/)	
el aforo	capacity (e.g. theater)
la carpa	"tent, carp, awning"
la enajenación	"alienation, disposal, transfer"
el florecimiento	"flowering, bloom, blossom"
el rodríguez	grass-widower
la inmovilidad	"immobility, stillness, immovability"
la indecisión	"indecision, hesitation, hesitance"
la obstinación	"obstinacy, recalcitrance, obduracy"
el diesel	diesel
el endurecimiento	"hardening, induration, hardness"
*** 371 - 380 (/course/195611/spanish-nouns-2-2/38/)	
el esparcimiento	"relaxation, recreation, amusement"
el sobresalto	"shock, fright, start"
el otorgamiento	"grant, bestowal"
la incompetencia	incompetence
la predilección	"predilection, partiality, penchant"
la desregulación	deregulation
el cochero	"coachman, cabman, cabbie"
la ceja	"eyebrow, brow, flange"
la viga	"beam, girder, joist"
la carnicería	"butcher shop, slaughter, butchery"
*** 381 - 390 (/course/195611/spanish-nouns-2-2/39/)	
el quiste	cyst
la prevalencia	prevalence
la capitulación	"capitulation, surrender, agreement"
la tipografía	"typesetting, typography, printing"
el biólogo	biologist
el bambú	bamboo
el pseudónimo	pseudonym
el gemido	"groan, moan, whimper"
(el)(la) trompeta	"trumpet (f), trumpeter"
la penuria	"penury, dearth, scarcity"
*** 391 - 400 (/course/195611/spanish-nouns-2-2/40/)	
el remolque	"towing, tow, trailer"
el trote	"trot, trotting"
(el)(la) pampa	"prairie (f), a tree of the Philippine Islands (m)"
la personificación	"personification, embodiment"
la pupila	"pupil (eye, student)"
el lastre	"ballast, liability, waste stone"
el contrabajo	"double bass, contrabass, double bass player"
el epígrafe	"epigraph, synopsis, summary"
la ínsula	insula
la resina	"resin, rosin, gum"
*** 401 - 410 (/course/195611/spanish-nouns-2-2/41/)	
el rabino	rabbi
el anticiclón	anticyclone
la entonación	"intonation, tone of voice, singing"
la barriada	"area, district, neighbourhood"
el espécimen	"specimen, sample, example"
el revestimiento	"coating, lining, facing"
la dilación	"delay, procrastination, dilation"
el vello	"hair, fuzz, down"
el mausoleo	"mausoleum, shrine"
la tubería	"pipeline, tubing, piping"
*** 411 - 420 (/course/195611/spanish-nouns-2-2/42/)	
la asesoría	"advice, counsel, consultant's office"
la misiva	missive
la esgrima	"fencing, swordsmanship, swordplay"
el calvario	"calvary, ordeal, stations of the cross"
la intoxicación	"poisoning, intoxication"
el novato	"rookie, newcomer, freshman"
la calavera	"skull, rake, skull and crossbones"
la psiquiatría	psychiatry
la socialización	socialization
la maña	"skill, habit, knack"
*** 421 - 430 (/course/195611/spanish-nouns-2-2/43/)	
la alienación	"alienation, derangement, insanity"
el obsequio	"gift, present"
el híbrido	"hybrid, cross"
la inhibición	inhibition
(el)(la) homicida	"murderer, homicide, murderess"
la diestra	right hand
la camarera	"waitress, chambermaid, barmaid"
el aseo	"cleanliness, tidiness, cleaning"
el derrame	"haemorrhage UK, hemorrhage US, bleeding"
la hipertensión	"hypertension, high blood pressure"
*** 431 - 440 (/course/195611/spanish-nouns-2-2/44/)	
la ornamentación	ornamentation
la brillantez	"brilliance, brilliancy, radiance"
la oscilación	"oscillation, swing, rocking"
(el)(la) demandante	"plaintiff, applicant, petitioner"
la torta	"cake, sandwich, slap"
el manjar	"delicacy, ambrosia, feast"
la insatisfacción	dissatisfaction
la ineficacia	"inefficacy, inefficiency, ineffectiveness"
las pasas	raisins
la revocación	"revocation, repeal, reversal"
*** 441 - 450 (/course/195611/spanish-nouns-2-2/45/)	
la estructuración	"structuring, organisation"
la sutileza	"subtlety, nicety, finesse"
el puñetazo	punch
el cocodrilo	crocodile
el desaliento	"dismay, discouragement, dejection"
la bonanza	"bonanza, fair weather, prosperity"
el magisterio	"faculty, teaching staff, education"
la homogeneidad	homogeneity
la venia	"consent, authorisation, permission"
la contingencia	"contingency, eventuality, possibility"
*** 451 - 460 (/course/195611/spanish-nouns-2-2/46/)	
el diafragma	"diaphragm, midriff, partition"
la omega	omega
la pandemia	pandemic
la beneficencia	"charity, beneficence, benefits"
el progenitor	"progenitor, ancestor"
la reliquia	"relic, vestige, dinosaur"
la sequedad	"dryness, curtness, brusqueness"
el refresco	"refreshment, refresher, soft-drink"
la estadía	"stay, residency"
el protestantismo	Protestantism
*** 461 - 470 (/course/195611/spanish-nouns-2-2/47/)	
el currículo	"curriculum, curriculum vitae, résumé"
el reembolso	"refund, reimbursement, cash on delivery"
el oleaje	"surf, surge, swell"
la inhabilitación	disqualification
el arrojo	"daring, spunk, courage"
el desfiladero	"gorge, pass, defile"
la tecla	"key, button"
(el)(la) vocal	"vowel (f), board member (m), chairperson (m)"
la consternación	"dismay, consternation"
el alegato	"allegation, argument, plea"
*** 471 - 480 (/course/195611/spanish-nouns-2-2/48/)	
el zaguán	"hallway, hall"
el escollo	"stumbling block, pitfall, barrier"
la matemática	mathematician
el usurpador	"usurper, imposter, masquerader"
el programador	programmer
la irradiación	irradiation
la sazón	"seasoning, ripeness"
el totalitarismo	totalitarianism
la alteza	"Highness, nobility"
(el)(la) contrincante	"opponent, adversary"
*** 481 - 490 (/course/195611/spanish-nouns-2-2/49/)	
el muestreo	sampling
la taxonomía	taxonomy
la quimera	"chimera, hallucination, pipe-dream"
la extremidad	"extremity, end, tip"
el ultimátum	ultimatum
el sueco	"Swedish, Swede"
la nodriza	"nurse, wet nurse, nursemaid"
el enjambre	"swarm, hive, crowd"
el anagrama	"anagram, logo"
el piqué	"pique, piqué"
*** 491 - 500 (/course/195611/spanish-nouns-2-2/50/)	
los ayudados	"the helped (ones, persons)"
la perspicacia	"perspicacity, insight, acumen"
la remolacha	"beetroot, beet"
la monotonía	"monotony, dreariness, monotone"
el despilfarro	"waste, wastefulness, extravagance"
el clasicismo	classicism
la cruzada	crusade
la preposición	preposition
el brinco	"leap, jump, hop"
la preponderancia	"preponderance, superiority"
*** 501 - 510 (/course/195611/spanish-nouns-2-2/51/)	
el quemado	"burn, scald"
la escucha	"wiretapping, interception, listening"
el cutis	"skin, complexion"
la magnificencia	"magnificence, grandeur"
la retina	retina
el palmo	"span, palm, hand"
la nena	"little child, kid"
el tirador	"handle, shooter, marksman"
el padrastro	"stepfather, stepparent, hangnail"
la torreta	turret
*** 511 - 520 (/course/195611/spanish-nouns-2-2/52/)	
el asentimiento	"assent, accession, concurrence"
el césar	Caesar
la extorsión	extortion
el gasoducto	"pipeline, gas pipeline"
el estigma	"stigma, blot, mark"
el párroco	"parish priest, rector, vicar"
el baluarte	"stronghold, bulwark, bastion"
el lavado	"washing, wash, cleaning"
la obligatoriedad	obligatory nature
el carrito	"cart, trolley, shopping cart"
*** 521 - 530 (/course/195611/spanish-nouns-2-2/53/)	
la delicia	"delight, joy, pleasure"
el periplo	"voyage, tour, journey"
el veterinario	"vet, veterinarian, veterinary"
la corrosión	"corrosion, rust, erosion"
la escoba	"broom, broomstick, brush"
el halo	"halo, aura"
el derredor	perimeter
la reapertura	reopening
la parcialidad	"bias, partiality, prejudice"
el billar	"billiards, pocket billiards, pool"
*** 531 - 540 (/course/195611/spanish-nouns-2-2/54/)	
el consistorio	consistory
la epístola	epistle
la ninfa	"nymph, cockatiel, quarrion"
la posta	"post, slug, relay"
el talón	"stub, bead, check"
la levadura	"yeast, leaven, leavening"
la viña	vineyard
la reutilización	reuse
el colectivo	"collective, group, lot"
el tórax	"thorax, chest"
*** 541 - 550 (/course/195611/spanish-nouns-2-2/55/)	
el racionalismo	rationalism
la crispación	"exasperation, tension, frayed nerves"
la onza	"ounce, snow leopard, square"
el ideario	ideology
la condecoración	"award, decoration, honor"
el cerrojo	"latch, bolt, lock"
el pronombre	pronoun
la barriga	"belly, potbelly, paunch"
el arrastre	"dragging, trawling"
el feudalismo	feudalism
*** 551 - 560 (/course/195611/spanish-nouns-2-2/56/)	
la pita	"pita fibre, hemp, pita bread"
el presbítero	presbyter
el ceño	"scowl, frown, space between the eyebrows"
el subconsciente	subconscious
el axioma	axiom
la chicharra	"cicada, bush cricket"
el desahogo	"relief, alleviation, solace"
el alfil	bishop
la desaceleración	"deceleration, slowing down"
el rubor	"flush, blush, blushing"
*** 561 - 570 (/course/195611/spanish-nouns-2-2/57/)	
el sanatorio	"sanitarium, sanatorium, hospital"
el estuario	estuary
el pensador	thinker
la neumonía	pneumonia
el listón	"strip, ribbon, batten"
el triunfador	"winner, success"
el rompecabezas	"puzzle, jigsaw, jigsaw puzzle"
la equiparación	comparison
la caricia	"caress, stroke, pat"
la longevidad	longevity
*** 571 - 580 (/course/195611/spanish-nouns-2-2/58/)	
la contraparte	opposing party
el plexo	plexus
el fusilamiento	"shooting, execution by firing squad"
el alumnado	"student body, pupils, students"
la gentileza	"gentleness, charm, courtesy"
(el)(la) liberal	"liberal, Liberal"
el eurodiputado	MEP
el envenenamiento	"poisoning, poison"
(el)(la) afluente	"affluent, tributary, influent"
la cancillería	"chancellery, chancery, ministry"
*** 581 - 590 (/course/195611/spanish-nouns-2-2/59/)	
el desembolso	"disbursement, outlay, expenditure"
el desencanto	"disenchantment, disillusionment, disappointment"
la infiltración	"infiltration, percolation"
el nicho	"niche, recess, alcove"
el pino	"pine, pin, skittle"
la vejiga	"bladder, blister"
la jarra	"jug, jar, carafe"
la intromisión	"meddling, intromission, interruption"
el anticipo	"advance, advance payment, anticipation"
las rebajas	"discount, rebate, reduction"
*** 591 - 600 (/course/195611/spanish-nouns-2-2/60/)	
el internamiento	internment
el oscar	Oscar
la quebrada	"ravine, brook, gully"
la emulación	"emulation, rival"
la ostentación	"ostentation, display, flashiness"
la sagacidad	"shrewdness, sagacity, cunning"
la camioneta	"van, wagon, estate car"
el carnicero	butcher
la cuantificación	quantification
el magnetismo	"magnetism, magnetic property, magnetic attraction"
*** 601 - 610 (/course/195611/spanish-nouns-2-2/61/)	
el rally	rally
la condensación	"condensation, reduction"
la prisionera	"prisoner, captive"
el conquistador	"conqueror, womanizer, Don Juan"
la irrigación	"irrigation, circulation, blood flow"
el chivo	"kid, young goat, plug"
la avena	"oat, oats"
la salvaguarda	safeguard
el primogénito	"firstborn, firstling"
el malvado	villain
*** 611 - 620 (/course/195611/spanish-nouns-2-2/62/)	
el chaval	"kid, lad, boy"
el terrón	"clod, lump, dregs"
el ciclón	"cyclone, hurricane, low"
la incomodidad	"discomfort, bother, inconvenience"
el chancho	"pig, hog, fat"
el villano	"villain, villein, baddy"
la esmeralda	emerald
el rezo	"prayer, praying"
el canje	"swap, trade, exchange"
el pop	pop (music)
*** 621 - 630 (/course/195611/spanish-nouns-2-2/63/)	
la revalorización	"revaluation, appreciation in value, increase"
la casaca	"dress coat, morning suit"
el parche	"patch, blotch, drumhead"
la coartada	"alibi, excuse"
el camello	"camel, dromedary, drug-pusher"
el micro	mike
el balde	"pail, bucket"
el títere	"puppet, marionette, puppet show"
la boga	"vogue, rage, trend"
la suficiencia	"adequacy, sufficiency, superiority"
*** 631 - 640 (/course/195611/spanish-nouns-2-2/64/)	
el silicio	silicon
la ancla	"anchor, rock, security"
la destilación	"distillation, distilling, result of distilling"
el escalofrío	"shudder, shiver, chill"
la ginebra	gin
el sarcófago	sarcophagus
la vasija	"vessel, crock, pot"
(el)(la) vodka	vodka
el pedagogo	pedagogue
el descrédito	"discredit, disparagement"
*** 641 - 650 (/course/195611/spanish-nouns-2-2/65/)	
el éter	ether
la evocación	"evocation, invocation"
el computador	computer
el adiestramiento	training
los añadidos	added
la sincronización	"timing, synchronization"
el estándar	standard
la habilitación	"adaptation, fitting out, authorisation UK"
el hada	fairy
el andén	"platform, quayside, pavement"
*** 651 - 660 (/course/195611/spanish-nouns-2-2/66/)	
el regala	gunnel
el subgrupo	subgroup
la ducha	"shower, shower head"
el arquetipo	archetype
la zanahoria	carrot
la devastación	"devastation, destruction"
la disparidad	"gap, disparity"
la pulgada	inch
la ingestión	"ingestion, consumption, swallowing"
el púlpito	"pulpit, platform, stage"
*** 661 - 670 (/course/195611/spanish-nouns-2-2/67/)	
el shock	shock
la alucinación	hallucination
la sucesora	successor
el magnesio	magnesium
el ramillete	"small bunch, bouquet, handful"
el activismo	activism
el baúl	"trunk, chest, boot"
la lona	"canvas, sailcloth, tarpaulin"
la materialización	materialization
el proverbio	"proverb, adage"
*** 671 - 680 (/course/195611/spanish-nouns-2-2/68/)	
el reporte	"report, news, log file"
la usurpación	"usurpation, encroachment, misappropriation"
la irlanda	Ireland
la versatilidad	"versatility, flexibility, adaptability"
la asesora	"adviser, consultant, moderator"
el ras	"brim, rim"
el portón	"gate, tailgate, hatch"
la idolatría	"idolatry, idolism, worship"
el loto	"lotus, lotto"
el esbozo	"outline, illustration, sample"
*** 681 - 690 (/course/195611/spanish-nouns-2-2/69/)	
la mesita	small table
la caseta	"stand, stall, cabin"
el subgénero	subgenus
la apatía	"apathy, inertia"
el esperanto	"Esperanto, esperanto"
el enterramiento	burial
la caligrafía	"calligraphy, hand, penmanship"
la filología	philology
el rugido	"roar, roaring, bellow"
el platillo	"saucer, dish, cymbal"
*** 691 - 700 (/course/195611/spanish-nouns-2-2/70/)	
la esquizofrenia	schizophrenia
(el)(la) taxista	"taxi driver, cabby, cabbie"
la urbanidad	"urbanity, civility, courtesy"
el simulador	"simulator, pretender"
la ultraderecha	extreme right
la datación	dating
el predicado	predicate
el ancestro	ancestor
el geógrafo	geographer
la escolarización	"going to school, school attendance"
*** 701 - 710 (/course/195611/spanish-nouns-2-2/71/)	
el ámbar	amber
la depreciación	"depreciation, devaluation, fall"
la interdependencia	interdependence
la secesión	"secession, split, departure from"
la conejera	"warren, hutch, rabbit hutch"
la gorriona	sparrow
el ábaco	"abacus, sloping trough, buddle"
la defensora	"defender, advocate, proponent"
(el)(la) dibujante	"draftsman, cartoonist"
el seductor	"handsome devil, seducer"
*** 711 - 720 (/course/195611/spanish-nouns-2-2/72/)	
la lisis	lysis
la chapa	"veneer, sheet, plate"
el patinaje	"skating, skateboarding, skid"
la peligrosidad	"dangerousness, riskiness, danger money"
el atlas	atlas
el cadete	"cadet, young player, teenage sportsperson"
la fisión	fission
el reducto	"redoubt, citadel, bastion"
el tempo	tempo
la pubertad	puberty
*** 721 - 730 (/course/195611/spanish-nouns-2-2/73/)	
la sedación	sedation
la templanza	"temperance, calm, level-headedness"
la coraza	"armor, cuirass, breastplate"
la deserción	"defection, desertion, abandonment"
el heno	hay
el letargo	"lethargy, torpor, stagnation"
la sugestión	"suggestion, recommendation"
la turbina	turbine
el resguardo	"guard, stub, ticket"
la hipoteca	"mortgage, mortgage payment"
*** 731 - 740 (/course/195611/spanish-nouns-2-2/74/)	
el ovario	ovary
la rareza	"rarity, oddity, rareness"
el remanente	"remainder, remains, excess"
el ateísmo	atheism
el papado	papacy
el raso	satin
la amonestación	"admonition, warning, admonishment"
la retransmisión	"broadcast, retransmission"
la litera	"bunk, bunk bed, litter"
el granizo	"hail, hailstones"
*** 741 - 750 (/course/195611/spanish-nouns-2-2/75/)	
el empujón	"push, shove, heave"
la culebra	"snake, serpent, scuffle"
la repartición	"distribution, division, redistribution"
el green	green
la interrogación	"question, interrogation, inquiry"
el bibliotecario	librarian
el desamparo	"abandonment, neglect, helplessness"
la avioneta	"small plane, light aircraft"
el maletín	"briefcase, attache case, doctor's bag"
el cloro	chlorine
*** 751 - 760 (/course/195611/spanish-nouns-2-2/76/)	
el conteo	"count, counting, amount owed"
la efigie	"effigy, likeness, picture"
la saña	"fury, cruelty, blind rage"
el desasosiego	"unrest, anxiety, disquietude"
el guiño	"wink, blinker, turn signal"
el boticario	"apothecary, druggist"
la conjetura	"guess, conjecture, surmise"
la odisea	"Odyssey, an epic, epic journey"
la osa	she-bear
la hostelería	hotel industry
*** 761 - 770 (/course/195611/spanish-nouns-2-2/77/)	
la gaita	"bagpipes, musette, pipes"
la guisa	"guise, wise, way"
la montura	"mount, frame, rim"
la intencionalidad	intentionality
la analizada	analyzed
la gerencia	"management, term of office, post of manager"
el tracto	tract
la pretemporada	preseason
la cadencia	"cadence, cadenza, pulse"
la calamidad	"calamity, disaster, disaster area"
*** 771 - 780 (/course/195611/spanish-nouns-2-2/78/)	
la borrachera	"drunkenness, binge, inebriation"
el epílogo	"epilogue, epilog"
la desventura	"misfortune, trouble"
la nevada	"snowfall, snowstorm"
la tributación	"taxation, tax, taxing"
la condenación	"damnation, condemnation, sentence"
el empeoramiento	"deterioration, worsening"
(el)(la) vigilante	"guard, caretaker, keeper"
el manicomio	"madhouse, asylum, institution"
la anemia	"anemia, anaemia, low blood count"
*** 781 - 790 (/course/195611/spanish-nouns-2-2/79/)	
el cedro	cedar
la copla	"couplet, verse, ballad"
el padrón	"census, electoral roll, register of inhabitants"
la prótesis	"prothesis, prosthesis, hearing aid"
el taxón	taxon
la vicepresidencia	vice
la sigla	initial
la incubación	"incubation, hatching"
el letrero	"signboard, sign, nameplate"
la bofetada	"slap, slap in the face, insult"
*** 791 - 800 (/course/195611/spanish-nouns-2-2/80/)	
la labranza	"tillage, farming, husbandry"
los premiados	winners
la alquería	"farmstead, farm, farmhouse"
el microprocesador	microprocessor
el montante	"upright, stanchion, strut"
el elector	"elector, constituent"
la internacionalización	internationalization
el menosprecio	"scorn, disdain, contempt"
la rivera	"brook, stream, creek"
el colon	"colon, obviously!"
*** 801 - 810 (/course/195611/spanish-nouns-2-2/81/)	
(el)(la) fiera	"clawed beast of prey, wild animal (f), brute"
el aprovisionamiento	"provisions, supplies"
la sacada	taken
la cautividad	captivity
el chileno	Chilean
la arista	"edge, awn, arista"
la floración	"flowering, bloom, blooming"
la genealogía	"genealogy, pedigree, family tree"
el promontorio	"headland, promontory, foreland"
los adentros	himself
*** 811 - 820 (/course/195611/spanish-nouns-2-2/82/)	
el barullo	"hubbub, racket, din"
la mutilación	"mutilation, amputation"
el pellejo	"skin, hide, pelt"
el brío	"verve, mettle, fight"
el coreógrafo	choreographer
el absolutismo	absolutism
el celibato	"celibacy, celibate person, bachelor"
la brújula	"compass, ship's compass"
la diarrea	"diarrhea, diarrhoea"
el desliz	"slip, lapse, indiscretion"
*** 821 - 830 (/course/195611/spanish-nouns-2-2/83/)	
el metano	methane
el abatimiento	"dejection, abasement, despondency"
la casona	"mansion, large house"
la perversión	"perversion, depravity, kink"
el morro	"snout, nose, headland"
la jardinería	gardening
el desagrado	displeasure
el master	"master copy, master's degree"
el prest	perst
el albañil	"mason, bricklayer, stonemason"
*** 831 - 840 (/course/195611/spanish-nouns-2-2/84/)	
el garcía	garcia
los anales	"annals, annual report"
el cloruro	chloride
el desnivel	"gradient, incline, slope"
el adivino	"seer, soothsayer, diviner"
el stock	stock
el populismo	populism
la coproducción	co-production
el desmayo	"fainting, swoon, fainting fit"
el positivismo	"positivism, positivity"
*** 841 - 850 (/course/195611/spanish-nouns-2-2/85/)	
el presbiterio	presbytery
el almacenaje	"storage, warehouse, godown"
el conservadurismo	"conservatism, fear of change"
la piña	"pineapple, pinecone, cone"
la matriculación	"registration, matriculation, enrolment"
el alcaide	"warden, governor, head of a corn exchange"
el portador	"bearer, carrier"
el sintetizador	"synthesizer, synth"
los acogidos	welcome
la inferencia	"inference, implication"
*** 851 - 860 (/course/195611/spanish-nouns-2-2/86/)	
la paranoia	"paranoia, obsession, mania"
la colación	"collation, congregation, body of parishioners"
el filtrado	percolation
el ritual	ritual
el naturalismo	naturalism
la aniquilación	"annihilation, extermination, destruction"
el manojo	"bunch, bundle, handful"
la barraca	"cabin, hut, barrack"
el mosaico	"mosaic, kaleidoscope, assortment"
la superposición	"overlap, superposition"
*** 861 - 870 (/course/195611/spanish-nouns-2-2/87/)	
la osamenta	"skeleton, bones"
la peluca	wig
la negociadora	negotiator
(el)(la) hindú	"Hindu, Hindoo"
el inquilino	"tenant, renter, lodger"
el murciélago	bat
el folklore	folklore
el secado	drying
la canalización	"channelling, scoring, grooving"
el presagio	"harbinger, omen, sign"
*** 871 - 880 (/course/195611/spanish-nouns-2-2/88/)	
la pizca	"pinch, whit, dash"
la plebe	"rabble, plebs, hoi polloi"
el tapete	"rug, mat, carpet"
el western	"western, Western"
el caserón	"big dump of a place, big ramshackle house, barracks of a house"
la caminata	"hike, walk, long walk"
el vivero	"nursery, vivarium, garden centre"
(el)(la) pantera	panther
(el)(la) sirviente	"servant, attendant, sergeant-at-arms"
la sinagoga	synagogue
*** 881 - 890 (/course/195611/spanish-nouns-2-2/89/)	
la acreditación	"credentials, certification, accreditation"
el islamismo	Islam
el recopilatorio	compilation
el sobrepeso	"overweight, overloading"
el subcampeonato	"runner-up, second place"
el autómata	"automaton, robot"
la merma	"decrease, waste, shrinkage"
el sinfín	"endless number, endless amount"
(el)(la) maquinista	"engineer, machinist, machine operator"
la fijeza	"fixity, firmness, fixedness"
*** 891 - 900 (/course/195611/spanish-nouns-2-2/90/)	
la incomprensión	incomprehension
el palenque	"palisade, wooden fence, fence"
el cuarzo	quartz
la baba	"slime, spittle, slobber"
la estepa	steppe
el milord	milord
la interrelación	interrelation
el versículo	verse
la valorización	"valorization, appraisal, valuation"
el nacional	national
*** 901 - 910 (/course/195611/spanish-nouns-2-2/91/)	
el calificativo	"description, qualifier"
la antipatía	"dislike, antipathy, unpleasantness"
la azotea	"flat roof, head, upstairs"
el tenedor	"holder, fork, bearer"
el mecanizado	machining
la sobredosis	overdose
la subversión	subversion
el girasol	sunflower
la anestesia	"anesthesia, anaesthetic, general"
el pliegue	"crease, fold, pleat"
*** 911 - 920 (/course/195611/spanish-nouns-2-2/92/)	
(el)(la) ultra	"extremist, fanatic"
la fragancia	"fragrance, aroma"
la pesadumbre	"grief, sorrow"
la medicación	"medication, treatment"
el peregrinaje	pilgrimage
la hoz	sickle
el mantel	"tablecloth, cloth"
el venezolano	Venezuelan
la complementariedad	complementarity
la simbología	"symbols, symbology"
*** 921 - 930 (/course/195611/spanish-nouns-2-2/93/)	
el box	"bay, examination room, cubicle"
el cargador	"charger, battery charger, magazine"
el cisma	"schism, split, disagreement"
la eslora	length
la interconexión	"interconnection, connection"
el seso	"brain, brains, sense"
el traste	"fret, cooking utensil"
la sangría	"indentation, bleeding, bloodletting"
la señoría	"ladyship, lordship, gentleman"
el jeque	"sheikh, sheik"
*** 931 - 940 (/course/195611/spanish-nouns-2-2/94/)	
el helio	helium
el inválido	"invalid, cripple"
(el)(la) cabecilla	"ringleader, leader, leading"
el altavoz	"speaker, loud-speaker, microphone"
la verbena	"verbena, vervain, festival"
la adversidad	"adversity, setback"
el atuendo	"attire, dress"
los británicos	British
el químico	chemist
el contrapeso	"counterbalance, counterweight, counterpoise"
*** 941 - 950 (/course/195611/spanish-nouns-2-2/95/)	
la joyería	"jewelry, jewelry store, jeweller´s"
la mostaza	"mustard, Chinese cabbage, mustard greens"
la cuñada	sister-in-law
el comic	comic
el libertador	liberator
la inexperiencia	inexperience
el subdesarrollo	underdevelopment
el receso	"break, pause, recess"
la excomunión	excommunication
la expiación	"expiation, atonement"
*** 951 - 960 (/course/195611/spanish-nouns-2-2/96/)	
el feminismo	feminism
el oboe	oboe
la foca	"seal, sealskin, cow"
la tapia	"wall, garden wall"
el competidor	"competitor, rival, contestant"
el esclarecimiento	"elucidation, clearing up, explanation"
el búho	"owl, great horned owl, long-eared owl"
la trinchera	"trench, entrenchment, trench coat"
el estereotipo	"model, stereotype, type"
el afincado	settled
*** 961 - 970 (/course/195611/spanish-nouns-2-2/97/)	
el egresado	graduate
la acuicultura	aquaculture
el procesado	"accused, processing, defendant"
el centímetro	"centimeter, centimetre, tape measure"
el cobijo	"shelter, refuge"
(el)(la) carroza	"float (f), coach (f), carriage (f)"
la mediocridad	"mediocrity, nonentity"
la escayola	"plaster, plastering, scagliola"
el porche	porch
la llaga	"sore, ulcer, stigmata"
*** 971 - 980 (/course/195611/spanish-nouns-2-2/98/)	
la impresora	printer
las administraciones	"administration, management, admin"
la traslación	"passage, movement, translation"
los ejemplares	"specimen, copy, exemplar"
el néctar	"fruit juice drink, nectar"
la cha	shah
el soborno	"bribery, subornation, bribe"
el liceo	"high school, lyceum"
la grafía	"spelling, letter, graphical symbol"
la maraña	"tangle, entanglement, skein"
*** 981 - 990 (/course/195611/spanish-nouns-2-2/99/)	
el bagaje	"baggage, knowledge, experience"
la perforación	"drilling, piercing, perforation"
la bulla	"noise, fuss, racket"
el vástago	"offspring, descendants, shoot"
el voluntariado	volunteering
la bobina	"bobbin, coil, reel"
el aguacero	"downpour, rain shower"
el discernimiento	"judgement, judgment"
la parábola	"parable, parabola"
la ambientación	setting
*** 991 - 1000 (/course/195611/spanish-nouns-2-2/100/)	
el duende	"elf, goblin, hobgoblin"
el jaguar	"jaguar, Jaguar"
la soldadura	"weld, solder, welding"
el yate	yacht
el pueblito	"little town, little village"
la temporalidad	"temporality, temporary nature, short-term nature"
la nitidez	"sharpness, clarity, definition"
el cimiento	"foundation, base, substructure"
la estrechez	"narrowness, tightness, closeness"
el cesto	"basket, hamper, hoop"
*** 1001 - 1010 (/course/195611/spanish-nouns-2-2/101/)	
la caducidad	"expiration, expiry"
el ligamento	ligament
la traba	"obstacle, hindrance"
la tenida	"outfit, suit"
el recordatorio	"reminder, commemorative card"
(el)(la) socialdemócrata	social democrat
el lloro	"crying, weeping, tears"
el veintiséis	"twenty-six, twenty-sixth"
el acoplamiento	"hook-up, coupling, fitting together"
el potrero	"paddock, cowboy, pasture"
*** 1011 - 1020 (/course/195611/spanish-nouns-2-2/102/)	
la plática	"talk, chat, discourse"
la porquería	"filth, muck, rubbish"
la madrina	"godmother, maid of honour, patroness"
el pasatiempo	"hobby, pastime, amusement"
el alfiler	"pin, stickpin, hatpin"
la descalificación	disqualification
el beneficiado	beneficiary
el cross	cross-country
la diputación	"deputation, council, council office"
el dividendo	dividend
*** 1021 - 1030 (/course/195611/spanish-nouns-2-2/103/)	
las andas	"frame, platform"
el pasadizo	"passageway, catwalk, passage"
el purgatorio	"purgatory, hell, living hell"
el escalafón	"scale, salary scale, promotion ladder"
la radioterapia	radiotherapy
el delantal	"apron, smock, smock UK"
(el)(la) practicante	assistant
la cisterna	"cistern, tank"
(el)(la) descendiente	"offspring, descendant"
la penalización	"penalty, forfeit, penalization"
*** 1031 - 1040 (/course/195611/spanish-nouns-2-2/104/)	
(el)(la) pirata	"pirate, privateer, corsair"
el repudio	"repudiation, disavowal, rejection"
la bañera	"tub, bathtub, bath"
la verosimilitud	"verisimilitude, plausibility, truth"
el crucifijo	crucifix
la alfarería	pottery
el mentón	chin
la cordialidad	"cordiality, heartiness"
el acopio	"gathering, accumulation, supply"
la logia	"lodge, society"
*** 1041 - 1050 (/course/195611/spanish-nouns-2-2/105/)	
la prerrogativa	"prerogative, privilege"
el emulador	rival
el trineo	"sleigh, sledge, sled"
el peldaño	"step, rung, stair"
la inutilidad	"uselessness, futility, pointlessness"
la mucosa	mucus
el arzobispado	archiepiscopate
la desesperanza	hopelessness
la incitación	incitement
la despensa	"pantry, buttery, larder"
*** 1051 - 1060 (/course/195611/spanish-nouns-2-2/106/)	
el perejil	parsley
(el)(la) mimbre	"wicker, willow, osier"
el tornillo	"screw, bolt"
la sucursal	"branch office, branch, subsidiary"
la pesadez	"heaviness, weight, tedium"
la marta	"sable, marten, pine marten"
el sprint	sprint
el neoliberalismo	neoliberalism
el camping	"camping, campsite, camp"
el promotor	"developer, promoter, forwarder"
*** 1061 - 1070 (/course/195611/spanish-nouns-2-2/107/)	
el gallego	"Galician, Galician language"
la validación	"validation, ratification, approval"
el veintisiete	"twenty-seven, twenty-seventh"
la dilatación	"dilatation, expansion, dilation"
el transbordador	"ferry, ferryboat"
el contratiempo	setback
el autoritarismo	authoritarianism
la ganadora	winner
el reformador	reformer
la confiscación	confiscation
*** 1071 - 1080 (/course/195611/spanish-nouns-2-2/108/)	
el dueto	duet
el montículo	"mound, hillock, knoll"
el repunte	"rise, recovery, upturn"
la sigma	sigma
los pesares	"sorrow, regret"
el termómetro	thermometer
el melodrama	melodrama
la reticencia	"reluctance, reticence, reservations"
la pava	"kettle, turkey hen, teapot"
el caló	language of Spanish gypsies
*** 1081 - 1090 (/course/195611/spanish-nouns-2-2/109/)	
la metalurgia	metallurgy
el serial	serial
la socialdemocracia	Social
el sorgo	sorghum
la presteza	"alacrity, quickness, promptness"
el contragolpe	"counter-blow, counter-attack"
los enseres	"basic tools, necessities, essentials"
el bullicio	"bustle, hustle, uproar"
el aplomo	"composure, aplomb"
la sonata	sonata
*** 1091 - 1100 (/course/195611/spanish-nouns-2-2/110/)	
la reinserción	reintegration
el nitrato	nitrate
el abordaje	"boarding, approach, collision"
la píldora	"bombshell, pill, contraceptive pill"
el condicionamiento	"conditioning, training, restriction"
el carajo	"a damn, a fig, a dime"
los mundiales	world
el benefactor	benefactor
la batuta	baton
el estuche	"kit, box, case"
*** 1101 - 1110 (/course/195611/spanish-nouns-2-2/111/)	
(el)(la) marroquí	Moroccan
la guardería	"nursery, nursery school, daycare center US"
el cartero	"postman, mailman, mail carrier"
la sonoridad	"sonority, sound, acoustics"
el garrote	"stick, walking stick, club"
la espesura	"thickness, thicket, density"
el gatito	"kitten, pussy"
la desidia	"carelessness, slovenliness, apathy"
la dispensa	exemption
el capullo	"bud, cocoon, helmet"
*** 1111 - 1120 (/course/195611/spanish-nouns-2-2/112/)	
los comprados	purchased
la mecha	"wick, fuse, match"
el automovilismo	"motoring, automobile industry, motorcar industry UK"
el tesón	"tenacity, firmness, determination"
la épica	epic genre
la pulga	"flea, roll, sandwich"
el subconjunto	subset
el tatuaje	tattoo
la mortandad	"loss of life, death"
el clítoris	clitoris
*** 1121 - 1130 (/course/195611/spanish-nouns-2-2/113/)	
el determinismo	determinism
la finura	"finesse, fineness, subtlety"
la intransigencia	intransigence
(el)(la) participante	"participant, contestant"
el chiquero	"pigsty, bull pen"
el escarmiento	"punishment, lesson, example"
los asentados	seated
el republicano	republican
la desestabilización	destabilization
la gratuidad	free
*** 1131 - 1140 (/course/195611/spanish-nouns-2-2/114/)	
la empuñadura	"handle, opening, start"
la carpintería	"woodwork, carpentry, joinery"
el controlador	controller
la representatividad	representation
la fragua	"forge, workshop"
la cuchilla	"knife, blade, razor blade"
la mofa	"mockery, ridicule, taunt"
la preeminencia	preeminence
el tedio	"tedium, boredom, ennui"
el tensor	"tensor, tensioner, chest pull"
*** 1141 - 1150 (/course/195611/spanish-nouns-2-2/115/)	
el frenesí	"frenzy, fury, madness"
(el)(la) reptil	"reptile, reptilian, creep"
la trinidad	trinity
el sindicalismo	syndicalism
el pisco	"grape liquor, pisco"
la corola	corolla
la orgía	"orgy, gang bang, spree"
el zócalo	"plinth, skirting board, baseboard"
la recaída	"relapse, setback, lapse"
el hastío	"weariness, boredom"
*** 1151 - 1160 (/course/195611/spanish-nouns-2-2/116/)	
el cubano	Cuban
la idoneidad	"suitability, aptitude"
la bailarina	"ballerina, dancing girl"
la disociación	dissociation
la tibieza	"lukewarmness, tepidness"
la crudeza	"rawness, crudity, bitterness"
la ruleta	roulette
el sacristán	"sexton, sacristan, verger"
la opulencia	"affluence, opulence, luxury"
la castellana	Spanish
*** 1161 - 1170 (/course/195611/spanish-nouns-2-2/117/)	
el hermanastro	"stepbrother, half-brother"
el arancel	"tariff, duty"
el mirador	"viewpoint, vantage point, bay window"
el bufete	"lawyer's office, desk, sideboard"
la cinematografía	"cinematography, works on film, movies"
el despojo	"dispossession, spoliation, divestment"
el pin	"pin, badge, prong"
el caramelo	"candy, caramel, toffee"
el compartimiento	"compartment, bin"
el torreón	"keep, turret, fortified tower"
*** 1171 - 1180 (/course/195611/spanish-nouns-2-2/118/)	
la metralla	"shrapnel, grapeshot"
el camarote	"stateroom, cabin, berth"
la camilla	"stretcher, litter, pallet"
el barbero	"barber, hairdresser"
la abdicación	abdication
la contrariedad	"annoyance, contrariness, obstacle"
el arribo	arrival
la ocultación	"concealment, occultation, hiding"
el páncreas	pancreas
el trampolín	"springboard, trampoline, ski jump"
*** 1181 - 1190 (/course/195611/spanish-nouns-2-2/119/)	
la golondrina	"swallow, motor launch"
el antídoto	antidote
el medioambiente	environment
el retardo	delay
el códice	codex
la embestida	"onslaught, onrush, charge"
la senadora	senator
la condonación	condonation
la despoblación	depopulation
la afinación	"tuning, refining, polishing"
*** 1191 - 1200 (/course/195611/spanish-nouns-2-2/120/)	
la incoherencia	"incoherence, inconsistency, nonsense"
la lupa	"magnifying glass, lens"
la sartén	"pan, frying pan, skillet"
la refinería	refinery
el musical	musical
el cóctel	"cocktail, cocktails"
la consejería	"ministry, regional ministry, office"
la lactancia	"nursing, lactation, breastfeeding period"
el gatillo	"trigger, forceps, clamp"
el gemelo	"twin, calf muscle"
*** 1201 - 1210 (/course/195611/spanish-nouns-2-2/121/)	
la alumna	schoolgirl
el gentío	"crowd, throng, mob"
la selectividad	selectivity
la grosería	"coarseness, rudeness, vulgarity"
la imperfección	"imperfection, flaw, defect"
la citación	"subpoena, summons, citation"
la catarata	"waterfall, cataract, cataracts"
la redonda	"whole note, semibreve, traffic circle US"
el peludo	"furry, armadillo, booze-up"
la indigencia	"indigence, destitution, need"
*** 1211 - 1220 (/course/195611/spanish-nouns-2-2/122/)	
la mandada	sent
la amalgama	"amalgam, cultural fusion, melting-pot"
la indagación	"inquiry, quest, inquest"
el papiro	"papyrus, papyrus scroll, papyrus manuscript"
el menoscabo	"reduction, lessening, drop"
el evacuado	evacuated
el iniciador	"initiator, pioneer, primer"
la ostra	oyster
el enjuiciamiento	"prosecution, indictment, trial"
el recato	"reserve, caution, care"
*** 1221 - 1230 (/course/195611/spanish-nouns-2-2/123/)	
el sebo	"tallow, sebum, suet"
el ómnibus	"bus, coach"
la culata	"butt, cylinder head, arse"
el nadador	swimmer
la disconformidad	"disagreement, nonconformity, disconformity"
la lepra	"leprosy, swinepox, plague"
la superpotencia	superpower
el adicto	"addict, follower, fan"
la coqueta	"coquette, dressing table"
el encantamiento	"enchantment, spell"
*** 1231 - 1240 (/course/195611/spanish-nouns-2-2/124/)	
el sulfato	"sulfate, sulphate"
las alitas	wings
el motociclismo	motorcycling
la pertinencia	"relevance, pertinence, relevancy"
la pujanza	"vigor, strength"
el clic	click
la sien	temple
el vasallaje	"allegiance, vassalage, serfdom"
la quimioterapia	"chemotherapy, chemo"
la difamación	"defamation, libel, slander"
*** 1241 - 1250 (/course/195611/spanish-nouns-2-2/125/)	
el empobrecimiento	"impoverishment, pauperization, degradation"
la refracción	refraction
la repulsión	"repulsion, repulse, disgust"
las cosquillas	"tickle, tickling"
la espera	"waiting, wait, delay"
el erudito	"scholar, polymath"
el recogimiento	"retreat, withdrawal, seclusion"
el frijol	kidney bean
el machete	machete
la connivencia	"collusion, cahoots, tolerance"
*** 1251 - 1260 (/course/195611/spanish-nouns-2-2/126/)	
el corcho	"cork, bobber"
(el)(la) hincha	"fan, supporter"
la maza	"mace, Indian club, meat tenderizer"
la puntualidad	punctuality
la grúa	"tow, crane, hoist"
el guerrillero	"guerrilla, partisan"
el medallero	medal table
(el)(la) idiota	"fool, idiot, moron"
el presentador	"presenter, host"
el estribo	"stirrup, stay, brace"
*** 1261 - 1270 (/course/195611/spanish-nouns-2-2/127/)	
la hebra	"strand, thread, string"
la aureola	"aureole, halo, aura"
el barómetro	"barometer, glass"
la aya	"governess, nursemaid, nanny"
la asa	"handle, bail, sap"
la leucemia	"leukemia, leukaemia"
el derramamiento	"shedding, spilling, spill"
la reconversión	"streamlining, restructuring, rationalizing"
el hurto	"theft, thievery, robbery"
el camionero	truck driver
*** 1271 - 1280 (/course/195611/spanish-nouns-2-2/128/)	
la omnipotencia	omnipotence
el boleto	"contract, bill of sale, ticket"
el pillaje	"plunder, pillage, mugging"
la segmentación	"segmentation, division, splitting up"
el alud	"avalanche, mudslide, rockslide"
el combinado	"cocktail, combined team"
la musculatura	"muscles, musculature, muscularity"
la eventualidad	"possibility, eventuality, contingency"
(el)(la) estratega	strategist
la rosca	"thread, nut, donut"
*** 1281 - 1290 (/course/195611/spanish-nouns-2-2/129/)	
la torsión	"twist, torsion, twisting"
el calvo	bald man
la negra	"bad luck, black, crotchet"
el acondicionamiento	"conditioning, fitting-out, refinishing"
el favorito	"favorite, favourite"
el fortín	"fort, pillbox, bunker"
el gentilhombre	gentleman
el barrido	"scanning, scavenging"
la aritmética	arithmetic
la conjura	conspiracy
*** 1291 - 1300 (/course/195611/spanish-nouns-2-2/130/)	
la cilindrada	cubic capacity
la represa	"dam, dyke, weir"
la capucha	"hood, cowl, cap"
el pistón	"piston, valve, percussion cap"
el ajuar	trousseau
el haragán	"truant, idler, sluggard"
la desaprobación	"disapprobation, disapproval, disfavour"
la donada	donated
el electrodo	electrode
el reflujo	"reflux, ebb, ebb tide"
*** 1301 - 1310 (/course/195611/spanish-nouns-2-2/131/)	
la canonización	canonization
el chequeo	"check, checkup, check-up"
la esterilidad	"infertility, sterility, barrenness"
la caoba	"mahogany, mahogany tree"
el consultorio	"office, consulting room, surgery"
la salchicha	"sausage, frankfurter, hot dog"
el caparazón	"shell, shield, cover"
el cofundador	cofounder
el sostenimiento	sustenance
la guardiana	guardian
*** 1311 - 1320 (/course/195611/spanish-nouns-2-2/132/)	
el puchero	"pot, stewpot, cooking pot"
el recambio	"replacement, spare part, spare"
la vacante	"vacant, vacancy, opening"
el suspense	"suspense, intrigue"
los fijados	fixed
el desfase	"gap, mismatch, discrepancy"
el tabique	"partition, room divider, partition wall"
la contraseña	"password, secret sign"
las termas	"Roman baths, baths, thermal springs"
la teja	"tile, ornamental curved comb, flamenco headwear"
*** 1321 - 1330 (/course/195611/spanish-nouns-2-2/133/)	
la usura	usury
la oradora	"speaker, orator"
la judicial	police officer
el grifo	"faucet, tap, griffin"
el pivote	"pivot, swivel"
el parón	"stop, halt, braking"
el biógrafo	biographer
el bazar	"bazaar, pound shop, dollar store"
el explosivo	explosive
el amianto	asbestos
*** 1331 - 1340 (/course/195611/spanish-nouns-2-2/134/)	
el teólogo	theologian
la militarización	militarization
la siniestralidad	accident
la domesticación	domestication
la mesura	"moderation, restraint, courtesy"
la recomendada	recommended
el tranco	"stride, threshold"
la volatilidad	volatility
el cabaret	cabaret
el francotirador	sniper
*** 1341 - 1350 (/course/195611/spanish-nouns-2-2/135/)	
el cariz	"look, outlook, appearance"
el quid	"crux, gist, reason"
el agregado	"aggregate, attache, aggregation"
los cortados	cut
el fonema	phoneme
el cuestionamiento	questioning
el profesionalismo	professionalism
el confort	"comfort, well-being"
el bádminton	badminton
el derrumbamiento	"collapse, overthrow, fall"
*** 1351 - 1360 (/course/195611/spanish-nouns-2-2/136/)	
la rendija	"crack, slit"
el dualismo	dualism
el expresionismo	expressionism
el asomo	"hint, trace"
la locución	"phrase, locution, idiom"
el dial	dial
la brasa	"embers, annoyance, nuisance"
la aleta	"fin, wing, flipper"
el durmiente	sleeper
el huso	spindle
*** 1361 - 1370 (/course/195611/spanish-nouns-2-2/137/)	
el rasero	strickle
la simiente	seed
el trueque	barter
el incesto	incest
el meteorito	"meteor, meteorite"
(el)(la) activista	activist
la reclamada	claimed
el desplome	"collapse, fall"
la disidencia	"dissent, dissidence, disagreement"
el holding	holding company
*** 1371 - 1380 (/course/195611/spanish-nouns-2-2/138/)	
el coito	"intercourse, coition, coitus"
el aguijón	"sting, stinger, goad"
la comparsa	"extra, bit player, subordinate"
los repuestos	"replacement, refill, extra"
los anís	"anise, aniseed, star anise"
la fogata	"bonfire, blaze"
el broche	"brooch, pin, broach"
el clarín	"bugle, clarion, bugler"
el engranaje	"gear, cog wheel, gear wheel"
el lince	"lynx, mind reader"
*** 1381 - 1390 (/course/195611/spanish-nouns-2-2/139/)	
la crucería	boss
el contador	"counter, meter, accountant"
la cala	"cove, creek, inlet"
la fiereza	"ferocity, savagery, cruelty"
el lustre	"luster, gloss, polish"
la estatuilla	"statuette, trophy, figurine"
el billón	"billion, one trillion, one billion"
la infusión	"brew, infusion"
la detonación	"detonation, bang"
la resaca	"hangover, undertow, undercurrent"
*** 1391 - 1400 (/course/195611/spanish-nouns-2-2/140/)	
la hipnosis	hypnosis
la inacción	inaction
la tarta	"pie, tart, cake"
el campesinado	peasantry
la gritería	"shouting, uproar"
el interruptor	switch
la transmutación	transmutation
la amortización	"amortization, redemption, depreciation"
el chat	"chat room, chatroom"
la epilepsia	epilepsy
*** 1401 - 1410 (/course/195611/spanish-nouns-2-2/141/)	
el epíteto	epithet
la chatarra	"junk, scrap, scrap metal"
el fosfato	phosphate
el jubilado	"retiree, senior citizen, pensioner"
el canibalismo	cannibalism
la res	"livestock, farm animal, beast"
el candor	"candor, innocence, naivety"
la fotosíntesis	photosynthesis
la blasfemia	"profanity, blasphemy, oath"
el dom	Sun
*** 1411 - 1420 (/course/195611/spanish-nouns-2-2/142/)	
la dentadura	"teeth, denture, set of teeth"
el deshielo	"thaw, melting, thawing"
la acidez	"heartburn, acidity, sourness"
el tabaquismo	"smoking, nicotine poisoning"
la teta	"boob, teat, tit"
la invalidez	"disability, incapacity"
el enredo	"mess, entanglement, tangle"
la aberración	"aberration, outrage, abomination"
el alabastro	"alabaster, gypseous alabaster"
el constructor	"builder, maker"
*** 1421 - 1430 (/course/195611/spanish-nouns-2-2/143/)	
el óvulo	"ovum, ovule, ova"
el desecho	"waste, waste of space, dead loss"
la abogacía	"advocacy, bar, law"
la formalización	formalization
el paraguay	Paraguay
la abolladura	"dent, indentation, dint"
la licenciada	graduate
la remoción	removal
la física	physics
el australiano	"Australian, Aussie"
*** 1431 - 1440 (/course/195611/spanish-nouns-2-2/144/)	
la efusión	"effusion, outpouring, outflow"
el cuadrante	"quadrant, dial, square cushion"
el raciocinio	"reasoning, reason"
el semáforo	"traffic lights, light, semaphore"
el paganismo	"paganism, heathen, heathenism"
la performance	performance
(el)(la) gigante	giant
el bombo	"bass drum, drum, belly"
el viejo	"buddy, old fellow, mate"
la necedad	"foolishness, silliness, nonsense"
*** 1441 - 1450 (/course/195611/spanish-nouns-2-2/145/)	
la incongruencia	"incongruity, contradiction, inconsistency"
la glorieta	"roundabout, gazebo, arbour"
el remolino	"swirl, whirlpool, eddy"
la clarificación	"clarification, explanation, filtering"
la diáspora	diaspora
la extranjería	"immigration matters, alien"
la consumación	"climax, end, culmination"
la enunciación	"enunciation, statement"
el retén	"squad, reserves"
la sobremesa	"table talk, after-dinner conversation, tablecloth"
*** 1451 - 1460 (/course/195611/spanish-nouns-2-2/146/)	
el míster	"Mr., Mister"
la ceniza	"ash, cinder, powdery mildew"
el coautor	co-author
la gordura	"fatness, plumpness, obesity"
el leopardo	"leopard, leopard-skin"
(el)(la) interrogante	"question, question mark, interrogator"
el estío	summer
la vidriera	"window, showcase, stained glass"
el cachorro	"cub, puppy, pup"
la mella	"nick, dent, notch"
*** 1461 - 1470 (/course/195611/spanish-nouns-2-2/147/)	
el depredador	"predator, depredator, looter"
el pícaro	"rascal, rogue, scamp"
el portillo	wicket
el banano	"banana tree, banana plant, banana"
la mayúscula	"capital, capital letter"
la congoja	"grief, anguish, distress"
el vaivén	"swinging, swaying, rocking"
la visa	visa
el sheriff	sheriff
el colono	"colonist, settler, planter"
*** 1471 - 1480 (/course/195611/spanish-nouns-2-2/148/)	
la ignominia	"disgrace, ignominy, dishonor"
(el)(la) donante	"donor, charity donor, benefactor"
el arrabal	"suburb, suburban slum"
el tópico	"topic, subject"
la parra	vine
el noviazgo	"engagement, courtship"
el descaro	"impudence, nerve, effrontery"
el merengue	"meringue, mess"
el rebote	"rebound, ricochet, anger"
la comicidad	"comedy, humor, comicality"
*** 1481 - 1490 (/course/195611/spanish-nouns-2-2/149/)	
la zozobra	"anxiety, uneasiness, jumpiness"
el corolario	corollary
la corbeta	"corvette, sloop"
(el)(la) narcotraficante	drug trafficker
la vulgaridad	"vulgarity, banality, crudity"
la bravura	"bravery, bravura, ferocity"
el bulevar	"boulevard, avenue"
la peluquería	"hairdressing, barbershop, hairdresser"
la heredera	heiress
(el)(la) recluta	"recruit, conscript, draftee"
*** 1491 - 1500 (/course/195611/spanish-nouns-2-2/150/)	
la barricada	"roadblock, barricade"
el barniz	"varnish, dope, veneer"
el repollo	cabbage
el aluvión	"alluvium, alluvion, flood"
la conmutación	"commutation, validation, punning"
la dona	"dona, donut, doughnut"
el dramatismo	drama
el jesuita	"Jesuit, puff pastry square with ham/cheese filling"
la melena	"mane, long hair, mane of hair"
la mística	"mysticism, mystic"
*** 1501 - 1510 (/course/195611/spanish-nouns-2-2/151/)	
el escrúpulo	"scruple, qualm, compunction"
la laya	spade
el mechón	"tuft, lock, forelock"
las cristianas	Christian
el boxeador	boxer
el sospechoso	suspect
la potenciación	"promotion, exponentiation, strengthening"
el librero	"bookseller, bookcase"
el millonario	millionaire
la fiscalización	audit findings
*** 1511 - 1520 (/course/195611/spanish-nouns-2-2/152/)	
el surtido	"assortment, selection, supply"
el bucle	"loop, curl, ringlet"
el simulacro	"simulacrum, simulation, drill"
la merienda	"snack, afternoon snack, high tea"
el subcontinente	subcontinent
la táctica	"tactics, tactic, policy"
la abadesa	abbess
el seísmo	earthquake
el patíbulo	"gallows, gibbet, scaffold"
el gueto	"ghetto, Jewish ghetto, Jewish quarter"
*** 1521 - 1530 (/course/195611/spanish-nouns-2-2/153/)	
el oidor	hearer
la viscosidad	viscosity
el cabotaje	"cabotage, coastal shipping, coastal trade"
el clímax	climax
la llamarada	"flare, blaze, flash"
el ratito	little while
la radiografía	"radiography, radiograph, X-ray photography"
la flexibilización	flexibility
el atropello	"accident, hit and run, outrage"
la almendra	"almond, kernel, stone"
*** 1531 - 1540 (/course/195611/spanish-nouns-2-2/154/)	
el peine	comb
la portezuela	door
el vertedero	"dump, rubbish dump, chute"
el transformador	transformer
el cromo	"chrome, chromium, trading card"
la vajilla	"crockery, tableware, plate"
la disertación	"dissertation, discourse, reflection"
la fineza	"fineness, kindness, act of kindness"
la gravitación	gravitation
el fierro	"iron, metal, brace"
*** 1541 - 1550 (/course/195611/spanish-nouns-2-2/155/)	
el ítem	item
el envase	"package, pack, container"
la radicalización	radicalization
el swing	jive
el mosto	grape-juice
los tocados	headdress
la intermediación	intermediation
el jurisconsulto	jurisconsult
el obelisco	obelisk
el fisco	"treasury, Inland Revenue, tax collector"
*** 1551 - 1560 (/course/195611/spanish-nouns-2-2/156/)	
la emanación	"emanation, emission, leak"
el gramo	"gram, gramme"
el labrador	farmer
la bayoneta	bayonet
(el)(la) crack	"crack (m), cracking player (m), champion (m)"
la nuera	daughter in law
la perversidad	"evil, perversity, iniquity"
el hedor	"stench, stink, reek"
el cubismo	cubism
la empatía	empathy
*** 1561 - 1570 (/course/195611/spanish-nouns-2-2/157/)	
el chasco	"disappointment, hoax"
la heterogeneidad	heterogeneity
la subprefectura	subprefecture
el yen	yen
el traumatismo	trauma
el chófer	"driver, chauffeur"
la arboleda	"grove, wood, plantation"
el meridiano	meridian
el corcel	"steed, charger, courser"
el mestizo	"mongrel, mestizo"
*** 1571 - 1580 (/course/195611/spanish-nouns-2-2/158/)	
la uña	"claw, nail, fingernail"
el desván	"loft, attic, garret"
la rejilla	"screen, wickerwork, wickering"
la puñalada	"stab, stabbing, thrust"
el virtuosismo	virtuosity
la vivacidad	"liveliness, vivacity, life"
la alegación	"allegation, declaration, statement"
el bergantín	"brig, brigantine"
el envidioso	"greedy people, greed"
el mesón	"meson, inn, bar"
*** 1581 - 1590 (/course/195611/spanish-nouns-2-2/159/)	
la esclerosis	sclerosis
la instantánea	"snapshot, snap"
el franciscano	Franciscan
la mana	manna
el milán	Milan
la aprensión	"apprehension, apprehensiveness, squeamishness"
el ariete	"battering ram, ram, striker"
la condolencia	"condolence, sympathy, condolences"
el desagüe	"drainage, drain, outlet"
la altivez	"haughtiness, arrogance, pride"
*** 1591 - 1600 (/course/195611/spanish-nouns-2-2/160/)	
la pequeñez	"smallness, littleness, shortness"
la solana	"suntrap, solarium"
la simbiosis	"symbiosis, cooperation, teamwork"
la picardía	"trick, trickery, plot"
la anfitriona	hostess
el guillermo	Bill
la intelectualidad	intellectuality
la amnesia	amnesia
el borracho	cake soaked in alcohol
el hospedaje	"lodging, tariff UK, rate"
*** 1601 - 1610 (/course/195611/spanish-nouns-2-2/161/)	
la chicha	"maize drink, chicha, purple corn drink"
la fenomenología	phenomenology
el conseller	Minister
la alocución	"address, allocution, speech"
el arcángel	archangel
el latón	brass
el buceo	"diving, deep sea diving, investigation"
la excentricidad	"eccentricity, oddity"
el aullido	"howl, yowl, howling"
(el)(la) deficiente	"mentally deficient person, handicapped person"
*** 1611 - 1620 (/course/195611/spanish-nouns-2-2/162/)	
el erario	"treasury, exchequer, public funds"
la institucionalización	institutionalization
la excarcelación	release (from prison)
la aprehensión	"apprehension, arrest, seizure"
el frenado	"braking, breaking"
el cepillo	"brush, toothbrush, scrub brush"
la deslealtad	"disloyalty, infidelity"
la acequia	"irrigation ditch, gutter, irrigation canal"
la entropía	entropy
el sinnúmero	"countless, endless"
*** 1621 - 1630 (/course/195611/spanish-nouns-2-2/163/)	
la riña	"fight, quarrel, brawl"
la marioneta	"marionette, puppet"
(el)(la) sinvergüenza	"shameless, scoundrel, cad"
el cobertizo	"shed, shelter, hut"
el sintagma	"syntagma, phrase, syntagm"
la yema	"bud, egg yolk, tip"
el vado	"ford, private right-of-way, private road"
el antebrazo	forearm
el lóbulo	"lobe, earlobe"
(el)(la) mártir	martyr
*** 1631 - 1640 (/course/195611/spanish-nouns-2-2/164/)	
la métrica	"metrics, meter"
el asegurador	"insurer, underwriter"
la rotonda	"roundabout, rotunda, traffic circle"
la sífilis	"syphilis, pox"
el visor	"viewfinder, viewer, goggles"
el yerro	"mistake, error"
la aridez	"aridity, barrenness, dryness"
el confesor	confessor
las fauces	"fauces, jaws, maw"
la incomunicación	"isolation, solitary confinement, lack of communication"
*** 1641 - 1650 (/course/195611/spanish-nouns-2-2/165/)	
el apareamiento	"mating, pairing, matching"
el tropiezo	"stumbling block, trip, stumble"
la propina	"tip, gratuity, extra piece"
la desnutrición	"malnutrition, undernourishment"
la tinción	staining
la artritis	arthritis
la purga	"purge, bleeding, purgative"
el desgarro	"tear, sense of pain, sense of sadness"
el cenit	"zenith, meridian"
el abstracto	abstractedness
*** 1651 - 1660 (/course/195611/spanish-nouns-2-2/166/)	
la comandancia	"command, command headquarters, command  n"
el clip	"paperclip, video, pop video"
la revitalización	revitalization
la venus	Venus
el deslinde	demarcation
el cebo	"bait, lure, fodder"
el verdor	greenness
la liza	"lists, contest"
la redundancia	redundancy
la vendedora	saleswoman
*** 1661 - 1670 (/course/195611/spanish-nouns-2-2/167/)	
la voluptuosidad	voluptuousness
el geólogo	geologist
la premura	"haste, urgency"
el napoleón	Napoleon
el pedal	"pedal, treadle, plastering"
el tendero	"storekeeper, grocer, shopkeeper"
el preceptor	"tutor, teacher, preceptor"
el califato	caliphate
el decaimiento	"decline, decay, enervation"
la gestora	management
*** 1671 - 1680 (/course/195611/spanish-nouns-2-2/168/)	
el atraco	"robbery, hold-up"
la calva	"worn patch, bare spot, Calva"
el visitador	visitor
el gravamen	"assessment, burden, encumbrance"
el aseguramiento	assurance
la curia	curia
(el)(la) dentista	dentist
el micer	Messer
la zoología	zoology
la embajadora	ambassadress
*** 1681 - 1690 (/course/195611/spanish-nouns-2-2/169/)	
el escarnio	"derision, ridicule, derisive remark"
la brida	"flange, bridle"
la inflorescencia	inflorescence
el látex	latex
el desbordamiento	"overflowing, flooding"
la incógnita	"X, unknown, unfamiliar"
la romanización	romanization
la samba	samba
el recodo	"bend, turn, turning"
el botánico	"botanist, botany"
*** 1691 - 1700 (/course/195611/spanish-nouns-2-2/170/)	
(el)(la) congresista	congressman
el desconsuelo	grief
la inminencia	"imminence, nearness, closeness"
la inventiva	inventiveness
la larva	"larva, grub"
la frivolidad	"levity, frivolity, triviality"
la aspereza	"roughness, abruptness, coldness"
el desguace	"scrapping, breaking up"
la buscada	sought
el alquitrán	"tar, tarmac"
*** 1701 - 1710 (/course/195611/spanish-nouns-2-2/171/)	
el trombón	trombone
la dirigencia	leadership
la conductividad	conductivity
la antonomasia	antonomasia
la papeleta	"certificate, ballot paper, awful task"
la terna	internal
(el)(la) facha	"look, figure, appearance"
el oratorio	"oratorio, oratory, chapel"
la transgresión	"transgression, violation"
el cactus	cactus
*** 1711 - 1720 (/course/195611/spanish-nouns-2-2/172/)	
el champán	"champagne, sampan"
la preciosa	gem
(el)(la) conserje	"concierge, doorman, janitor"
la proeza	"feat, exploit, great achievement"
la hendidura	"fissure, crack, groove"
el cáñamo	hemp
la rudeza	"rudeness, roughness, brusqueness"
el tabernáculo	tabernacle
la flotación	buoyancy
la sedimentación	sedimentation
*** 1721 - 1730 (/course/195611/spanish-nouns-2-2/173/)	
el accesorio	"accessory, attachment"
la sordera	deafness
el lobby	lobby
la nao	ship
el retrete	"toilet, water closet, privy"
el stop	stop button
la defunción	"death, passing, decease"
la deposición	deposition
la horquilla	"hairpin, fork, yoke"
la inhalación	inhalation
*** 1731 - 1740 (/course/195611/spanish-nouns-2-2/174/)	
la dehesa	pasture
la falange	"phalanx, phalange, falange"
el perseguidor	"pursuer, persecutor"
la techumbre	"roofing, roof"
el salitre	"saltpeter, saltpetre, nitre"
el sport	sport
el descabello	pithing
la coquetería	"flirtation, coquetry"
la gelatina	"gelatin, gelatine, jelly"
la idiosincrasia	"idiosyncrasy, trait, peculiarity"
*** 1741 - 1750 (/course/195611/spanish-nouns-2-2/175/)	
el memorándum	"memorandum, memo, notebook"
la miniatura	miniature
la cazuela	"pan, casserole, cooking pot"
el parásito	"pest, parasite"
el tornado	"tornado, twister, whirlwind"
la expresividad	"eloquence, expressivity, expression"
la lacra	"after-effect, consequence, blot"
el cinto	"belt, gunbelt"
(el)(la) demócrata	democrat
el veraneo	"summer holiday, summer break"
*** 1751 - 1760 (/course/195611/spanish-nouns-2-2/176/)	
la inconsciencia	"unconsciousness, thoughtlessness, oblivion"
la vihuela	"vihuela, obsolete plucked stringed instrument"
la atalaya	"watchtower, vantage point"
(el)(la) calandria	"calendar (f), malingerer"
el archiduque	archduke
el encubrimiento	"concealment, receiving"
el confinamiento	"confinement, stabling"
la dicción	diction
el gerundio	"gerund, gerundive, present participle"
el galpón	"one story house, shed, storehouse"
*** 1761 - 1770 (/course/195611/spanish-nouns-2-2/177/)	
el envasado	"packing, canning, packaging"
el chorizo	"sausage, chorizo, spicy sausage"
la guadaña	scythe
la estaca	"stake, peg, picket"
(el)(la) violinista	"violinist, violin player, fiddler"
la opositora	"opposition, opponent, candidate"
el desprestigio	"discredit, loss of prestige"
la meteorología	meteorology
el augurio	"augury, omen, sign"
la sotana	"cassock, robe, soutane"
*** 1771 - 1780 (/course/195611/spanish-nouns-2-2/178/)	
la lombriz	"earthworm, worm, angleworm"
la extravagancia	"extravaganza, extravagance, flamboyancy"
el telar	"loom, curtain"
la opacidad	"opacity, opaqueness, opaque"
la cosmología	cosmology
la polinización	pollination
el doblete	doublet
la beatificación	beatification
el frontal	"front, cover, frontal bone"
la inmoralidad	immorality
*** 1781 - 1790 (/course/195611/spanish-nouns-2-2/179/)	
la probeta	"test tube, tray, developer tray"
el viraje	"turn, toning, swerve"
la desazón	"uneasiness, discomfort, anxiety"
el bárbaro	barbarian
el guardacostas	coastguard
el iceberg	"iceberg, berg"
el pingüino	penguin
el argot	"slang, jargon, argot"
el padecimiento	"suffering, ailment, illness"
el desdoblamiento	"unfolding, division, splitting"
*** 1791 - 1800 (/course/195611/spanish-nouns-2-2/180/)	
el panamá	"Panama, panama"
(el)(la) navegante	"navigator, seafarer"
el desatino	"nonsense, mistake"
el bombeo	pumping
el vandalismo	vandalism
la silvicultura	"forestry, silviculture"
el ensamblaje	assembly
(el)(la) copiloto	"co-pilot, co-driver"
el esparto	"esparto, alfa, esparto grass"
la insinuación	"insinuation, suggestion, innuendo"
*** 1801 - 1810 (/course/195611/spanish-nouns-2-2/181/)	
la reprobación	"reprobation, reproval, censure"
el sorbo	"sip, gulp, taste"
la muela	"tooth, molar, back tooth"
la moza	"wench, girl, waitress"
el altercado	"altercation, disagreement, dispute"
la carabina	"carbine, chaperon, rifle"
el acantilado	"cliff, bluff"
el parangón	"comparison, compare"
(el)(la) corresponsal	"correspondent, stringer"
la botica	"drugstore, druggist, chemist's"
*** 1811 - 1820 (/course/195611/spanish-nouns-2-2/182/)	
la mazmorra	dungeon
la riada	flood
la anorexia	"anorexia, anorexy"
la consultoría	"consultancy, consultant's office, consultant's"
la negrura	"blackness, darkness"
la refriega	"fray, affray, brawl"
el friso	"frieze, dado, baseboard"
el erizo	"hedgehog, echinus, hedgehog cactus"
el pesebre	"manger, crib, trough"
el oportunismo	opportunism
*** 1821 - 1830 (/course/195611/spanish-nouns-2-2/183/)	
el cordel	"string, cord, track"
las pesas	"weight, dumbbell"
el azafrán	"crocus, saffron, saffron crocus"
el bisabuelo	great-grandfather
(el)(la) jurista	"lawyer, jurist"
el paleontólogo	"palaeontologist, paleontologist"
el rectángulo	"rectangle, oblong"
el goteo	"drip, dripping, dribble"
el magma	magma
la serranía	mountain range
*** 1831 - 1840 (/course/195611/spanish-nouns-2-2/184/)	
el perrito	"puppy, doggie, doggy"
el reajuste	"readjustment, readjusting, reform"
la sinergia	synergy
el catecismo	catechism
el acomodo	"comfort, a comfortable position, a place to stay"
la peca	"freckle, spot"
el profano	"layman, layperson"
el forro	"lining, cover, sheathing"
el maillot	"swimsuit, swimming costume, jersey"
la predecesora	predecessor
*** 1841 - 1850 (/course/195611/spanish-nouns-2-2/185/)	
el bálsamo	"balm, balsam, salve"
el estamento	"class, stratum, estate"
el riachuelo	"creek, rivulet, rill"
el cuco	"cuckoo, baby carriage, cradle"
la iniquidad	"iniquity, wickedness"
el mimo	"mime, indulgence, pantomime"
el tapón	"plug, stopper, cap"
el aparejo	"rig, gear, rigging"
el sigilo	"secrecy, stealth, secretiveness"
el chal	"shawl, wrap, pashmina"
*** 1851 - 1860 (/course/195611/spanish-nouns-2-2/186/)	
la hechura	"workmanship, making, creature"
la reagrupación	"regrouping, reunification"
el anzuelo	"bait, fishhook, hook"
la lisonja	"flattery, compliment"
el forraje	"forage, fodder"
(el)(la) naturalista	naturalist
la palestina	Palestine
el unicornio	unicorn
el cohecho	"bribery, bribe"
(el)(la) consorte	consort
*** 1861 - 1870 (/course/195611/spanish-nouns-2-2/187/)	
el fiasco	"fiasco, let-down, flop"
el lirismo	lyricism
el cogote	nape
la penicilina	penicillin
la gasolinera	"petrol station, gas station, garage"
las comillas	"quotation marks, quotes, inverted commas"
la salinidad	"salinity, saltiness"
la esponja	"sponge, lush, fish"
la infelicidad	"unhappiness, infelicity"
la mansedumbre	"gentleness, meekness, tameness"
*** 1871 - 1880 (/course/195611/spanish-nouns-2-2/188/)	
la perpetuidad	perpetuity
la panadería	"bakery, baking"
(el)(la) canadiense	"Canadian, lumber jacket (m)"
el coloso	colossus
el báculo	"crosier, crook, walking stick"
la deferencia	deference
el ébano	"ebony, ebony (tree)"
la compuerta	"gate, floodgate, penstock"
el retazo	"remnant, snippet, piece"
el balazo	"shot, bullet wound, gunshot wound"
*** 1881 - 1890 (/course/195611/spanish-nouns-2-2/189/)	
el cántico	"song, poetic composition, hymn"
el córner	corner
la apicultura	"beekeeping, apiculture, bee-keeping"
la oficialidad	officers
(el)(la) correspondiente	corresponding member
la disfunción	"dysfunction, malfunction"
el fémur	femur
la fluctuación	"fluctuation, rock, rocking"
la judicatura	"judiciary, judicature"
la portera	portress
*** 1891 - 1900 (/course/195611/spanish-nouns-2-2/190/)	
la salvedad	"proviso, salvo, reservation"
el boliche	"small shop, bowling alley, cup and ball toy"
el garzón	waiter
el jarabe	syrup
el cadmio	cadmium
la estandarización	standardization
la saciedad	"satiation, satiety, repletion"
la barranca	"ravine, gully, rift"
el bol	"bowl, soup-bowl, deep dish"
el mobiliario	"furnishings, furniture, furnishing"
*** 1901 - 1910 (/course/195611/spanish-nouns-2-2/191/)	
la genialidad	"genius, brilliant idea, brilliance"
la matrona	"matron, midwife"
el pinar	"pinewood, pine grove, pine wood"
el sínodo	synod
la visera	"visor, peak, vizor"
el fuel	fuel
el paludismo	malaria
la indolencia	"indolence, sloth, indifference"
la convalecencia	convalescence
el oporto	port
*** 1911 - 1920 (/course/195611/spanish-nouns-2-2/192/)	
el rinoceronte	"rhino, rhinoceros"
el académico	professor
la nicotina	nicotine
el entrecejo	"frown, space between the eyebrows"
el harén	harem
el rubro	"heading, title"
el cántaro	"pitcher, jug, jugful"
el tomillo	thyme
la ranura	"groove, keyhole, slot"
la mensajería	"messaging, courier service, messenger service"
*** 1921 - 1930 (/course/195611/spanish-nouns-2-2/193/)	
el meollo	"pith, heart, core"
la polaridad	polarity
el arrollado	"roulade, meat roll, rolled roast"
el solsticio	solstice
el hilado	"yarn, spinning"
el heraldo	"herald, harbinger"
el implante	"implant, implantation"
(el)(la) moralista	moralist
el ultraje	"outrage, insult"
el trimestre	"quarter, term, trimester"
*** 1931 - 1940 (/course/195611/spanish-nouns-2-2/194/)	
la escocia	Scotland
la capitalidad	capital status
la escoria	"dross, slag, scum"
la epidermis	epidermis
el arrecife	reef
la costilla	"rib, pastry, chop"
la plana	"plain, flatland, grassland"
la repostería	"confectionery, pastry-making, pastries"
el barroco	"baroque, Baroque, Baroque era"
el cataclismo	"cataclysm, upheaval"
*** 1941 - 1950 (/course/195611/spanish-nouns-2-2/195/)	
la horda	"horde, mob, gang"
el laúd	"lute, typical Mediterranean boat, leatherback turtle"
la estratagema	"ruse, stratagem, contrivance"
(el)(la) fresa	"strawberry (f), milling cutter (f), drill (f)"
el furgón	"van, wagon, boxcar"
la varita	wand
la contraofensiva	counteroffensive
el ferry	ferry
el aprieto	"fix, jam, trouble"
el mordisco	"nibble, nip, snap"
*** 1951 - 1960 (/course/195611/spanish-nouns-2-2/196/)	
el plagio	"plagiarism, plagiary"
el prefecto	prefect
el sedimento	"sediment, grounds, deposit"
la autodefensa	"self-defense, self-defence"
(el)(la) superintendente	"superintendent, overseer"
el descubridor	"discoverer, finder"
la agregación	aggregation
el bulbo	bulb
el atisbo	"shadow, trace, glimmer"
el quirófano	"surgery, operating room, operating theatre UK"
*** 1961 - 1970 (/course/195611/spanish-nouns-2-2/197/)	
el orfanato	orphanage
la condescendencia	"condescension, complaisance, condescendence"
la mengua	"decline, decrease, diminishment"
la intercesión	intercession
la leona	lioness
la húngara	Hungarian
el posó	"deposit, sediment, grounds"
la reorientación	readjusting
el ria	"sea inlet, water jump"
la égida	aegis
*** 1971 - 1980 (/course/195611/spanish-nouns-2-2/198/)	
la oruga	"caterpillar, larva, caterpillar tractor"
el bombero	"fireman, firefighter"
el peinado	"hairstyle, coiffure, hairdo"
la escotilla	"hatch, hatchway, scuttle"
la reiteración	reiteration
el rótulo	"sign, label, lettering"
el estrellato	stardom
la postguerra	postwar
la sustentación	"lift, support, basis"
la adivinación	"divination, prediction, fortune-telling"
*** 1981 - 1990 (/course/195611/spanish-nouns-2-2/199/)	
el calzado	footwear
el carguero	"freighter, cargo ship"
la gráfica	"graph, graphics, table"
la regata	"regatta, race, boat race"
el tabú	"taboo, tabu"
el cuchicheo	"whispering, whisper, buzz"
la infinitud	infinitude
el ensanche	"extension, expansion, development"
el apretón	"grip, squeeze, clasp"
el tintero	"inkwell, inkpot, cartridge holder"
*** 1991 - 2000 (/course/195611/spanish-nouns-2-2/200/)	
la mediana	"median, central reservation, median strip"
el añicos	smithereens
el lavabo	"washbasin, basin, sink"
el ciprés	"cypress, cypress wood"
el porrazo	"whack, thump, bump"
el ternero	calf
la subscripción	subscription
el aguante	"endurance, stamina, resistance"
la asiduidad	"assiduity, assiduousness, diligence"
la espadaña	"bulrush, steeple, bell gable"
*** 2001 - 2010 (/course/195611/spanish-nouns-2-2/201/)	
la centuria	century
el chalet	"chalet, detached house"
la intendencia	"intendant's office, manager's office, Quartermaster Corps"
el quicio	"jamb, doorjamb, doorframe"
(el)(la) oyente	"listener, hearer, auditor"
la propietaria	proprietress
la marihuana	marijuana
la eyaculación	ejaculation
el comendador	commander
el jade	jade
*** 2011 - 2020 (/course/195611/spanish-nouns-2-2/202/)	
el camisón	"nightdress, nightgown, nightie"
el enfermero	"nurse, male nurse"
el fragor	"roar, clamour"
la tina	"tub, vat, large jar"
el existencialismo	existentialism
la bilis	"bile, gall, temper"
la pompa	"pomp, bubble, pump"
el sedán	"sedan, saloon"
el triunvirato	triumvirate
la amplificación	amplification
*** 2021 - 2030 (/course/195611/spanish-nouns-2-2/203/)	
el ladrido	"bark, barking, woof"
la impiedad	"impiety, profanity"
el deslizamiento	"slipping, gliding"
el redactor	"editor, redactor"
el manco	"one-armed man, amputee"
la yihad	jihad
el cierne	blossoming
el episcopado	"episcopacy, episcopate"
el dintel	"lintel, threshold"
la mole	"mass, hulk, pile"
*** 2031 - 2040 (/course/195611/spanish-nouns-2-2/204/)	
el pimiento	"pepper, capsicum, couldn't care less"
el trovador	"troubadour, minstrel, folk singer"
la tiza	chalk
la equitación	"riding, horsemanship, equitation"
el multiplicando	multiplicand
la desamortización	"confiscation, seizure"
el bailarín	"dancer, ballet dancer"
el danés	"Danish, Dane"
(el)(la) indígena	"native, Indian"
la oda	ode
*** 2041 - 2050 (/course/195611/spanish-nouns-2-2/205/)	
la procreación	procreation
el estante	"rack, shelf, bookcase"
el pito	"whistle, prick, pipe"
el domo	dome
la aclamación	"acclamation, acclaim"
el latido	"beating, beat, heartbeat"
el cuatrocientos	four hundred
el desquite	"retaliation, retribution, requital"
el serafín	seraph
el tendón	"tendon, sinew"
*** 2051 - 2060 (/course/195611/spanish-nouns-2-2/206/)	
el flaco	"weakness, weak point"
la coordinadora	coordinator
la planeación	planning
el ion	ion
la tacha	"blemish, taint, reproach"
el epitafio	epitaph
la metástasis	metastasis
el acatamiento	"observance, acceptance, compliance"
la panacea	"panacea, nostrum"
la fobia	"phobia, hatred"
*** 2061 - 2070 (/course/195611/spanish-nouns-2-2/207/)	
la barandilla	"rail, railing, banister"
la sortija	"ring, pin, curl"
el atajo	shortcut
la homofobia	homophobia
la cantina	"cantina, canteen, buffet"
el bautizo	"christening, baptism"
la tapadera	"top, lid, cover"
el collage	collage
el melón	melon
el chimpancé	chimpanzee
*** 2071 - 2080 (/course/195611/spanish-nouns-2-2/208/)	
el citoplasma	cytoplasm
la eminencia	"eminence, height, prominent figure"
la quilla	"keel, breastbone"
el buzón	"mailbox, postbox, letterbox"
el empaque	"packing, baling, packaging"
la suela	"sole, shoe-leather"
el rastreo	"tracing, tracking, search"
la adrenalina	adrenalin
la coerción	"coercion, force, threat"
el recubrimiento	covering
*** 2081 - 2090 (/course/195611/spanish-nouns-2-2/209/)	
la desproporción	disproportion
el elfo	elf
la higuera	"fig tree, fig"
el finlandés	"Finn, Finnish"
el grafito	"graphite, pencil sketch, graffiti"
la malta	malt
la sauna	sauna
la mercadotecnia	marketing
la diadema	"diadem, coronet, crown"
la papelera	"bin, paper mill, wastepaper basket"
*** 2091 - 2100 (/course/195611/spanish-nouns-2-2/210/)	
el gorila	"gorilla, thug, bully-boy"
el jersey	"jersey, sweater, jumper"
el nihilismo	nihilism
el oleoducto	"pipeline, oil pipeline"
la deshidratación	"drying, dehydration"
la testosterona	testosterone
el byte	byte
el diestro	"bullfighter, matador"
el cajero	"cashier, cash machine, ATM"
la madriguera	"den, hole, burrow"
*** 2101 - 2110 (/course/195611/spanish-nouns-2-2/211/)	
el usurero	"usurer, loan shark, shylock"
el coyote	"coyote, gossip, intermediary"
la crucifixión	crucifixion
el idilio	"idyll, idyl"
el crisol	"melting pot, crucible"
la redondez	"roundness, rotundity"
el caldero	"water bowl, cooking pot, water vessel"
el carbonato	carbonate
el fallido	failed
el acertijo	"puzzle, riddle, quiz"
*** 2111 - 2120 (/course/195611/spanish-nouns-2-2/212/)	
el talismán	"talisman, charm, good luck charm"
la imaginería	"imagery, silk embroidery"
el impresionismo	impressionism
la virulencia	"virulence, bitterness, hostility"
la biblia	"Bible, bible"
la capitana	"captain, skipper, commander"
la guillotina	guillotine
el hombrecillo	"little man, little fellow"
la pizza	pizza
la cascada	"cascade, waterfall, fall"
*** 2121 - 2130 (/course/195611/spanish-nouns-2-2/213/)	
la escarcha	frost
la servilleta	"napkin, serviette, serviette UK"
el desmentido	denial
la conurbación	conurbation
la beldad	"belle, beauty"
el rompimiento	"breach, outbreak, rupture"
el algarrobo	"carob tree, locust tree, carob"
el ejido	"common land, shared land, public land"
el porro	"joint, reefer"
la lagartija	"lizard, Iberian wall lizard, gecko"
*** 2131 - 2140 (/course/195611/spanish-nouns-2-2/214/)	
el embarcadero	"pier, jetty, quay"
la póliza	policy
el céfiro	"zephyr, west wind, breeze"
el taburete	stool
la sidra	"cider, hard cider"
la criptografía	cryptography
el fetichismo	fetishism
el rosal	"rosebush, rose bush"
el chubasco	"shower, squall, rain shower"
el pentagrama	"staff, stave"
*** 2141 - 2150 (/course/195611/spanish-nouns-2-2/215/)	
la diseñadora	designer
el facsímil	facsimile
la desconexión	disconnexion
la diseminación	dissemination
el desafuero	"outrage, excess"
el tímpano	"eardrum, tympanum, drum"
la efervescencia	"effervescence, fizz, fizziness"
la masturbación	masturbation
el organigrama	"organization chart, org chart, flow chart"
el arriendo	"rent, rental, lease"
*** 2151 - 2160 (/course/195611/spanish-nouns-2-2/216/)	
la varilla	"rib, spoke, dipstick"
el envoltorio	"sheath, wrapper, casing"
el abanderado	standard-bearer
el caché	"appearance fee, price ticket, price label"
la antecámara	"antechamber, anteroom, lobby"
la cantata	cantata
la oratoria	"oratory, public speaking, rhetoric"
la menta	"peppermint, mint"
la poción	"potion, drench, medicine"
la náusea	"qualm, nausea"
*** 2161 - 2170 (/course/195611/spanish-nouns-2-2/217/)	
la convulsión	"upheaval, convulsion, unrest"
el tacón	heel
la jueza	judge
el ocultismo	occultism
la permeabilidad	permeability
la plasticidad	plasticity
la sarna	"mange, scabies, itch"
la superestructura	superstructure
el autocar	"coach, bus"
la pulpería	"grocery store, local convenience store, bodega"
*** 2171 - 2180 (/course/195611/spanish-nouns-2-2/218/)	
el ideólogo	ideologist
el aliciente	"incentive, lure, attraction"
la insolvencia	"insolvency, bankruptcy"
el coño	"pussy, cunt, minge"
el sismo	seism
la gitana	"Gypsy, Gipsy"
el bosquecillo	"copse, spinney, small wood"
la improcedencia	inappropriateness
el aperitivo	"appetizer, aperitif, opener"
el dúplex	duplex
*** 2181 - 2190 (/course/195611/spanish-nouns-2-2/219/)	
la carcasa	"frame, framework, skeleton"
la poética	"poetics, art of poetry"
el tulipán	tulip
el monitoreo	monitoring
la rotundidad	rotundity
el andante	andante
el balido	"bleat, baa, bleating"
los queridos	"darling, love"
la hondura	depth
el embudo	"funnel, traffic jam, bottleneck"
*** 2191 - 2200 (/course/195611/spanish-nouns-2-2/220/)	
la toga	"gown, toga, robe"
el naranjo	"orange, orange tree, bitter orange"
el panfleto	"pamphlet, flyer"
la rapiña	robbery
la radiactividad	radioactivity
el ciberespacio	Cyberspace
la confiabilidad	reliability
el nuncio	"messenger, herald, harbinger"
la acritud	"acrimony, pungency, acerbity"
el milímetro	"millimeter, millimetre, fraction of an inch"
*** 2201 - 2210 (/course/195611/spanish-nouns-2-2/221/)	
la retroalimentación	feedback
la conectividad	connectivity
la taba	"ankle bone, jackstones, knucklebones"
la pastilla	"bar, tablet, chip"
el dardo	"dart, Loaded question"
el arbolado	"forest, woodland, woods"
el espino	"hawthorn, thorn"
el acicate	"incentive, stimulus"
la boquilla	"mouthpiece, nozzle, holder"
el oprobio	"opprobrium, shame, disgrace"
*** 2211 - 2220 (/course/195611/spanish-nouns-2-2/222/)	
el guisante	"pea, peas"
el céntimo	"penny, centime, cent"
el pigmento	pigment
el hipódromo	"racecourse, hippodrome, racetrack"
el guiso	"stew, casserole"
la susceptibilidad	"susceptibility, sensitivity, irritability"
el babor	"port, larboard, port side"
(los)(las) circunstantes	bystanders
el coliseo	Coliseum
la tijera	fork
*** 2221 - 2230 (/course/195611/spanish-nouns-2-2/223/)	
la meningitis	meningitis
el semicírculo	semicircle
el esguince	sprain
la apoteosis	"apotheosis, finale, climax"
la cristalización	crystallization
la liberalidad	liberality
el topo	"mole, tunnelling machine, spy"
la tuerca	"nut, screw"
la fotocopia	photocopy
la nevera	"refrigerator, fridge, icebox"
*** 2231 - 2240 (/course/195611/spanish-nouns-2-2/224/)	
el cabezazo	"header, headbutt"
la hemoglobina	"hemoglobin, haemoglobin"
la rambla	"ravine, watercourse, avenue"
el descalabro	"set-back, disaster"
el chamán	shaman
el transistor	transistor
el abolengo	"lineage, ancestry"
la acentuación	"accentuation, emphasis"
la diferencial	differential
el vocero	"spokesman, spokesperson"
*** 2241 - 2250 (/course/195611/spanish-nouns-2-2/225/)	
el caño	"spout, tube, pipe"
el estribor	starboard
la ociosidad	"idleness, sloth"
el carnet	"license, licence, card"
la candidez	"naivety, naïveté, naïvety"
el pulpo	"octopus, bungee cord, bungee rope"
la empalizada	"palisade, fence"
la profanación	"profanation, desecration, pollution"
el atolladero	"quagmire, mire, logjam"
el esquiador	skier
*** 2251 - 2260 (/course/195611/spanish-nouns-2-2/226/)	
la autoconciencia	self-conscience
la manutención	"maintenance, support, care"
el parking	"car park, parking, parking lot"
la precampaña	pre-campaign
el yodo	iodine
el anclaje	"anchorage, anchoring, anchorage-dues"
el brasero	"brazier, heater, campfire"
el detector	detector
la castración	"emasculation, castration"
la homilía	homily
*** 2261 - 2270 (/course/195611/spanish-nouns-2-2/227/)	
la hospitalización	hospitalization
el tractor	"tractor, bulldozer"
la usanza	"usage, custom"
el autismo	"autism, Asperger's syndrome, isolation"
el cadalso	scaffold
la bajeza	"baseness, abjection, vile deed"
el cuenco	"bowl, basin, cup"
el crudo	crude
el coadjutor	curate
la patera	dinghy
*** 2271 - 2280 (/course/195611/spanish-nouns-2-2/228/)	
(el)(la) subteniente	sublieutenant
el simposio	symposium
la tarima	"wooden flooring, platform, dais"
la marginalidad	"marginalization, marginal character, minor importance"
la voracidad	"voracity, voraciousness, lust"
la adscripción	ascription
la adherencia	"adherence, adhesion, adhesiveness"
el manzano	apple tree
el fresno	ash
el mareo	"dizziness, seasickness, giddiness"
*** 2281 - 2290 (/course/195611/spanish-nouns-2-2/229/)	
la obertura	overture
el provocador	provoker
la morfina	"morphine, morphia"
la intentona	"foolhardy attempt, wild attempt"
(el)(la) mural	mural
la varianza	variance
la prepotencia	"arrogance, overbearingness, high-handedness"
la confidencia	"confidence, tip, secret"
la lozanía	"freshness, lushness, youthfulness"
el propulsor	"propeller, propellant, fuel"
*** 2291 - 2300 (/course/195611/spanish-nouns-2-2/230/)	
la tesitura	"situation, position, circumstances"
el balanceo	"swinging, rocking, sway"
la superproducción	overproduction
la interactividad	interactivity
la locomoción	"locomotion, movement, motion"
la complexión	"constitution, build, physique"
la integral	integral
el receptáculo	"receptacle, holder"
el estrago	"ruin, ravage"
el separatismo	separatism
*** 2301 - 2310 (/course/195611/spanish-nouns-2-2/231/)	
la cebra	zebra
la favorita	favorite
el destructor	destroyer
el mutismo	"mutism, silence"
la robustez	"sturdiness, hardiness"
el clavel	carnation
el donaire	"grace, charm, pun"
la máxima	"maxim, saying, adage"
la heredad	"property, estate, demesne"
el regionalismo	regionalism
*** 2311 - 2320 (/course/195611/spanish-nouns-2-2/232/)	
el turbante	turban
el agravamiento	aggravation
el relativismo	relativism
el senderismo	hiking
el currículum	resume
la buhardilla	"attic, mansard, dormer window"
el fuelle	"bellows, blower, inverted pleat"
la galleta	"biscuit, cookie, cracker"
los idos	gone
la impedancia	impedance
*** 2321 - 2330 (/course/195611/spanish-nouns-2-2/233/)	
la monografía	monograph
la escaramuza	"skirmish, brush, scuffle"
el almíbar	"syrup, compote, syrupy"
el zoo	zoo
la pulmonía	pneumonia
el zoólogo	zoologist
la replicación	replication
la telepatía	telepathy
el catre	"bed, camp bed, cot"
el formulario	"form, application form, questionnaire"
*** 2331 - 2340 (/course/195611/spanish-nouns-2-2/234/)	
la hiel	"gall, bile, bitterness"
la inseminación	insemination
la clarividencia	"clairvoyance, farsightedness, second sight"
la florencia	florence
la hojalata	"tin, tin-plate"
la aseveración	"assertion, claim"
la cerda	"bristle, sow, horsehair"
el compartimento	compartment
el condestable	Constable
el pupitre	desk
*** 2341 - 2350 (/course/195611/spanish-nouns-2-2/235/)	
la vestidura	"vesture, clothing"
la desfachatez	"impudence, brass, gall"
el animalito	animal
la palestra	"arena, ring, floor"
el peñasco	"boulder, crag, rock"
el cassette	"cassette, tape"
el ocre	ochre
el ogro	"ogre, grump, grouch"
la pira	"pyre, bonfire"
el hijito	sonny
*** 2351 - 2360 (/course/195611/spanish-nouns-2-2/236/)	
el celuloide	celluloid
la disuasión	"deterrence, dissuasion, discouragement"
la desenvoltura	"ease, abandon, impudence"
el morbo	"morbidity, morbidness, excitement"
la picota	"pillory, cherry"
el ponche	"punch, toddy"
la chusma	"rabble, riffraff, vermin"
la plazoleta	small square
el autocontrol	self control
la salubridad	"healthiness, healthcare"
*** 2361 - 2370 (/course/195611/spanish-nouns-2-2/237/)	
la bombilla	"bulb, lamp, light bulb"
(el)(la) concursante	"contestant, competitor"
el desacato	"disrespect, contempt"
la cañada	"glen, ravine, narrow pass"
el gótico	"Gothic, Goth, goth"
la rescisión	"rescission, cancellation"
la cajita	small box
el bandolero	bandit
la cereza	"cherry, cerise"
el miocardio	infarction
*** 2371 - 2380 (/course/195611/spanish-nouns-2-2/238/)	
la parienta	kinswoman
el rotor	rotor
el empalme	"splice, junction, joint"
la astilla	"splinter, sliver, chip"
el comunitario	Community
la automoción	self-propulsion
la desocupación	idleness
el íleon	ileum
la motriz	driving
la operatividad	effectiveness
*** 2381 - 2390 (/course/195611/spanish-nouns-2-2/239/)	
la atenuación	"attenuation, reduction, moderation"
la cómoda	chest of drawers
la cuneta	"gutter, ditch, curb"
la polilla	"moth, clothes moth, bookworm"
la vigía	"watch, watchtower"
el mandarín	Mandarin person
el compilador	compiler
el aventurero	adventurer
el basalto	basalt
la figuración	figuration
*** 2391 - 2400 (/course/195611/spanish-nouns-2-2/240/)	
la desinformación	"misinformation, disinformation, lack of information"
el pubis	"pubis, pelvis, pubic bone"
la acometida	"rush, attack, connection"
el máster	master's degree
el aglomerado	agglomerate
la biopsia	"biopsy, tissue for biopsy"
el tablón	"board, plank, beam"
el trébol	"clover, clubs"
la disipación	dissipation
el doblez	"fold, double, crease"
*** 2401 - 2410 (/course/195611/spanish-nouns-2-2/241/)	
la sorna	"sarcasm, irony"
el renglón	"row, line"
el glamour	"glamor, glamour"
la insensibilidad	"callousness, insensibility, insensitivity"
la glaciación	glaciation
la jabalina	"javelin, spear, wild sow"
la rúbrica	"signature, flourish"
el taco	"wad, cue, block"
el alarido	"yell, howl, yowl"
el aragón	Aragon
*** 2411 - 2420 (/course/195611/spanish-nouns-2-2/242/)	
el populacho	"populace, rabble"
la diálisis	dialysis
el gruñido	"growl, grunt, snarl"
la atrocidad	"outrage, atrocity, awfulness"
el rubí	ruby
el óbolo	mite
el benceno	benzene
el tonelaje	tonnage
la etnografía	ethnography
la gasa	"chiffon, gauze, crêpe"
*** 2421 - 2430 (/course/195611/spanish-nouns-2-2/243/)	
la cazadora	huntress
el carcelero	"jailor, jailer, prison guard"
el leño	"log, old style boat, blockhead"
la recapitulación	"recap, recapitulation, summation"
los repatriados	returnees
el sentimentalismo	"sentimentality, sentimentalism, sentiment"
la bujía	"spark plug, plug, sparking plug"
la abreviación	"abbreviation, shortening, abridgement"
el altruismo	altruism
el ventilador	"fan, ventilator, ceiling fan"
*** 2431 - 2440 (/course/195611/spanish-nouns-2-2/244/)	
el suboficial	non-commissioned officer
el operario	"operator, operative"
el óvalo	oval
la peseta	"peseta, penny, cent"
el sopor	"sleepiness, drowsiness, somnolence"
el corsé	"corset, stays, straitjacket"
el hostigamiento	"harassment, harrying, whipping"
la motora	"motor boat, motorboat, bike"
la psique	"Psyche, psyche"
el reflector	"reflector, searchlight, spotlight"
*** 2441 - 2450 (/course/195611/spanish-nouns-2-2/245/)	
la mezzosoprano	mezzo-soprano
la sofisticación	sophistication
la bronca	"dressing down, telling off, reprimand"
el aleteo	"flutter, flap, flapping"
el pijama	"pajamas, jams, jammies"
la presentadora	presenter
la sacerdotisa	priestess
el corralito	playpen
el espín	porcupine
la floresta	"clearing, glade"
*** 2451 - 2460 (/course/195611/spanish-nouns-2-2/246/)	
el percance	"mishap, accident, mischance"
la algarabía	"rejoicing, jubilation, yellow odontites"
el nevado	snow-capped mountain
el viñedo	vineyard
la profesionalización	professionalization
las catacumbas	catacomb
el duplicado	"duplicate, copy"
el abasto	"provisions, supplies, small shop"
los terópodos	theropods
el derbi	derby
*** 2461 - 2470 (/course/195611/spanish-nouns-2-2/247/)	
la orquestación	"orchestration, scoring"
el almendro	"almond, almond tree"
el risco	"crag, cliff, fritter"
el ramaje	foliage
el glaciar	glacier
la cogida	"goring, shag, bonk"
la solapa	"lapel, flap, book flap"
el libertinaje	"licentiousness, debauchery, profligacy"
el túmulo	"mound, burial mound, tumulus"
el falo	phallus
*** 2471 - 2480 (/course/195611/spanish-nouns-2-2/248/)	
el excedente	"surplus, excess, excessive"
el estero	estuary
la reforestación	"reforestation, afforestation"
el rondó	"rondo, rondeau"
el aeroplano	"airplane, aeroplane, plane"
el apocalipsis	apocalypse
la colecta	"collection, collect, whip-round"
(el)(la) culpable	"culprit, offender"
(el)(la) modista	"dressmaker, modiste"
la gema	"gem, gemstone, bud"
*** 2481 - 2490 (/course/195611/spanish-nouns-2-2/249/)	
la bocina	"horn, hooter, steam-whistle"
el fulano	so-and-so
el subtítulo	"subtitle, caption, subheading"
la tequila	tequila
el acelerador	"accelerator, throttle"
el hervidero	"hot spring, throng, heater"
el hipertexto	hypertext
el péndulo	pendulum
la cabalgata	"ride, parade, procession"
la úlcera	"ulcer, sore"
*** 2491 - 2500 (/course/195611/spanish-nouns-2-2/250/)	
los conservadores	"conservative, Tory, conservator"
la intrusión	"intrusion, trespass"
el puntapié	kick
el antifaz	"mask, eye shield, sleep mask"
el mulo	"mule, ox"
las pagas	pay
la perfidia	"perfidy, treachery"
el silogismo	syllogism
la hamaca	hammock
el cinc	zinc
*** 2501 - 2510 (/course/195611/spanish-nouns-2-2/251/)	
el esófago	"esophagus, gullet, oesophagus"
la trastienda	"back room, back"
la carátula	"cover, jacket"
el crujido	"crack, creak, crunch"
la taifa	kingdom
la pederastia	pederasty
el librito	matchbook
el hacinamiento	overcrowding
(el)(la) oriental	"eastern, Oriental, oriental"
el buscador	"search-engine, searcher, scanner"
*** 2511 - 2520 (/course/195611/spanish-nouns-2-2/252/)	
el relator	teller
el detonante	"trigger, detonator"
la desorientación	"disorientation, confusion"
el intervencionismo	interventionism
la prosecución	pursuance
la oca	"goose, snakes and ladders, New Zealand yam"
los recibos	receipt
(el)(la) vertical	vertical
el vómito	"vomit, puke, gastric juices"
el nene	"little child, kid"
*** 2521 - 2530 (/course/195611/spanish-nouns-2-2/253/)	
la biosfera	biosphere
la hibridación	hybridization
el lucero	"bright star, point of light, star"
el búnker	"bunker, concrete box, safe room"
el barbecho	"fallow, fallow land"
la introspección	introspection
la menstruación	"menstruation, period, menses"
la prodigalidad	"prodigality, wastefulness, extravagance"
la pavada	"silly thing, triviality, silliness"
los altos	"stop, halt, standstill"
*** 2531 - 2540 (/course/195611/spanish-nouns-2-2/254/)	
la adaptabilidad	adaptability
el virginia	Virginia
la alergia	allergy
(el)(la) anarquista	anarchist
el quebranto	"break, debilitation, weakening"
el resquicio	"chink, gap, crevice"
el ropero	"closet, wardrobe, clothier"
el colofón	"colophon, climax, culmination"
el fetiche	"fetish, charm"
la fisura	"fissure, tear, fracture"
*** 2541 - 2550 (/course/195611/spanish-nouns-2-2/255/)	
el agarre	grip
el madrigal	madrigal
la platea	"main floor, stalls, orchestra section"
la honda	"sling, slingshot"
el zurdo	"southpaw, lefty, left-handed person"
la reintegración	"reinstatement, refund, repayment"
la animosidad	"animosity, animus, energy"
la tripa	"gut, intestine, dossier"
el noticiero	news
la pelvis	pelvis
*** 2551 - 2560 (/course/195611/spanish-nouns-2-2/256/)	
la filogenia	phylogeny
la humareda	smoke
el desperdicio	"waste, scraps"
la acuarela	"watercolor, aquarelle, watercolor US"
el zoológico	zoo
la flacura	"leanness, thinness, skinniness"
el water	"toilet, john, closet"
el dosel	canopy
el sílex	"flint, silex"
la galantería	"gallantry, polite gesture, attention"
*** 2561 - 2570 (/course/195611/spanish-nouns-2-2/257/)	
la intranquilidad	"restlessness, restiveness, worry"
la putrefacción	"rot, putrefaction, rottenness"
el sacrilegio	"sacrilege, desecration, profanation"
la esfinge	sphinx
el relojero	"watchmaker, watch box"
la desertización	desertification
el camuflaje	"camouflage, front"
el éster	ester
el brusco	"Knee Holly, Butcher's Broom"
el ventanal	"picture window, large window"
*** 2571 - 2580 (/course/195611/spanish-nouns-2-2/258/)	
el sacramento	"sacrament, host"
el vicario	"vicar, surrogate, curate"
la horticultura	horticulture
el coñac	"cognac, brandy"
la encíclica	encyclical
el eufemismo	euphemism
la disparada	fired
el flagelo	"flagellum, scourge, calamity"
el escondrijo	"nook, cache, hiding place"
el fénix	"phoenix, phenix"
*** 2581 - 2590 (/course/195611/spanish-nouns-2-2/259/)	
el secundario	seconder
la sor	Sister
el diezmo	tithe
el laborismo	labor
el ostracismo	ostracism
la probidad	probity
(el)(la) aristócrata	"aristocrat, nobleman, patrician"
la conjugación	"conjugation, conjugate, conjunction"
el interventor	"controller, inspector, comptroller"
el emirato	emirate
*** 2591 - 2600 (/course/195611/spanish-nouns-2-2/260/)	
la eucaristía	Eucharist
la oída	heard
la hostia	"host, wafer, communion wafer"
la sardina	"sardine, pilchard"
la especia	spice
el spot	spot
la sustracción	"subtraction, abstraction, theft"
la minuciosidad	"thoroughness, minuteness, particularity"
el valenciano	"Valencian, person from Valencia, the people of Valencia"
la vértebra	"vertebra, vertebrae"
*** 2601 - 2610 (/course/195611/spanish-nouns-2-2/261/)	
el multiplicador	multiplier
la madreperla	"pearl, pearl oyster"
la elipse	ellipse
el cortijo	"farmhouse, farm, country property"
el embalaje	"packaging, packing, package"
la polución	"pollution, contamination, ejaculation"
la prolijidad	prolixity
el vendaval	"storm, gale, strong wind"
el abrojo	thistle
el literato	"writer, litterateur, author"
*** 2611 - 2620 (/course/195611/spanish-nouns-2-2/262/)	
la autosuficiencia	self-sufficiency
el republicanismo	republicanism
el asterisco	"asterisk, star"
el bastardo	"bastard, boa, boa constrictor"
el binomio	"binomial, pairing, coupling"
el bolero	bolero
el aljibe	"cistern, tank, reservoir"
el peñón	"crag, rock"
el desánimo	"discouragement, dejection, despondency"
el olmo	"elm, elm tree"
*** 2621 - 2630 (/course/195611/spanish-nouns-2-2/263/)	
el formalismo	"formalism, formality"
la ceca	mint
el parapeto	"parapet, breastwork, bulwark"
la holgura	"space, clearance"
la telecomunicación	telecommunication
el hermanamiento	twinning
el musicólogo	musicologist
la cafeína	"caffeine, caffein"
el hermetismo	"watertight nature, hermetic nature, impenetrability"
el jerez	sherry
*** 2631 - 2640 (/course/195611/spanish-nouns-2-2/264/)	
la libido	libido
el recrudecimiento	"upsurge, recrudescence"
el secretismo	secrecy
el conservatorio	"conservatory, conservatoire, school of music"
la grana	"deep red, dark red, burgundy"
el hombrecito	"little man, little fellow"
la traductora	"translator, interpreter"
la gobernadora	governess
el mulato	mulatto
la precocidad	"precociousness, precocity, prematurity"
*** 2641 - 2650 (/course/195611/spanish-nouns-2-2/265/)	
la boina	"beret, cap, soft cap"
el becerro	"calf, bull calf, male calf"
el inmovilismo	immobility
el júnior	"junior, novice"
(el)(la) dorsal	"jersy number (m), ridge (f) "
el sollozo	"sob, sobbing"
la vainilla	vanilla
la durabilidad	durability
el apólogo	apologue
la baronía	"barony, baronage"
*** 2651 - 2660 (/course/195611/spanish-nouns-2-2/266/)	
el moño	"bun, topknot, bow"
el isótopo	isotope
la pastoral	"pastoral, bucolic"
el vedado	private preserve
la costra	"scab, crust, rind"
el tanteo	"score, scoring, test"
(el)(la) accionista	"shareholder, stockholder"
la despreocupación	"unconcern, disregard, abandon"
la coagulación	coagulation
la sandía	watermelon
*** 2661 - 2670 (/course/195611/spanish-nouns-2-2/267/)	
el aturdimiento	"daze, bewilderment, shock"
la carestía	"famine, shortage, dearness"
el necio	"fool, loggerhead"
el maní	"peanut, groundnut, goober"
el portazo	"slam, bang"
el empirismo	empiricism
la etiología	"aetiology, etiology"
la inanición	"starvation, inanition"
la veda	"closed season, close season"
el fieltro	felt
*** 2671 - 2680 (/course/195611/spanish-nouns-2-2/268/)	
la moraleja	moral
la placenta	"placenta, afterbirth"
la púa	"plectrum, spine, tine"
el pretérito	"preterite, past tense, preterit"
el auspicio	"support, auspice, auspices"
el viaducto	viaduct
el impostor	"impostor, sham"
el derby	Derby
la facilitación	facilitation
el laicismo	secularism
*** 2681 - 2690 (/course/195611/spanish-nouns-2-2/269/)	
la luisa	leslie
la malnutrición	malnutrition
el integrismo	entrenched traditionalism
el amuleto	"amulet, charm, good-luck charm"
el terraplén	"embankment, mound, earthwork"
el pimentón	"green pepper, bell pepper, paprika pepper"
el fotón	photon
el polideportivo	"sports center, sport centre, sports centre"
la cucharada	"tablespoon, spoonful, tablespoonful"
el tribuno	tribune
*** 2691 - 2700 (/course/195611/spanish-nouns-2-2/270/)	
la colcha	"bedspread, quilt, bedcover"
el brazalete	"bracelet, bangle, armlet"
el tonel	"cask, barrel, tun"
el grosero	"double chin, bounder"
el desamor	"lack of affection, indifference, coolness"
el apremio	"pressure, urgency, charge"
el convite	"treat, banquet, feast"
el memorando	memorandum
la inmediatez	"closeness, proximity, immediacy"
la lanzadera	shuttle
*** 2701 - 2710 (/course/195611/spanish-nouns-2-2/271/)	
la amputación	amputation
la cognición	cognition
la encantadora	"enchanter, magician"
el pesquero	fishing boat
el atasco	"jam, clogging, clog"
el faisán	"pheasant, pheasant mushroom"
la ortega	sandgrouse
el alga	"seaweed, alga"
la cata	"tasting, taste, bite"
el novillero	truant
*** 2711 - 2720 (/course/195611/spanish-nouns-2-2/272/)	
la viudedad	widowhood
el sionismo	Zionism
la archidiócesis	archdiocese
el toldo	"awning, canopy, blind"
el canasto	"basket, hamper"
la flotilla	"flotilla, fleet"
el extravío	"loss, misplacement, straying"
el moco	"mucus, snot, mass of creases"
el gabán	overcoat
el polaco	"Polish, Pole, vendor"
*** 2721 - 2730 (/course/195611/spanish-nouns-2-2/273/)	
el salmo	psalm
el granero	"silo, barn, granary"
el cancionero	song book
el amonio	ammonium
la contraprestación	consideration
la credulidad	credulity
el anticuario	"antiquarian, antique dealer, antiquary"
el zonzo	"idiot, bore"
el joyero	"jeweler, jewellery box, jewelry box"
el tanatorio	"morgue, mortuary, funeral home"
*** 2731 - 2740 (/course/195611/spanish-nouns-2-2/274/)	
la trepa	"scrambling, hide"
el zapatero	"shoemaker, cobbler, shoerack"
la fotógrafa	photographer
el anverso	"obverse, head, front page"
la inviolabilidad	"inviolability, sanctity"
el sarampión	measles
el cole	"high school, primary school, primary"
el soto	"riverside grove, riverside copse, riverside vegetation"
la podredumbre	"rottenness, rot, putrefaction"
el velero	"sailboat, sailer, sailing ship"
*** 2741 - 2750 (/course/195611/spanish-nouns-2-2/275/)	
el calamar	"squid, cuttlefish, calamari"
la hinchazón	"swelling, puffiness, bump"
la jugadora	"player, gambler"
el mánager	manager
el arroyuelo	"rivulet, streamlet, brooklet"
la conflictividad	unrest
el módem	modem
la adulación	"adulation, flattery, sycophancy"
la bifurcación	"bifurcation, fork, division"
el ahogo	"choke, drowning, suffocation"
*** 2751 - 2760 (/course/195611/spanish-nouns-2-2/276/)	
el generador	generator
el hebreo	"Hebrew, Jew, Jewish person"
la discrecionalidad	discretion
la cancela	iron gate
el fardo	"bale, package, bundle"
la congruencia	"congruence, coherence, sense"
las pegas	"downside, sticking"
el hacendado	"farmer, yeoman"
los federados	federated
la nivelación	"levelling, levelling out"
*** 2761 - 2770 (/course/195611/spanish-nouns-2-2/277/)	
la virilidad	"manliness, virility, manhood"
la sedición	"sedition, insurrection"
el bosquejo	"sketch, outline, draft"
la insensatez	"stupidity, idiocy, folly"
el tentador	"tempter, temptress"
la zeta	"Z, police car, z-car"
la psicóloga	psychologist
la convección	convection
el litio	lithium
el anatema	anathema
*** 2771 - 2780 (/course/195611/spanish-nouns-2-2/278/)	
la mancomunidad	"association, commonwealth, community"
el automatismo	automatism
el trenzado	"braid, entrechat, plaiting"
el cerezo	"cherry tree, cherry, cherry-wood"
la loza	"crockery, faience, dishes"
el bochorno	"embarrassment, sultry weather, sultriness"
el masón	"mason, freemason"
el ornamento	"ornament, decoration"
la tesorería	"treasury, liquid assets, treasurer´s office"
el judo	judo
*** 2781 - 2790 (/course/195611/spanish-nouns-2-2/279/)	
la receptividad	"receptivity, receptiveness, propensity"
el veintiuno	"pontoon, twenty-one"
el colegiado	"collegiate member, referee"
la discontinuidad	discontinuity
el índigo	indigo
el medallón	"locket, medallion"
el candado	"padlock, lock"
la bufanda	"scarf, muffler, perk"
la juerga	"spree, bender, binge"
la tonada	"tune, melody"
*** 2791 - 2800 (/course/195611/spanish-nouns-2-2/280/)	
la guirnalda	"wreath, garland, festoon"
el católico	Catholic
el farmacéutico	"chemist, pharmacist, druggist"
la institutriz	governess
el eslalon	slalom
el boicoteo	"boycott, sanction"
el pendón	"banner, pennon, standard"
el hermanito	brother
el laudo	"decision, judgment, ruling"
la eclosión	"hatching, bloom, eclosion"
*** 2801 - 2810 (/course/195611/spanish-nouns-2-2/281/)	
el cadí	Kadi
la travesura	"mischief, trick, pranks"
el monolito	monolith
el escote	"neck, neckline, cleavage"
el pillo	"rascal, blackguard, rogue"
el escalador	scaler
el chillido	"squeal, scream, shriek"
la subcultura	subculture
el petrolero	"tanker, oil tanker, oilman"
la peripecia	"unforeseen incident, unexpected event, vicissitude"
*** 2811 - 2820 (/course/195611/spanish-nouns-2-2/282/)	
el estalinismo	Stalinism
la epistemología	epistemology
el agrimensor	surveyor
la fuerte	fort
el encuadre	"frame, selection"
la molienda	"grinding, milling, grist"
el hangar	"hangar, shed"
la siderurgia	"iron and steel industry, siderurgy"
la calleja	lane
la pantomima	"pantomime, panto, dumbshow"
*** 2821 - 2830 (/course/195611/spanish-nouns-2-2/283/)	
la trenza	"plait, braid, tress"
(el)(la) yanqui	"Yankee, Yank"
el pibe	"kid, lad, boy"
la pecadora	sinner
la germinación	germination
la individualización	individualization
la abyección	"abjection, abomination, infamy"
el maletero	"boot, trunk, porter"
el ropaje	"clothing, clothes, garb"
el demoledor	"demolishing, demolisher"
*** 2831 - 2840 (/course/195611/spanish-nouns-2-2/284/)	
la yuxtaposición	"juxtaposition, apposition"
la vitrina	"showcase, cabinet, glass cabinet"
el maná	"manna, manna from heaven, stroke of luck"
la sistematización	systematization
la bordada	tack
el apostolado	"apostleship, apostolate, ministry"
el desahucio	"eviction, ouster"
la orla	"fringe, trimming, border"
la sinrazón	"injustice, wrong, outrage"
el militarismo	militarism
*** 2841 - 2850 (/course/195611/spanish-nouns-2-2/285/)	
el neón	"neon, neon sign"
la loa	"praise, high praise, prologue"
el bocadillo	"sandwich, snack, bit part"
el fuste	"shank, shaft, importance"
la estupefacción	stupefaction
el manganeso	manganese
el nacionalsocialismo	National
el rediseño	redesign
los generales	generals
el deceso	"death, passing"
*** 2851 - 2860 (/course/195611/spanish-nouns-2-2/286/)	
el genotipo	genotype
el pitón	"python, piton, spout"
el tinto	"red wine, black coffee"
el peluquero	"barber, hairdresser"
la herrera	"smith, blacksmith"
la aplicabilidad	"applicability, relevance"
la desmovilización	demobilization
la reafirmación	reaffirmation
(el)(la) agravante	aggravating factor
el asador	"barbeque, barbecue, spit"
*** 2861 - 2870 (/course/195611/spanish-nouns-2-2/287/)	
el equinoccio	equinox
la maledicencia	evil-speaking
la exuberancia	"exuberance, lushness"
la hondonada	"hollow, dip"
la mermelada	"jam, marmalade"
la alameda	"mall, grove, avenue"
la terquedad	"obstinacy, obduracy, stubbornness"
el rédito	"revenue, return, yield"
el seiscientos	six hundred
el zarpazo	"snatch, grab, swipe"
*** 2871 - 2880 (/course/195611/spanish-nouns-2-2/288/)	
el penacho	"tuft, plume, crest"
el gene	gene
la goleadora	goal scorer
el engorde	fattening
la militar	"military, soldier"
los olivares	olive grove
la bici	"bike, pushbike"
el chef	chef
la circuncisión	circumcision
el enamoramiento	falling in love
*** 2881 - 2890 (/course/195611/spanish-nouns-2-2/289/)	
el alborozo	"joy, delight"
la palmera	"palm tree, palm, heart-shaped puff pastry"
el peluche	"teddy bear, cuddly toy, fluffy toy"
los fracasados	"failure, loser"
la calidez	warmth
la docilidad	"docility, pliancy, amenability"
la mecanización	mechanization
la unicidad	"uniqueness, oneness"
los enterados	aware
la empresaria	"businessman, entrepreneur, manager"
*** 2891 - 2900 (/course/195611/spanish-nouns-2-2/290/)	
la indigestión	indigestion
el musulmán	"Moslem, Mussulman, Muslim"
el madero	"pig, trunk, ship"
el metraje	"running time, duration, length"
el secretariado	"secretarial studies, secretarial course, secretary's office"
el guano	"guano, balsa tree, woolly material from the balsa tree used for stuffing"
el capo	"bonnet, hood, boss"
la cartulina	"cardboard, poster board, card"
el colón	"Columbus, colon"
el franco	franc
*** 2901 - 2910 (/course/195611/spanish-nouns-2-2/291/)	
la indeterminación	indeterminacy
la siega	"mown grain, mowings, mown grass"
(el)(la) rosa	"pink (m), rose (f)"
el pregón	"proclamation, announcement"
la simpleza	"simplicity, simpleness, crassness"
la simultaneidad	"simultaneity, simultaneousness"
el estabilizador	"stabilizer, stabilizer bar, anti-roll bar"
el granjero	farmer
el articulado	articles
el internado	"boarding school, internship, inmate"
*** 2911 - 2920 (/course/195611/spanish-nouns-2-2/292/)	
el capitel	"capital, chapiter"
el fugitivo	"fugitive, runaway"
la monstruosidad	"monstrosity, eyesore, freak"
la serenata	"serenade, din, racket"
el forcejeo	"struggle, tussle, resistance"
la noria	"waterwheel, big wheel, ferris wheel"
la camaradería	"camaraderie, friendship, friendliness"
la orfandad	orphanhood
la parsimonia	"parsimony, phlegm, unhurriedness"
la polimerización	polymerization
*** 2921 - 2930 (/course/195611/spanish-nouns-2-2/293/)	
el renuncio	revoke
(el)(la) antagonista	antagonist
el coso	"arena, bullring, main street"
el matón	"bully, thug, bruiser"
la farándula	"celebrity, show business, entertainment world"
la desecación	"desiccation, exsiccation"
el dogmatismo	dogmatism
el eunuco	eunuch
la gula	"gluttony, greed, greediness"
(el)(la) golfista	golfer
*** 2931 - 2940 (/course/195611/spanish-nouns-2-2/294/)	
el pomo	"knob, door knob, pommel"
el agüero	"omen, portent, luck"
el tálamo	"thalamus, marriage bed, wedding bed"
la bocanada	"whiff, mouthful, puff"
la climatología	climatology
el monóxido	monoxide
la hueste	"host, army, crowd"
la degustación	tasting
la recámara	"bedroom, breech, magazine"
la picadura	"bite, sting, cavity"
*** 2941 - 2950 (/course/195611/spanish-nouns-2-2/295/)	
el bonete	"cap, biretta, reticulum"
el pepino	"cucumber, wiener, dick"
el damasco	"damask, apricot"
la divisoria	divide
el jubón	"doublet, jerkin"
el arce	maple
el mosquetero	musketeer
la amapola	"opium poppy, poppy, field poppy"
la unción	"unction, dedication, devotion"
la cosmovisión	world view
*** 2951 - 2960 (/course/195611/spanish-nouns-2-2/296/)	
el grillo	cricket
el bienhechor	do-gooder
la botánica	"botany, botanist"
la mónada	monad
la poligamia	polygamy
el revoltijo	"jumble, mess, welter"
el dependiente	"dependent, employee"
el agrupamiento	grouping
la opereta	operetta
el bodegón	"still life, taproom, tavern"
*** 2961 - 2970 (/course/195611/spanish-nouns-2-2/297/)	
el round	round
el derivado	derivative
el desparpajo	"self-confidence, ease, impudence"
el adverbio	adverb
(el)(la) confidente	"confident, confidant, confidante"
el hado	"fate, doom, destiny"
las exequias	funeral rites
el mecenazgo	"patronage, sponsorship"
el sincretismo	syncretism
el yogur	"yogurt, yoghurt"
*** 2971 - 2980 (/course/195611/spanish-nouns-2-2/298/)	
el austriaco	Austrian
la somnolencia	"sleepiness, somnolence, drowsiness"
la dedicatoria	"dedication, inscription"
el realce	"enhancement, luster, highlight"
el champaña	"champagne, bubbly"
el pus	pus
los revelados	developing
la calentura	"fad, desire, urge"
el cabrito	"kid, client, cabrito"
la logística	logistics
*** 2981 - 2990 (/course/195611/spanish-nouns-2-2/299/)	
la fécula	starch
(el)(la) recurrente	appellant
el boro	boron
la objetivación	objectification
el codazo	elbow
la gallardía	"gallantry, gracefulness, valour"
el embrollo	"imbroglio, muddle, confusion"
la incumbencia	"incumbency, responsibility"
el quiosco	"kiosk, pavilion"
la lavandería	"laundry, laundromat, launderette"
*** 2991 - 3000 (/course/195611/spanish-nouns-2-2/300/)	
el señuelo	"lure, decoy, bait"
la mitra	"Mithras, miter"
la brusquedad	"suddenness, sharpness, brusqueness"
la tapicería	"tapestry, upholstery, upholsterer's"
la alta	"certificate of fitness to work, certificate of discharge, all-clear"
el cobalto	cobalt
la desorganización	"disorganization, disruption, lack of organization US"
la escolaridad	"education, schooling"
el hollín	soot
la paleontología	"paleontology, palaeontology"
*** 3001 - 3010 (/course/195611/spanish-nouns-2-2/301/)	
el ají	"chilli, chili, pepper"
la risita	chuckle
la telaraña	"cobweb, web, spiderweb"
la grey	"flock, sheep, congregation"
el infiltrado	infiltrate
la legación	legation
el penique	penny
el fisiólogo	physiologist
la cacerola	"saucepan, pan, skillet"
el boceto	"sketch, outline"
*** 3011 - 3020 (/course/195611/spanish-nouns-2-2/302/)	
el anteojo	"spectacles, binoculars, blinkers"
la narradora	"narrator, storyteller"
la pervivencia	survival
la laringe	larynx
el platón	Plato
el transepto	transept
los bajos	bottom
el locutor	"announcer, broadcaster, narrator"
(el)(la) croata	"Croatian, Croat"
el imitador	"imitator, impersonator, mimic"
*** 3021 - 3030 (/course/195611/spanish-nouns-2-2/303/)	
la mandioca	"manioc, cassava, yuca"
la pileta	"pool, swimming pool, mud pond"
el regulador	"regulator, controller, buffer"
la rumba	rumba
el condimento	"seasoning, condiment, flavor"
el símil	"simile, comparison"
el tic	"tic, twitch"
la sociabilidad	"sociability, social skills, sociableness"
el veintiocho	"twenty-eight, twenty-eighth"
el adán	"Adam, sight, mess"
*** 3031 - 3040 (/course/195611/spanish-nouns-2-2/304/)	
el moisés	"bassinet, carrycot, Moses basket"
el hálito	"breath, halite, gentle breeze"
la mediadora	"mediator, mediatrix"
el nácar	"nacre, mother of pearl"
el hule	"rubber, oilcloth, oilskin"
el cuadrado	square
la sublimación	sublimation
la palabrería	"talk, hot air"
el ovillo	"ball, foetal position"
la buda	Buddha
*** 3041 - 3050 (/course/195611/spanish-nouns-2-2/305/)	
el desmoronamiento	"collapse, breaking down, breakdown"
el antro	"dump, dive, hole"
el infortunado	unfortunate
la dicotomía	dichotomy
la pulsión	"urge, drive, impulse"
la aria	aria
el callo	"callus, corn"
el desencuentro	"failed meeting, disagreement"
la chacra	"farm, small farm, Chakra"
el lustro	"five-year period, lustrum"
*** 3051 - 3060 (/course/195611/spanish-nouns-2-2/306/)	
el disquete	"floppy, diskette, floppy disk"
el junco	"junk, rush, reed"
la materialidad	"materiality, materialness"
el menisco	meniscus
la grupa	"rump, buttocks, hindquarters"
la aterrada	terrified
la parabrisas	"windscreen, windshield, screen"
la cana	"reed, cane, stem"
el deshonor	dishonor
el machismo	"machismo, chauvinism"
*** 3061 - 3070 (/course/195611/spanish-nouns-2-2/307/)	
el rearme	"rearmament, re-arming"
el avatar	avatar
el contemporáneo	"contemporary, contemporaneous"
la debacle	"debacle, collapse, downfall"
la paella	"paella, paella pan"
(el)(la) hablante	"speaking, speaker"
la estratificación	"stratification, bedding"
el estructuralismo	structuralism
la electrificación	electrification
el gurú	guru
*** 3071 - 3080 (/course/195611/spanish-nouns-2-2/308/)	
el arenque	herring
la callejuela	"lane, backstreet, passageway"
el peral	"pear, pear wood"
el penal	"penalty, prison, gaol"
la pinza	"pleat, tongs, tweezers"
el pagaré	promissory note
el usufructo	usufruct
la blandura	"weakness, softness, blandness"
la consultora	consultant
el desapego	disregard
*** 3081 - 3090 (/course/195611/spanish-nouns-2-2/309/)	
la hilaridad	hilarity
el búfalo	"buffalo, American bison, American buffalo"
la bonificación	"discount, bonus, extra pay"
la duplicidad	"duplicity, duplication"
el homenajeado	honoree
la indisciplina	indiscipline
el subproducto	sub product
la turbulencia	"turbulence, turmoil, uproar"
la vaguedad	"vagueness, haziness, ambiguity"
la añoranza	"yearning, homesickness, hankering"
*** 3091 - 3100 (/course/195611/spanish-nouns-2-2/310/)	
el desmembramiento	dismemberment
el escocés	"Scottish, Scots, Scotch"
el teórico	"theorist, theoretician"
la pedofilia	pedophilia
la postulación	"postulation, collection, nomination"
la saya	"skirt, petticoat, dress"
la animadversión	"animadversion, ill will, antagonism"
la perra	"bitch, slut, coins"
la glosa	"gloss, comment, note"
la arenga	"harangue, spiel"
*** 3101 - 3110 (/course/195611/spanish-nouns-2-2/311/)	
el encabezamiento	"header, caption, headline"
la indignidad	"indignity, outrage"
el mijo	millet
el misal	missal
el estuco	"stucco, plaster, stucco work"
el archidiácono	archdeacon
la caterva	"bunch, gang,"
la cruda	hangover
el hospicio	"hospice, hostel, orphanage"
el posadero	"landlord, innkeeper, host"
*** 3111 - 3120 (/course/195611/spanish-nouns-2-2/312/)	
la miopía	"nearsightedness, myopia, short-sightedness"
la ramificación	"ramification, branch, division"
el substrato	substrate
la difracción	diffraction
el bombardero	bomber
(el)(la) astronauta	"astronaut, spaceman"
(el)(la) exponente	"exponent, indicator, index"
el abeto	"fir, fir tree, silver fir"
la amazona	"horsewoman, riding habit, Amazon"
la irracionalidad	irrationality
*** 3121 - 3130 (/course/195611/spanish-nouns-2-2/313/)	
el kilogramo	"kilogram, kilogramme"
la tablilla	"notice board, record sheet, chocolate bar"
la personalización	personalization
la progenie	"progeny, brood"
el sexenio	six years
la alevosía	"treachery, skulduggery, premeditation"
la irrealidad	"unreality, fantasy"
la hiedra	ivy
la espectacularidad	spectacular
la ablación	ablation
*** 3131 - 3140 (/course/195611/spanish-nouns-2-2/314/)	
la puja	"bid, bidding"
la cincha	"cinch, girth, webbing"
la acuñación	"coinage, mintage"
la mexicana	Mexican
el retículo	"reticle, reticule"
la banqueta	"sidewalk, banquette, bench"
la toxina	toxin
el jarrón	vase
el arnés	harness
la aspirina	aspirin
*** 3141 - 3150 (/course/195611/spanish-nouns-2-2/315/)	
la carita	face
la cimentación	"laying foundations, founding"
la neurona	"neuron, nerve cell"
el pétalo	petal
el filántropo	philanthropist
el prurito	"pruritus, itch, itching"
el restaurador	"restorer, restaurateur"
el espinazo	"spine, backbone"
el trípode	"tripod, three-legged stool"
la virtualidad	virtuality
*** 3151 - 3160 (/course/195611/spanish-nouns-2-2/316/)	
el pupilo	"ward, pupil, boarder"
el estireno	styrene
el candelabro	"candelabrum, candelabra"
el custodio	"custodian, guardian, police officer"
la disgregación	"disintegration, breaking up, break-up"
el hacedor	"doer, maker"
las vetas	highlights
la poseedora	"owner, holder, possessor"
la incautación	"seizure, n, confiscation"
el griterío	"shouts, cries, uproar"
*** 3161 - 3170 (/course/195611/spanish-nouns-2-2/317/)	
el gel	"shower gel, liquid soap, gel"
el anejo	supplement
el teletexto	teletext
el tazón	"bowl, basin, mug"
(los)(las) convocantes	conveners
la escapatoria	"escape, loophole, getaway"
la impureza	"impurity, defect, foreign body"
la interpolación	interpolation
el arrendatario	"lessee, leaseholder"
el arriero	"muleteer, mule driver"
*** 3171 - 3180 (/course/195611/spanish-nouns-2-2/318/)	
el reactivo	reagent
el autorretrato	self-portrait
la herrería	"smithy, forge, farriery"
el desenfreno	"wildness, license, wantonness"
la mercadería	"merchandise, goods"
la corresponsabilidad	responsibility
el pacifismo	pacifism
el queroseno	"kerosene, paraffin oil"
el tándem	"tandem, tandem bicycle, duo"
el zodíaco	zodiac
*** 3181 - 3190 (/course/195611/spanish-nouns-2-2/319/)	
el eclecticismo	eclecticism
la gacela	"gazelle, springbok"
la insignificancia	"insignificance, negligibility, triviality"
el perturbador	jammer
el conector	"plug, connector"
la poda	"pruning, pruning time"
la reprimenda	"rebuke, reprimand, telling off"
la sílice	"silica, silicon dioxide, quartz"
la lonja	"slice, rasher, market"
el tifus	typhus
*** 3191 - 3200 (/course/195611/spanish-nouns-2-2/320/)	
la sintomatología	symptomatology
el maniquí	"dummy, mannequin, manikin"
el fatalismo	fatalism
el sainete	"interlude, short"
el kit	"kit, kit form"
el opresor	oppressor
la algazara	"uproar, pandemonium, noise"
el tejo	"yew, quoit, hopscotch"
el compañerismo	comradeship
el denuedo	"boldness, daring, valour"
*** 3201 - 3210 (/course/195611/spanish-nouns-2-2/321/)	
la dopamina	dopamine
la camada	litter
la barbacoa	"barbecue, outdoor barbecue, barbecued food"
la contrarrevolución	counterrevolution
el amontonamiento	"crowding, gathering, heaping"
el paladín	"defender, paladin"
el jubileo	Jubilee
la pedida	"popthe question, proposal"
la promiscuidad	"promiscuity, promiscuousness"
el hechicero	sorcerer
*** 3211 - 3220 (/course/195611/spanish-nouns-2-2/322/)	
el candil	oil lamp
el equívoco	"ambiguity, equivocation, pun"
el bajón	"bassoon, fall, sharp drop"
la rellena	"black pudding, blood sausage"
el cojín	"cushion, squab"
(el)(la) gendarme	"gendarme, police officer"
el chacal	"jackal, buzzard, vulture"
la raqueta	"racket, racquet, tennis player"
el fraccionamiento	"residential development, estate, compound"
el limo	"silt, slime, mud"
*** 3221 - 3230 (/course/195611/spanish-nouns-2-2/323/)	
el desaire	"slight, rebuff, snub"
la chalupa	"small canoe, narrow canoe, boat"
el filamento	"strand, filament, thread"
la mulata	mulatto
la salvadora	"savior, saver, rescuer"
la sobreexplotación	overexploitation
la versificación	versification
el acrecentamiento	"accretion, enhancement"
la cohabitación	cohabitation
el rozamiento	"friction, wear, rubbing"
*** 3231 - 3240 (/course/195611/spanish-nouns-2-2/324/)	
la percha	"hanger, perch, peg"
el rellano	"landing, flat area, level area"
la malignidad	"malignancy, malignity"
el encono	"rancor, bitterness, spite"
el camarón	"shrimp, prawn, common prawn"
la soda	"soda, soda water, cafe"
la bancada	"thwart, rower's bench, bench"
la coronilla	"top, pate, crown"
el egipcio	Egyptian
la chupa	jacket
*** 3241 - 3250 (/course/195611/spanish-nouns-2-2/325/)	
el atracciones	"attraction, attractiveness, draw"
la contractura	contracture
(el)(la) independiente	"independent, freelance"
el lavadero	"laundry, washing place, panning site"
el noruego	Norwegian
el placebo	placebo
el envite	stake
la transfusión	transfusion
la eurodiputada	"MEP, Euro MP"
el expolio	"pillaging, plundering, hullaballoo"
*** 3251 - 3260 (/course/195611/spanish-nouns-2-2/326/)	
(el)(la) vicecanciller	Vice Chancellor
la celada	"ambush, sallet, trick"
el antipapa	antipope
el simio	"ape, simian"
el hervor	"boil, boiling"
la salmuera	brine
el castor	"castor, beaver"
el regidor	"councilor, stage manager"
el seto	hedge
la librea	livery
*** 3261 - 3270 (/course/195611/spanish-nouns-2-2/327/)	
el racionamiento	rationing
el ecuatoriano	Ecuadorian
el papeleo	"paperwork, red tape"
el aforismo	"aphorism, dictum"
el colorante	"coloring, dye, coloring matter"
el diácono	deacon
la esquila	"handbell, small bell, shearing"
(el)(la) pinche	"kitchen help, scullion, scullery maid"
el latifundio	"latifundia, large estate, latifundium"
la mantilla	"mantilla, shawl, baby blanket"
*** 3271 - 3280 (/course/195611/spanish-nouns-2-2/328/)	
la vendimia	"vintage, grape harvest, harvest"
el póster	poster
el entrevistador	interviewer
la conceptualización	conceptualization
la desarticulación	"break-up, breaking up, disbanding"
la colegiata	collegiate
la llovizna	"drizzle, drizzling, misty rain"
el marcaje	marking
la empujada	push
el serrucho	"saw, handsaw"
*** 3281 - 3290 (/course/195611/spanish-nouns-2-2/329/)	
la morosidad	"slowness in paying, defaulting, default"
la vileza	"turpitude, vileness, meanness"
el empleador	employer
la libia	Libya
la reformulación	reformulation
la renegociación	renegotiation
la secularización	secularization
la capitanía	"captaincy, company, military government"
el graznido	"croak, caw, squawk"
el timonel	"helmsman, coxswain, cox"
*** 3291 - 3300 (/course/195611/spanish-nouns-2-2/330/)	
el empréstito	loan
la fechoría	"misdeed, villainy, piece of mischief"
el protón	proton
el primor	"skill, care, delicacy"
el estornudo	sneeze
el rodillo	"steamroller, road roller, roller"
la tea	torch
el vizconde	viscount
la experta	"expert, connoisseur"
la salita	"parlor, sitting room"
*** 3301 - 3310 (/course/195611/spanish-nouns-2-2/331/)	
la hornacina	"alcove, niche, recess"
la cerilla	"match, taper, wax"
la seta	mushroom
el diapasón	"tuning fork, fingerboard"
la voluta	"volute, scroll, spiral"
el silbato	"whistle, small rupture"
la sierva	serf
el cartógrafo	"cartographer, mapmaker"
el vasallo	vassal
la centralidad	centrality
*** 3311 - 3320 (/course/195611/spanish-nouns-2-2/332/)	
el botellón	binge drinking
el adagio	"adagio, adage"
el tendido	"hanging out, pegging out, overhead cables"
la indiscreción	"indiscretion, tactless thing to ask, tactless thing to say, tactless thing to do, etc."
la masculinidad	"masculinity, manhood, manliness"
el pichón	"pigeon, squab, fledgling"
la prédica	"sermon, homily"
el utensilio	"utensil, tool"
el marisco	shellfish
la aquiescencia	acquiescence
*** 3321 - 3330 (/course/195611/spanish-nouns-2-2/333/)	
el descontrol	"chaos, turmoil, disarray"
la obsidiana	obsidian
el proselitismo	"proselytism, preaching"
la semántica	semantics
el amplificador	"amplifier, booster"
el asturiano	Asturian
la gratificación	"gratuity, gratification, reward"
el desborde	"overflow, overflowing"
la prominencia	"prominence, saliency, salience"
el reno	"reindeer, caribou"
*** 3331 - 3340 (/course/195611/spanish-nouns-2-2/334/)	
la retrospectiva	"retrospective, hindsight"
el talud	"slope, incline, drop"
el tiento	"touch, feeling, care"
la alcurnia	"lineage, ancestry"
el resfriado	"cold, flu"
la itinerancia	roaming
la termodinámica	thermodynamics
la tauromaquia	"bullfighting, tauromachy, the art of bullfighting"
el alijo	"cache, stash, haul"
la camarilla	"clique, ring, cabal"
*** 3341 - 3350 (/course/195611/spanish-nouns-2-2/335/)	
el mutuo	consumer loan
el enganche	"coupling, hitch, hook"
el horóscopo	"horoscope, star sign, sign"
(el)(la) médium	"medium, psychic"
la paralaje	parallax
el filón	"seam, vein, gold mine"
el vicesecretario	Deputy Secretary
la menopausia	menopause
el garbanzo	chickpea
la exhortación	"exhortation, appeal"
*** 3351 - 3360 (/course/195611/spanish-nouns-2-2/336/)	
el hostal	"hostel, guesthouse, inn"
el hidróxido	hydroxide
la ineptitud	"ineptitude, ineptness, inaptitude"
el centavo	"penny, cent, centavo"
el ático	"penthouse, attic, loft"
la silicona	"silicone, silicone cement, silicone rubber"
el pezón	"teat, nipple, tread"
la historiadora	historian
el virtuoso	virtuoso
el brandy	brandy
*** 3361 - 3370 (/course/195611/spanish-nouns-2-2/337/)	
el electromagnetismo	electromagnetism
la habitabilidad	habitability
la territorialidad	territoriality
la persiana	"blind, shade, louver"
el pedernal	"flint, stone, rock"
la escalerilla	gangway
el boquete	"hole, gap, opening"
la ignición	ignition
(el)(la) ignorante	ignoramus
el lupus	lupus
*** 3371 - 3380 (/course/195611/spanish-nouns-2-2/338/)	
el moho	"mold, rust, mildew"
la reminiscencia	"reminiscence, memory"
el sulfuro	"sulfide, sulphide"
los aprovechados	"opportunist, scrounger"
la joroba	hump
la solitaria	tapeworm
la ineficiencia	inefficiency
la mantención	"maintenance, support"
la respetabilidad	respectability
(el)(la) principiante	"beginner, novice"
*** 3381 - 3390 (/course/195611/spanish-nouns-2-2/339/)	
el deudo	blood relation
el cayo	"cay, key"
el apio	celery
la miga	"crumb, nitty-gritty, substance"
el descarte	"discarded cards, discard pile, throw away pile"
la niñera	"nanny, nurse, nursemaid"
la jauría	pack (of hounds)
el refectorio	refectory
el zafiro	sapphire
la ciénaga	"swamp, bog"
*** 3391 - 3400 (/course/195611/spanish-nouns-2-2/340/)	
la cubeta	"tray, bucket, pail"
el parlamentarismo	parliamentarism
el aguacate	"avocado, avocado pear tree, avocado pear"
la pendencia	brawl
el eucalipto	"eucalyptus, gum tree"
el filete	"filet, fillet, steak"
la fruición	"fruition, delight, joy"
la estera	"mat, matting, rush mat"
el palacete	"palazzo, mansion, small palace"
la cartilla	"passbook, savings book, military service record"
*** 3401 - 3410 (/course/195611/spanish-nouns-2-2/341/)	
el patriarcado	"patriarchate, patriarchy"
la berlina	"sedan, brougham"
el milano	"white tailed kite, common eagle ray"
la desmentida	denial
el malo	villain
el responso	"prayer for the dead, scolding, telling-off"
la vedette	"star, leading lady"
la apoplejía	"apoplexy, stroke, cerebrovascular accident"
el contrasentido	"contradiction, nonsense"
la disentería	dysentery
*** 3411 - 3420 (/course/195611/spanish-nouns-2-2/342/)	
el fósil	fossil
el azabache	"jet, blue bird-of-paradise"
(el)(la) particular	"matter, individual"
la mitosis	mitosis
la cuadratura	quadrature
la minuta	"quick meal, draft, rough draft"
la extirpación	"removal, extirpation, eradication"
el postigo	"shutter, wicket, side door"
el ayo	tutor
la popularización	popularization
*** 3421 - 3430 (/course/195611/spanish-nouns-2-2/343/)	
el tanto	"point, goal"
la tasación	"assessment, appraisal, rating"
el bachiller	"bachelor, graduate, secondary school"
el bardo	bard
el pajarito	birdie
la consolación	consolation
la letanía	"litany, constant refrain, long list"
el palestino	Palestinian
el salvoconducto	"pass, safeguard, safe-conduct"
el bribón	"rascal, knave, villain"
*** 3431 - 3440 (/course/195611/spanish-nouns-2-2/344/)	
el redentor	redeemer
el rufián	"ruffian, roughneck"
el significante	"signifier, significant"
la caleta	"small cove, small inlet, small boat"
la catedrática	professor
la tiniebla	darkness
la vocecita	little voice
el consumismo	consumerism
el frescor	"freshness, coolness"
el alumbramiento	"delivery, illumination, lighting"
*** 3441 - 3450 (/course/195611/spanish-nouns-2-2/345/)	
el balsero	ferryman
la reyerta	"fight, brawl, clash"
el canguro	kangaroo
el bache	"pothole, lean spell, rough patch"
la sombrilla	"umbrella, parasol, sun umbrella"
el subterráneo	"underground room, subterranean room"
la autodestrucción	self-destruction
la dilución	dilution
la maniobrabilidad	maneuverability
la neutralización	"neutralization, counteraction"
*** 3451 - 3460 (/course/195611/spanish-nouns-2-2/346/)	
el nirvana	nirvana
la redefinición	redefinition
el armero	"armourer, gunsmith, armorer"
la querencia	"attachment, fondness, homesickness"
el prospecto	"leaflet, prospectus, information pamphlet"
el mineral	"mineral, ore"
el narcisismo	narcissism
la pulsación	"pulse, touch, pulsation"
el rublo	"ruble, rouble"
el travesti	"transvestite, drag"
*** 3461 - 3470 (/course/195611/spanish-nouns-2-2/347/)	
la funeraria	"undertaker's, funeral parlor, funeral home"
la invasora	invader
el curandero	"quack, quack doctor"
la categorización	"categorizing, cataloguing, categorization"
el karate	karate
el espaldarazo	"accolade, recognition, slap on the back"
el anacronismo	anachronism
la asimetría	asymmetry
la voladura	"blasting, demolition, blowing-up"
el cereal	"cereal, cereal plant"
*** 3471 - 3480 (/course/195611/spanish-nouns-2-2/348/)	
la impertinencia	impertinence
el lapsus	lapse
el puntero	"pointer, cursor"
el jaleo	"racket, din, row"
la esterilización	"sterilization, sterilisation, neutering"
la insolación	"sunstroke, insolation, heatstroke"
la reválida	"validation, confirmation, final exams"
la vulva	vulva
el carcinoma	carcinoma
el gallito	"cocky git, arrogant swine"
*** 3481 - 3490 (/course/195611/spanish-nouns-2-2/349/)	
el cazo	"dipper, saucepan, ladle"
el alce	"elk, moose, cut"
la inconsistencia	inconsistency
la repisa	"ledge, shelf, bracket"
la lid	"matter, affair, battle"
el descargo	"release, discharge, deposition"
la crecida	"rise, swelling"
la irritabilidad	irritability
la perpetuación	perpetuation
el redescubrimiento	rediscovery
*** 3491 - 3500 (/course/195611/spanish-nouns-2-2/350/)	
el tambo	"milking yard, inn, barrel"
la alcoholemia	blood alcohol level
la almeja	"clam, mollusc, cunt"
la disección	"dissection, in-depth study"
la involución	"involution, backward movement, regression"
la mili	military service
la narrativa	"narrative, fiction, prose fiction"
la protuberancia	"protuberance, bulge, swelling"
la reprensión	"rebuke, reproof, reprimand"
el cascarón	"shell, eggshell, shallow vault"
*** 3501 - 3510 (/course/195611/spanish-nouns-2-2/351/)	
el torniquete	"tourniquet, turnstile, swivel"
el desertor	"defector, deserter, runaway"
el ganadero	"cattle rancher, rancher, breeder"
la sicología	psychology
el comporte	behaviour
el apolo	Apollo
el ornitólogo	ornithologist
la polifonía	polyphony
la transpiración	"sweating, perspiration"
la dramaturgia	dramaturgy
*** 3511 - 3520 (/course/195611/spanish-nouns-2-2/352/)	
el cabezal	"head, magnetic head, lorry"
el jazmín	"jasmin, jasmine, jessamine"
el arenal	"sandy area, quicksand"
la pavimentación	paving
el constitucionalismo	constitutionalism
el curry	"curry, curry powder"
el raid	"test, trial, rally"
la sofía	Sofia
(el)(la) negociante	"dealer, merchant, tradesman"
la abuelita	"grandma, granny, grannie"
*** 3521 - 3530 (/course/195611/spanish-nouns-2-2/353/)	
el relicario	"shrine, reliquary, locket"
el sudario	shroud
el señalamiento	signaling
el cepo	"stocks, clamp, block"
el trapecio	"trapezium, trapeze, trapezius"
el vaho	"vapor, mist, steam"
el antimonio	antimony
la desvinculación	decoupling
la masificación	"mass use, increase, extension"
la mendicidad	"begging, mendicancy, mendicity"
*** 3531 - 3540 (/course/195611/spanish-nouns-2-2/354/)	
la secuenciación	sequencing
la subcontratación	subcontracting
la chilena	"Chilean, scissor kick"
la confitería	"confectionery, sweet shop, candy shop"
el mariachi	Mariachi
el embate	"onslaught, sudden attack, pounding"
el ramón	ramon
la vesícula	"vesicle, gallbladder, bladder"
el animador	"animator, entertainer, cheerleader"
la anguila	"eel, European eel"
*** 3541 - 3550 (/course/195611/spanish-nouns-2-2/355/)	
la idealización	idealization
el lego	"layman, laity"
el cieno	"mud, silt, slime"
la camorra	"Neapolitan mafia, Camorra, fight"
el rectorado	"rector's office, vice-chancellor's office, rectorship"
el ardid	"scheme, trick, ruse"
la metralleta	"submachine gun, tommy gun"
el desvarío	"weird idea, mad idea, insane notion"
la edificabilidad	buildability
la incontinencia	incontinence
*** 3551 - 3560 (/course/195611/spanish-nouns-2-2/356/)	
el mugido	"bellow, moo, low"
la hojarasca	"fallen leaves, dead leaves"
el plegado	"folding, creasing"
la madeja	"hank, skein, head of hair"
(el)(la) humanista	humanist
la parentela	"kin, relations, relatives"
la milonga	"porkie, porky, pork pie"
el tabloide	tabloid
el vengador	"avenger, revenger"
la argamasa	mortar
*** 3561 - 3570 (/course/195611/spanish-nouns-2-2/357/)	
el dimorfismo	dimorphism
el abedul	"birch, birch tree, birch wood"
el halago	"flattery, pleasure, blandishment"
el oscurantismo	"obscurantism, opposition, deception"
el fenotipo	phenotype
el alfarero	potter
el solaz	"solace, relaxation, rest"
el arpón	"spear, harpoon, gaff"
el recargo	"surcharge, late fee"
el tríptico	"triptych, flyer, leaflet"
*** 3571 - 3580 (/course/195611/spanish-nouns-2-2/358/)	
el humedal	wetland
la agave	agave
la america	America
la magnanimidad	magnanimity
la predestinación	predestination
el apartamiento	"alienation, withdrawal"
la elipsis	ellipsis
el biombo	"folding screen, screen, room divider"
el jeep	jeep
el polvorín	"powder keg, munitions dump, gun powder"
*** 3581 - 3590 (/course/195611/spanish-nouns-2-2/359/)	
el violador	"violator, rapist"
el neurólogo	neurologist
el adoctrinamiento	indoctrination
la faringe	pharynx
la transportación	"transportation, transport"
el pelotazo	blow with a ball
el recuadro	"box, inset"
la catarsis	catharsis
la lasca	"chip, chipping, n   adj"
el comino	"cumin, caraway, jot"
*** 3591 - 3600 (/course/195611/spanish-nouns-2-2/360/)	
el paroxismo	"paroxysm, fever pitch, crisis"
el aparador	"sideboard, dresser, cupboard"
el desvelo	"sleeplessness, wakefulness, being awake"
la ardilla	squirrel
la pincelada	"touch, brushwork, brushstroke"
el jornal	"wage, pay, hire"
el acreedor	creditor
la eclíptica	ecliptic
la premeditación	"premeditation, deliberation, forethought"
el trio	trio
*** 3601 - 3610 (/course/195611/spanish-nouns-2-2/361/)	
(el)(la) solicitante	"applicant, petitioner"
la cervecería	"brewery, alehouse, bar"
la chanza	"jest, joke, badinage"
los olímpicos	Olympian
el paraguayo	"Paraguayan, saturn peach"
el quinquenio	"quinquennium, five years, five-year period"
la salazón	"salting, salt"
el cortocircuito	"short circuit, short-circuit"
el sinsentido	absurdity
el nativo	native
*** 3611 - 3620 (/course/195611/spanish-nouns-2-2/362/)	
la permisividad	permissiveness
la bienaventuranza	"beatitude, blessedness"
la caries	"caries, decay, cavity"
el reclame	"commercial, advertisement"
la drogadicción	drug addiction
el estercolero	"dung-heap, dunghill, manure heap"
el favoritismo	"favoritism, favouritism"
la merluza	"hake, drunk, skinful"
la izada	hoisted
el panal	"honeycomb, beehive stitch, shirring"
*** 3621 - 3630 (/course/195611/spanish-nouns-2-2/363/)	
la litografía	"lithography, lithograph"
el minero	miner
el carrete	"reel, spool, roll"
la sutura	"suture, seam, stitches"
el envés	"underside, back, wrong side"
la indefinición	"lack of definition, vagueness"
la pulcritud	"neatness, tidiness, smartness"
la transcendencia	transcendence
la afabilidad	"affability, amiability, geniality"
el break	break dancing
*** 3631 - 3640 (/course/195611/spanish-nouns-2-2/364/)	
el chicle	"chewing gum, gum, chicle"
el cinematógrafo	cinematograph
la desvergüenza	"effrontery, shamelessness, impudence"
el fascículo	"fascicle, fascicule, part"
el vallado	fence
la mies	"grain, corn, harvest"
el maleficio	"hex, witchcraft, curse"
la cabalgadura	mount
la mortaja	"shroud, mortise, grave clothes"
la hechicería	"sorcery, witchcraft, witch's tools"
*** 3641 - 3650 (/course/195611/spanish-nouns-2-2/365/)	
la substitución	substitution
(el)(la) vicealmirante	Vice Admiral
el abaratamiento	"decrease, reduction, lowereing"
el bilingüismo	bilingualism
la laboriosidad	industriousness
el principito	princeling
el loco	"madman, lunatic"
la bolsita	sachet
el bisonte	"bison, wisent, European bison"
la clavícula	"clavicle, collarbone, collar bone"
*** 3651 - 3660 (/course/195611/spanish-nouns-2-2/366/)	
la cloaca	"cloaca, sewer, manhole"
el desarrollador	developer
la desactivación	deactivation
la fonología	phonology
la interceptación	interception
la arrodillada	kneeling statue
el centauro	centaur
el convencionalismo	"conventionality, conventionalism"
el camarín	"dressing room, niche, alcove"
la ebriedad	"drunkenness, intoxication, inebriety"
*** 3661 - 3670 (/course/195611/spanish-nouns-2-2/367/)	
el desvanecimiento	"fading, fainting, vanishing"
el meñique	"little toe, little finger, pinky"
el ungüento	"ointment, unguent, salve"
la reincidencia	"recidivism, relapse, backsliding"
el frigorífico	"refrigerator, fridge, cryogenic"
la transformadora	transformative
la trucha	"trout, mouth, face"
el frasquito	vial
el amago	feint
la charca	"pond, pool"
*** 3671 - 3680 (/course/195611/spanish-nouns-2-2/368/)	
el microclima	microclimate
el ocultamiento	concealment
el androide	android
el atavío	"apparel, dress, attire"
la mordedura	"bite, bite-mark"
el catastro	"cadastre, cadaster, land registry"
los echados	cast
la corea	chorea
el condensador	"condenser, capacitor"
el condón	"condom, rubber, French letter"
*** 3681 - 3690 (/course/195611/spanish-nouns-2-2/369/)	
el donativo	donation
el dragado	dredging
la usina	"industry, large factory, power station"
el caminito	narrow lane
el noviciado	novitiate
el oscilador	oscillator
la prospección	"prospecting, prospection, research"
el escáner	scanner
el ayer	"yesterday, the past, the old days"
la pintora	painter
*** 3691 - 3700 (/course/195611/spanish-nouns-2-2/370/)	
el introductor	introducer
el mantra	mantra
el neoclasicismo	neoclassicism
la ralentización	"slowdown, deceleration"
el sobreseimiento	stay
la abominación	abomination
el ánodo	anode
la aorta	aorta
la exégesis	exegesis
el mayoral	"foreman, manager, overseer"
*** 3701 - 3710 (/course/195611/spanish-nouns-2-2/371/)	
el cabelludo	haired
el tarro	"jar, tin, pot"
la mezquindad	"pettiness, meanness, paltriness"
el rumano	"Romanian, Roumanian, Rumanian"
la terracota	"terracotta, terracotta figurine"
la rectora	school or university pressdent
la magdalena	"cupcake, madeleine"
la mugre	"dirt, grime, grease"
el convidado	guest
el achaque	"infirmity, ailment, weakness"
*** 3711 - 3720 (/course/195611/spanish-nouns-2-2/372/)	
el parqué	"park, fleet"
(el)(la) pobre	"poor, indigent"
la abrigada	"shelter, windbreak"
(el)(la) lateral	"wing, winger, side"
la ancianidad	old age
la anormalidad	"abnormality, anomaly"
el brocado	brocade
la cohorte	"cohort, group, company"
el distribuidor	"distributor, hall, landing"
la cuadrícula	"grid, graticule, graph paper"
*** 3721 - 3730 (/course/195611/spanish-nouns-2-2/373/)	
la picazón	"itch, prickle, prickling"
la liviandad	"lightness, triviality, trivial nature"
la óptica	"optics, Optics, viewpoint"
el espolón	"ram, spur, fetlock"
la repesca	repechage
la treta	"ruse, contrivance, feint"
el esperma	"sperm, semen"
el quebrantamiento	"violation, deterioration, worsening"
el estoicismo	"stoicism, fortitude"
la exteriorización	externalization
*** 3731 - 3740 (/course/195611/spanish-nouns-2-2/374/)	
la homogeneización	homogenization
la impopularidad	unpopularity
el recaudo	"collection, marinade, sauce"
la beneficiada	benefit
(el)(la) poli	"cop, Poly, Tech"
el destrozo	"damage, heavy damage"
el excomulgado	excommunicate
el francés	"French, Frenchman"
la languidez	"languor, languishment, listlessness"
la necrosis	necrosis
*** 3741 - 3750 (/course/195611/spanish-nouns-2-2/375/)	
el reguero	"trail, trickle, track"
la carretilla	"wheelbarrow, barrow, pizza cutter"
la pandereta	tambourine
la testa	head
el húngaro	Hungarian
la cestería	"basketwork, wickerwork, basketry"
la tilde	"accent, written accent, acute accent"
el adelantamiento	"advancement, overtaking, improvement"
el artilugio	"contraption, gadget, gimmick"
el jornalero	"day laborer, laborer"
*** 3751 - 3760 (/course/195611/spanish-nouns-2-2/376/)	
el digestivo	digestive medicine
el humanoide	humanoid
el amaneramiento	"mannerism, affectation, preciosity"
(el)(la) patriota	patriot
el criba	"riddle, screen, sieve"
el corrimiento	slipping
el chirrido	"squeak, chirp, creak"
(el)(la) caminante	"walker, hiker, wayfarer"
el comodín	"wildcard, joker, chart"
la reubicación	"relocation, resettlement"
*** 3761 - 3770 (/course/195611/spanish-nouns-2-2/377/)	
la dispensación	dispensation
la atrofia	atrophy
la contracorriente	"counter-current, cross-current"
el orfebre	"goldsmith, silversmith, metalsmith"
(el)(la) humorista	"humorist, humourist"
el mesías	Messiah
el rombo	"rhombus, diamond, rhomb"
el bastidor	"stretcher, stretcher frame, wings"
el superhombre	superman
el estafador	"swindler, racketeer, shark"
*** 3771 - 3780 (/course/195611/spanish-nouns-2-2/378/)	
la videoconsola	"video game console, video game platform, video game machine"
el drive	drive
el ántrax	anthrax
la apófisis	apophysis
la arcada	"arcade, span, series of arches"
la guinda	"cherry, final touch, cherry on top"
el dipolo	dipole
el palomar	"dovecote, pigeon house, dovecot"
el excremento	"dung, excrement, excreta"
la ionización	ionization
*** 3781 - 3790 (/course/195611/spanish-nouns-2-2/379/)	
la linealidad	linearity
la pastelería	"pastry shop, bakery, pastries"
el piquete	"picket, picket line, bite"
el surtidor	"pump, gasoline pump US, petrol  pump UK"
(el)(la) saxofonista	saxophonist
la costurera	"seamstress, dressmaker, needlewoman"
el patrocinador	"sponsor, patron"
el sucedáneo	"substitute, surrogate, ersatz"
la arruga	"wrinkle, line, furrow"
el quejido	"groan, moan, whimper"
*** 3791 - 3800 (/course/195611/spanish-nouns-2-2/380/)	
la mandolina	"mandolin, mandoline"
la admisibilidad	admissibility
la gendarmería	gendarmerie
el sadismo	sadism
la cítara	zither
la baza	"asset, trick, chance"
la ladrona	"burglar, thief, robber"
el claroscuro	chiaroscuro
la lencería	"lingerie, underwear, lingerie shop"
el matutino	morning paper
*** 3801 - 3810 (/course/195611/spanish-nouns-2-2/381/)	
(el)(la) pediatra	"pediatrician, pediatrist"
el álamo	poplar
el pretor	"praetor, pretor, magistrate"
la estantería	"shelving, rack, shelves"
el servilismo	"subservience, servility, sycophancy"
la sinapsis	synapses
(el)(la) textil	textile
el bajel	"vessel, ship"
el hormigón	"concrete, cement"
el cincel	chisel
*** 3811 - 3820 (/course/195611/spanish-nouns-2-2/382/)	
el devoto	"devotee, votary"
la igualación	equalization
el linfoma	lymphoma
la nanotecnología	nanotechnology
la readmisión	readmission
el bienio	"biennium, two-year period, two-year raise"
el bizcocho	"biscuit, cake, sponge"
el parpadeo	"blink, blinking, flickering"
la contusión	"bruise, contusion"
la trocha	"gauge, gage, path"
*** 3821 - 3830 (/course/195611/spanish-nouns-2-2/383/)	
la gradación	"gradation, grading series, grading"
el pistolero	"gunman, gangster"
la armónica	"harmonica, mouth organ, harp"
la ensenada	"inlet, cove, bight"
la pestilencia	"pestilence, stench, stink"
la proveedora	"provider, supplier"
la corpulencia	"bulk, corpulence, portliness"
la grandiosidad	"grandiosity, magnificence, grandeur"
el ascetismo	asceticism
el conato	attempt
*** 3831 - 3840 (/course/195611/spanish-nouns-2-2/384/)	
el apoderado	"agent, attorney, proxy"
el remanso	"backwater, haven"
el sepelio	"burial, funeral"
la catequesis	"catechism, religious teaching, religious instruction"
la circunnavegación	circumnavigation
(el)(la) contratista	contractor
el alargamiento	"elongation, lengthening, extension"
el radiador	radiator
el gajo	"segment, branch, section"
el espadachín	swordsman
*** 3841 - 3850 (/course/195611/spanish-nouns-2-2/385/)	
la hibernación	hibernation
la musicalidad	musicality
el orégano	"oregano, marjoram"
el sultanato	sultanate
la digresión	"digression, excursus, aside"
la discípula	disciple
la suspicacia	"distrust, suspicion, mistrust"
la desunión	"disunion, disunity"
el basurero	"dump, garbage collector, garbage man"
el hércules	Hercules
*** 3851 - 3860 (/course/195611/spanish-nouns-2-2/386/)	
el hato	"herd, gang, small herd"
el interdicto	"injunction, ban"
el monocultivo	monoculture
(el)(la) chotacabras	"nighthawk, goatsucker"
(los)(las) madridistas	Whites
el afianzamiento	"reinforcement, consolidation, strengthening"
el melocotón	peach
la avanzadilla	patrol
el canapé	"couch, settee, daybed"
la desinfección	disinfection
*** 3861 - 3870 (/course/195611/spanish-nouns-2-2/387/)	
la iguana	iguana
el encendedor	"lighter, igniter, cigarette lighter"
el síndico	"receiver, syndic, liquidator"
el corzo	"roe deer, roe, roebuck"
la esterlina	Sterling
la tundra	tundra
el decodificador	decoder
el gángster	"gangster, mobster"
la emotividad	emotionality
el pastiche	"pastiche, pasticcio"
*** 3871 - 3880 (/course/195611/spanish-nouns-2-2/388/)	
el cañonazo	"(cannon) shot, (shell) shot, (sound of) cannon fire"
la abducción	abduction
el despertador	alarm clock
el bordo	"board, side"
el chasquido	"click, snap, flick"
el conformismo	"conformity, conformism"
la disyuntiva	"dilemma, quandary"
el casquete	"helmet, cure, hood"
el hobby	hobby
la idiotez	"idiocy, foolishness, stupidity"
*** 3881 - 3890 (/course/195611/spanish-nouns-2-2/389/)	
el desajuste	imbalance
el maxilar	"jaw, jawbone, mandible"
(el)(la) lingüista	linguist
la raja	"raja, split, gash"
el trienio	triennium
el angelito	angel
el internacionalismo	internationalism
la cobranza	collection
la roseta	"blotch, showerhead, rose"
la cirrosis	cirrhosis
*** 3891 - 3900 (/course/195611/spanish-nouns-2-2/390/)	
la hulla	coal
la cópula	"copula, copulation, sexual intercourse"
el barquero	"ferryman, boatman, bargeman"
el preso	"inmate, prisoner"
el mamífero	"mammalian, mammal"
la pedrería	"precious stones, jewels, gemstones"
el rosetón	"rosette, rose window"
la gaseosa	"soda, soda pop, pop"
las subunidades	subunits
el recaudador	tax collector
*** 3901 - 3910 (/course/195611/spanish-nouns-2-2/391/)	
el quórum	quorum
la reordenación	realignment
el waterpolo	water polo
el independentismo	pro-independence movement
el acetato	acetate
el agobio	"burden, oppression, cause of anxiety"
el adalid	"champion, warlord, leader"
la distribuidora	distributor
el párpado	"eyelid, lid"
el nomo	gnome
*** 3911 - 3920 (/course/195611/spanish-nouns-2-2/392/)	
el pasador	"hairclip, hairslide, barette"
el golpeo	"hitting, punching"
la hidrólisis	hydrolysis
(el)(la) terapeuta	therapist
el portento	"wonder, portent, prodigy"
el mercantilismo	"mercantilism, commercialism, profiteering"
el alunizaje	moon landing
el engrandecimiento	"aggrandizement, enlargement, exaltation"
el habitáculo	cabin
el cotejo	"comparison, collation"
*** 3921 - 3930 (/course/195611/spanish-nouns-2-2/393/)	
la delación	delation
el graffiti	graffiti
el bisnieto	great-grandson
el parador	"hostel, tourist hotel"
el engendro	"monstrosity, eyesore, monster"
el empaquetado	"packing, packaging"
la reanimación	"resuscitation, recovery"
el diminutivo	"short, diminutive"
el subalterno	"subaltern, subordinate"
la conmiseración	"commiseration, sympathy"
*** 3931 - 3940 (/course/195611/spanish-nouns-2-2/394/)	
la desintoxicación	"detox, sobering up, detoxification"
el esoterismo	esotericism
el despiste	"absent-mindedness, lapse of concentration"
el bajorrelieve	bas-relief
el bateador	"batter, batsman"
la conservadora	"conservative, conservator, curator"
el derrotero	"direction, path, course"
la polvareda	"dust cloud, cloud of dust"
el colmillo	"fang, tusk, canine"
la mordaza	"gag, clamp, jaw"
*** 3941 - 3950 (/course/195611/spanish-nouns-2-2/395/)	
la altanería	"haughtiness, pride, falconry"
el calzón	"pants, breeches, underpants"
la pragmática	pragmatics
la puna	"puna, mountain sickness, altitude sickness"
el satén	"satin, sateen"
el combo	"sledge hammer, combo"
la sinonimia	synonymy
la tríada	triad
la luchadora	"wrestler, fighter"
el hospedador	host
*** 3951 - 3960 (/course/195611/spanish-nouns-2-2/396/)	
la posadera	innkeeper
el cerebelo	cerebellum
la depredación	predation
la mariana	Marian
la avispa	wasp
la acacia	"acacia, acacia wood"
el pasmo	"astonishment, shock, chill"
la cofia	"cap, bonnet, hairnet"
la chinchilla	"chinchilla, chinchilla fur"
la exhalación	exhalation
*** 3961 - 3970 (/course/195611/spanish-nouns-2-2/397/)	
los ojillos	eyelets
el aplastamiento	"flattening, squashing, crushing"
el jengibre	ginger
la hernia	"hernia, rupture"
la ballesta	"leaf spring, crossbow, ballista"
el valija	"pouch, suitcase, valise"
el silo	silo
el tubérculo	"tubercle, tuber"
la retama	broom
el absentismo	"absenteeism, truancy, carelessness"
*** 3971 - 3980 (/course/195611/spanish-nouns-2-2/398/)	
la expiración	"expiration, expiry, death"
la transliteración	transliteration
la acrópolis	acropolis
la beatitud	"beatitude, bliss"
la bordura	bordure
el aderezo	"dressing, seasoning, garnish"
la hechicera	"enchantress, sorceress"
la enormidad	"enormity, enormousness"
el malecón	"jetty, pier, breakwater"
la mascarilla	"mask, face pack, death mask"
*** 3981 - 3990 (/course/195611/spanish-nouns-2-2/399/)	
el juglar	"minstrel, jongleur, troubadour"
la alteridad	otherness
la cremallera	"zipper, rack, zip"
el enebro	juniper
el añil	"anil, indigo, blue"
la refundición	revision
la serotonina	serotonin
el atlante	Atlas
el basilisco	basilisk
la concavidad	"concave, concavity, hollow"
*** 3991 - 4000 (/course/195611/spanish-nouns-2-2/400/)	
el cangrejo	"crab, crayfish, marble crab"
la glorificación	glorification
la minusvalía	"handicap, capital loss, drop in value"
el tábano	"horsefly, gadfly, pain in the arse"
el plancton	plankton
la correría	"raid, incursion, invasion"
el hablador	"talker, chatterbox, gossip"
el neumático	"tire, tyre"
la brasileña	Brazilian
el agrónomo	"agronomist, agriculturalist, agriculturist"
*** 4001 - 4010 (/course/195611/spanish-nouns-2-2/401/)	
la cesación	cessation
la dejadez	"neglect, laziness, negligence"
el standing	standing
la cerviz	"cervix, nape"
el arcabuz	"harquebus, arquebus"
el picaporte	"latch, knocker, handle"
el terruño	"plot, piece of land, homeland"
el reagrupamiento	regrouping
el samurai	samurai
el bisturí	"scalpel, bistoury, surgical knife"
*** 4011 - 4020 (/course/195611/spanish-nouns-2-2/402/)	
el estanco	"standing water, pond, bodega"
la lengüeta	"tab, tongue, barb"
el enrejado	"trellis, lattice, grille"
la superpoblación	"overcrowding, overpopulation"
la bajura	inshore
el constructivismo	constructionism
la cosmética	cosmetics
la mirra	myrrh
el sucre	"penny, cent"
la auditora	audit
*** 4021 - 4030 (/course/195611/spanish-nouns-2-2/403/)	
la cartelera	"billboard, listings, bulletin board"
la faculta	empowers
el identificador	identifier
el brebaje	"potion, concoction, mixture"
la gamba	prawn
el estertor	"rattle, death rattle, rale"
el caballete	"ridge, easel, trestle"
el andamio	"scaffolding, scaffold, platform"
el trasunto	"transcript, carbon copy, image"
la permuta	"transfer, exchange"
*** 4031 - 4040 (/course/195611/spanish-nouns-2-2/404/)	
la tribulación	tribulation
la excedencia	"unpaid leave, leave of absence"
el gradual	gradual
la historicidad	historicity
el ínterin	interim
la lactosa	lactose
el opúsculo	"tract, brief treatise"
la ambivalencia	"ambivalence, ambiguity"
el diodo	diode
el eclesiástico	"ecclesiastic, churchman, cleric"
*** 4041 - 4050 (/course/195611/spanish-nouns-2-2/405/)	
el injerto	"graft, scion, cutting"
el estrechamiento	"narrowing, handshake, strengthening"
el tablado	"platform, floorboards, boards"
el lleno	"sell out, full house"
la semblanza	"semblance, biographical sketch, biographical note"
la sodomía	"sodomy, buggery"
la estampida	stampede
el cantero	"stonecutter, mason, quarryman"
la reentrada	re-entry
la feminidad	femininity
*** 4051 - 4060 (/course/195611/spanish-nouns-2-2/406/)	
el soñador	"dreamer, daydreamer"
el bipartidismo	bipartisanship
la megafonía	"acoustics, sound systems, loudspeakers"
la azada	hoe
el despropósito	"absurdity, inappropriate remark, piece of nonesense"
la frecuentación	attendance
(los)(las) barcelonistas	Barca
el prostíbulo	"brothel, house of prostitution, whorehouse"
la consonante	consonant
el empacho	"embarrassment, indigestion, hindrance"
*** 4061 - 4070 (/course/195611/spanish-nouns-2-2/407/)	
la braza	"fathom, brace, breast-stroke"
la homología	homology
la pesquisa	"investigation, inquiry, secret police"
el jockey	jockey
la ponzoña	poison
el puzzle	puzzle
el licuado	"shake, milk shake"
el subordinado	"subordinate, ancillary, underling"
el patronazgo	patronage
el democristiano	Democrat
*** 4071 - 4080 (/course/195611/spanish-nouns-2-2/408/)	
el flúor	"fluor, fluoride, fluorine"
la hiperinflación	hyperinflation
el revulsivo	"revulsive, catalyst, salutary lesson"
el elixir	elixir
el tamiz	sieve
la saeta	"arrow, dart, saeta"
el atraque	"berth, mooring"
el flete	"charter, freight, cargo"
(el)(la) comensal	"commensal, diner"
la calada	"drag, puff, soak"
*** 4081 - 4090 (/course/195611/spanish-nouns-2-2/409/)	
la franela	flannel
el ventarrón	"gale, strong wind, stiff wind"
la manguera	hose
el amarre	"mooring, berth, slip"
el reductor	reducing
el rabillo	"stalk, strap"
la superficialidad	"superficiality, shallowness"
el coque	coke
el corderito	"lamb, lambskin"
el aserradero	sawmill
*** 4091 - 4100 (/course/195611/spanish-nouns-2-2/410/)	
la afectividad	affectivity
el discipulado	discipleship
la escenificación	staging
el paralelo	"parallel, line of latitude"
el fiordo	"fjord, fiord"
el fotograma	frame
la pinacoteca	"gallery, art gallery"
el brezo	"heath, heather, briar"
el desarraigo	"losing touch, uprooting"
el motel	motel
*** 4101 - 4110 (/course/195611/spanish-nouns-2-2/411/)	
el durazno	"peach, peach tree"
la perfumería	"perfumery, perfume industry, perfumer"
el membrillo	"quince, quince jelly, quince preserve"
el redoble	"roll, rumble, beat"
el espasmo	spasm
el subjetivismo	subjectivism
el trailer	trailer
el turbocompresor	turbocharger
el ventrículo	ventricle
el velorio	"wake, vigil, profession ceremony"
*** 4111 - 4120 (/course/195611/spanish-nouns-2-2/412/)	
el resuello	"wheeze, breathing, gasping"
la tromba	"whirlwind, deluge, cyclone"
el panadero	baker
el croquis	sketch
la candela	candle
la delgadez	"thinness, slimness, slenderness"
la epidemiología	epidemiology
el mosén	Mosen
los haberes	assets
el cronómetro	"chronometer, stop watch"
*** 4121 - 4130 (/course/195611/spanish-nouns-2-2/413/)	
la dioxina	dioxin
(los)(las) hipócritas	hypocrite
(el)(la) transeúnte	"passerby, transient"
la pátina	patina
la flema	"phlegm, sputum, composure"
(el)(la) estadista	"statesman, statistician"
la marejada	"surge, groundswell, tidal wave"
(el)(la) traficante	"trafficker, trader"
la mocedad	"youth, boyhood, girlhood"
el sésamo	"sesame, sesame seeds"
*** 4131 - 4140 (/course/195611/spanish-nouns-2-2/414/)	
el ginecólogo	gynecologist
el pilotaje	"piloting, flying, driving"
el psiquismo	psychism
el pescante	"davit, box, driver's seat"
la exasperación	exasperation
el reborde	"flange, ledge"
la zorra	"fox, bitch, vixen"
el rastrillo	"rake, portcullis, rummage sale"
la biomedicina	biomedicine
la contrición	contrition
*** 4141 - 4150 (/course/195611/spanish-nouns-2-2/415/)	
el nepotismo	nepotism
la portabilidad	portability
el soluto	solute
el magnicidio	assassination
la bronquitis	bronchitis
el cacho	"chub, piece, bit"
(el)(la) combatiente	"combatant, fighter, ruff"
la cantaora	folksinger
la perilla	"knob, door knob, handle"
la malva	mallow
*** 4151 - 4160 (/course/195611/spanish-nouns-2-2/416/)	
el estanciero	rancher
el estoque	"rapier, sword, tuck"
la espuela	spur
el ensanchamiento	widening
el bridge	bridge
el delator	"informer, delator"
la berta	Bertha
la concisión	"conciseness, succinctness, pithiness"
el peyote	peyote
la carroña	"carrion, riffraff"
*** 4161 - 4170 (/course/195611/spanish-nouns-2-2/417/)	
el pasodoble	"double march, on the double, paso doble"
la emulsión	emulsion
el ahijado	"godchild, godson, mentee"
los heredados	legacy
la mortificación	"mortification, chagrin"
el solfeo	"musical theory, drubbing, beating"
el infractor	"offender, infractor"
(el)(la) baranda	"rail (f), railing (f), handrail (f)"
la radiofrecuencia	RF
el rizoma	"rootstock, rhizome"
*** 4171 - 4180 (/course/195611/spanish-nouns-2-2/418/)	
la verónica	"veronica, speedwell"
el esternón	"breastbone, sternum"
la reeducación	re-education
el varapalo	"long pole, blow with a stick, beating"
la ganga	"bargain, giveaway, snip"
el boj	"box, boxwood"
la alcantarilla	"culvert, sewer, drain"
el decálogo	"decalogue, commandments, do's and dont's"
la depravación	"depravation, depravity, turpitude"
el taladro	"drill, auger, gimlet"
*** 4181 - 4190 (/course/195611/spanish-nouns-2-2/419/)	
el armiño	"ermine, stoat"
el allanamiento	"forceful entry, forced entry, raid"
el obús	"howitzer, bombshell, shell"
el revoque	"plaster, plastering, whitewash"
la escultora	sculptress
el patín	"shoe, skid, skate"
la mesilla	"side table, small table"
la variable	variable
la viñeta	"vignette, cartoon"
la pepa	seed
*** 4191 - 4200 (/course/195611/spanish-nouns-2-2/420/)	
el espectrómetro	spectrometer
el catalanismo	Catalanism word or phrase
el tejón	badger
el cruzado	"cross figure, crusader"
la golosina	"dainty, candy, tidbit"
el trasiego	"decanting, transfer, bustle"
la disonancia	"dissonance, disharmony, discord"
el amasijo	"dough, kneading"
la averiguación	"inquiry, enquiry"
el descampado	"open space, waste ground, piece of waste ground"
*** 4201 - 4210 (/course/195611/spanish-nouns-2-2/421/)	
el participio	participle
la socia	"partner, member, associate"
(el)(la) granuja	"rogue (m), crook (m), ragamuffin (m)"
el folletín	"romance novel, Mills and Boon, feuilleton"
el sayo	"smock, tunic"
(el)(la) apelante	appellant
la barcaza	"barge, lighter"
el mazazo	"blow with a mallet, hammerblow"
el caviar	"caviar, caviare"
los matriculados	enrolled
*** 4211 - 4220 (/course/195611/spanish-nouns-2-2/422/)	
el bemol	"flat, flat sign"
el ajetreo	"hustle, bustle"
el informador	"informer, informant"
el latigazo	"lash, whiplash, swig"
el nopal	"nopal, prickly pear"
la papaya	"papaya, pawpaw, pussy"
el repique	"peal, ringing, pealing"
el perihelio	perihelion
el beneficiario	"recipient, beneficiary, payee"
el sombreado	"shading, shadow"
*** 4221 - 4230 (/course/195611/spanish-nouns-2-2/423/)	
el platero	silversmith
la duela	"stave, hogshead stave, board"
el vórtice	"vortex, eye, centre"
la decodificación	decoding
la autogestión	self-management
la reintroducción	reintroduction
el albatros	albatross
la andanada	"broadside, covered bullring seats, reprimand"
el crío	child
el desenfado	ease
*** 4231 - 4240 (/course/195611/spanish-nouns-2-2/424/)	
el malhechor	"evildoer, malefactor, wrongdoer"
el exotismo	exoticism
el fermento	ferment
la tuba	"tuba, palm wine, kallu"
la vorágine	"whirlpool, vortex, whirlwind"
la colita	willy
la derivada	derivative
el bazo	spleen
el bicentenario	"bicentennial, bicentenary"
el costumbrismo	"customs, mores"
*** 4241 - 4250 (/course/195611/spanish-nouns-2-2/425/)	
el solapamiento	overlap
la asonada	"mob, rabble, riot"
el serbio	Serbian
el anticuerpo	antibody
el bollo	"bun, scone, biscuit"
el cortesano	"courtier, courtesan, prostitute"
la dina	dyne
el artillero	"gunner, artilleryman"
el atril	"music stand, lectern, bookrest"
la precedencia	"precedence, priority, preeminence"
*** 4251 - 4260 (/course/195611/spanish-nouns-2-2/426/)	
el refrigerador	refrigerator
la ecografía	"sonography, diagnostic sonography, ultrasonography"
la tomografía	"tomography, scan"
el trópico	"tropic, tropics"
el suministrador	supplier
la intrepidez	"intrepidity, fearlessness, audacity"
el polietileno	"polyethylene, polythene"
la polimerasa	polymerase
la regenta	runs
el adaptador	"adapter, adaptor"
*** 4261 - 4270 (/course/195611/spanish-nouns-2-2/427/)	
el estampido	"bang, boom, crash"
el crono	chrono
la vanagloria	conceit
la inmundicia	"filth, dirt, uncleanliness"
la gangrena	"gangrene, mortification, sickness"
las albricias	"good news, gift"
la puntilla	"lace, purl, brad"
el locutorio	"parlor, cybercafe, cybercafé"
(el)(la) píxel	pixel
el rábano	"radish, poof, poofter"
*** 4271 - 4280 (/course/195611/spanish-nouns-2-2/428/)	
el ripio	"rubble, garbage, refuse"
el cervatillo	"small deer, fawn"
las sociedades	"society, partnership, corporation"
la tara	"tare, defect, blemish"
la guiñada	"yaw, wink"
la curandera	"quack, quack doctor"
el gringo	"gringo, Yankee"
(el)(la) centroizquierda	center-left
la circunspección	"circumspection, discretion"
el hipotálamo	hypothalamus
*** 4281 - 4290 (/course/195611/spanish-nouns-2-2/429/)	
la jovialidad	"joviality, cheerfulness"
la mamita	mammy
la mitigación	"mitigation, relief"
el monoteísmo	monotheism
la palangana	"basin, bowl, washbasin"
el candelero	"candlestick, candle-holder, candle holder"
la catapulta	catapult
la quina	"cinchona bark, Peruvian bark, quinine"
el cursor	cursor
el saltamontes	"grasshopper, hopper"
*** 4291 - 4300 (/course/195611/spanish-nouns-2-2/430/)	
la hiena	"hyena, hyaena"
el noticiario	"news, news bulletin, newsreel"
(el)(la) organista	"organist, organ player"
la viruta	"shaving, shavings"
la cortedad	shortness
el columpio	swing
la urea	urea
el coleccionismo	collecting
el glutamato	glutamate
el golazo	goal
*** 4301 - 4310 (/course/195611/spanish-nouns-2-2/431/)	
el rengo	lame
el utilitarismo	utilitarianism
el armadillo	armadillo
el lúpulo	hop (plant)
el sofisma	sophism
la banana	"banana, banana tree, banana plant"
la bitácora	binnacle
el desglose	"breakdown, itemization"
el dígito	digit
el fauno	"faun, Faunus"
*** 4311 - 4320 (/course/195611/spanish-nouns-2-2/432/)	
la cornada	goring
los herpes	"herpes, shingles, cold-sore"
el linchamiento	lynching
la reimpresión	"reprint, reissue"
el mercadillo	"rummage sale, street market, market"
la brea	"tar, pitch"
la renuencia	"unwillingness, reluctance"
la bienhechora	do-gooder
el sketch	sketch
la educadora	educator
*** 4321 - 4330 (/course/195611/spanish-nouns-2-2/433/)	
la huérfana	orphan
la pantorrilla	calf
el becario	"scholarship holder, scholar"
la descoordinación	incoordination
el encaminamiento	routing
el espiritismo	"spiritism, spiritualism"
la globalidad	globality
la predominancia	predominance
la tipificación	"classification, categorization"
la trova	"ballad, song, verse"
*** 4331 - 4340 (/course/195611/spanish-nouns-2-2/434/)	
el checo	"Czech, Afro-Peruvian percussion instrument, Peruvian pot"
el vendaje	"dressing, bandage, bandaging"
el agasajo	"entertainment, pleasure, delight"
la excreción	excretion
el bufón	"fool, buffoon, jester"
los gases	"gas, gases"
la bisagra	"hinge, hinge party"
la idealidad	ideality
el medidor	"meter, measurer, gauge"
el musgo	moss
*** 4341 - 4350 (/course/195611/spanish-nouns-2-2/435/)	
el telediario	"newscast, news bulletin, news program"
la codorniz	quail
el cuadrilátero	"ring, quadrilateral, quadrangle"
el tul	"tulle, net"
la tráquea	"windpipe, trachea"
el africano	African
el funcionalismo	functionalism
la homeopatía	homeopathy
la infertilidad	infertility
la inocuidad	safety
*** 4351 - 4360 (/course/195611/spanish-nouns-2-2/436/)	
el trust	trust
el carrusel	"carrousel, carousel, merry-go-round"
la recusación	challenge
la consignación	"consignment, allocation, record"
la circunvalación	encirclement
el bobo	"fool, boob, ninny"
la cuita	"grief, anxiety, worry"
el lunar	"mole, spot, beauty mark"
el buche	"mouthful, shot, slug"
la parafernalia	paraphernalia
*** 4361 - 4370 (/course/195611/spanish-nouns-2-2/437/)	
el ronquido	"snore, snoring, rough sound"
la tetera	"teapot, kettle"
el transplante	"transplant, transplantation"
el escurrimiento	wring
la pelusa	"fuzz, fluff, down"
el asociacionismo	associations
la beligerancia	"belligerency, belligerence, hostility"
la negatividad	negativity
la discordancia	"discordance, disagreement, conflict"
el primero	first
*** 4371 - 4380 (/course/195611/spanish-nouns-2-2/438/)	
la ferretería	"hardware, ironmongery, hardware store"
la descortesía	"impoliteness, discourtesy, incivility"
las trias	industries
(los)(las) normales	normal
la obscenidad	"obscenity, bawdiness, lewdness"
el apasionamiento	"passion, enthusiasm"
la pirotecnia	"pyrotechnics, explosives factory"
el relax	relaxation
la solubilidad	solubility
el guisado	"stew, casserole, ragout"
*** 4381 - 4390 (/course/195611/spanish-nouns-2-2/439/)	
la estopa	"tow, oakum, burlap"
el calco	"tracing, rubbing, carbon copy"
el chato	tumbler
el básquet	basketball
el recalentamiento	overheating
el púgil	"boxer, pugilist, prize fighter"
la desgana	"reluctance, apathy, indifference"
el ecologismo	Ecology
la etnología	ethnology
el rebrote	"new outbreak, reappearance"
*** 4391 - 4400 (/course/195611/spanish-nouns-2-2/440/)	
el cenicero	"ashtray, hearth"
los abocados	doomed
(el)(la) hereje	heretic
el aborrecimiento	"loathing, abhorrence, abomination"
la proscripción	"proscription, banishment"
el distingo	reservation
el papelito	slip
la verticalidad	verticality
el bostezo	yawn
la concejala	Councillor
*** 4401 - 4410 (/course/195611/spanish-nouns-2-2/441/)	
la realimentación	feedback
el visionario	visionary
el apaciguamiento	"appeasement, subsidence, pacification"
la humanización	humanization
el reformismo	reformism
la subsidiaridad	subsidiarity
el trial	trials
el chulo	pimp
la acomodación	accommodation
el desagravio	amends
*** 4411 - 4420 (/course/195611/spanish-nouns-2-2/442/)	
el anhídrido	anhydride
la autocracia	autocracy
la morena	"brunette, moraine, moray"
el divertimento	divertimento
el regate	"dodge, dribbling, feint"
la bizarría	gallantry
la vislumbre	"glimpse, gleam"
la alojada	housed
el óbice	"obstacle, impediment, hindrance"
el organizador	organizer
*** 4421 - 4430 (/course/195611/spanish-nouns-2-2/443/)	
el percal	percale
el sexteto	"sextet, sestet, sextette"
las tratas	traffic
el vegetal	"vegetable, vegetal"
la lavandera	"washerwoman, sandpiper, laundry woman"
el riel	rail
el sevillano	Seville person
(el)(la) compa	"pal, mate, buddy"
la hiperactividad	hyperactivity
la hipertrofia	"hypertrophy, overgrowth, excess"
*** 4431 - 4440 (/course/195611/spanish-nouns-2-2/444/)	
la inflexibilidad	"inflexibility, rigidity, obduracy"
la jerarquización	"job allocation, job classification, organization into a hierarchy"
la neurología	neurology
la sacarosa	saccharose
el tridente	trident
el primate	primate
la patrullera	patrol boat
el bulo	canard
el repartimiento	"distribution, division, share"
el percutor	firing pin
*** 4441 - 4450 (/course/195611/spanish-nouns-2-2/445/)	
el glosario	glossary
el enamorado	lover
la hermanastra	stepsister
la trasmisión	transmission
la urdimbre	"warp, scheme, plot"
el gluten	"gluten, flour and water paste"
la monogamia	monogamy
el prensado	pressing
el cupón	"coupon, voucher, ticket"
los endemismos	endemism
*** 4451 - 4460 (/course/195611/spanish-nouns-2-2/446/)	
el maño	hand
el auricular	"headphone, earphone, earpiece"
los enteros	integer
la crin	"mane, horsehair"
(el)(la) ocupante	occupant
el charol	"patent leather, lacquer"
la filantropía	philanthropy
la plástica	plastic
la benignidad	benignity
el enmalle	gill
*** 4461 - 4470 (/course/195611/spanish-nouns-2-2/447/)	
la hidrología	hydrology
la reabsorción	reabsorption
la basada	bed
el chance	"chance, opportunity"
el correlato	correlate
la madreselva	"honeysuckle, woodbine"
el piojo	"louse, burr, ugly person"
la medusa	"medusa, jellyfish"
el mandadero	"messenger, office boy"
el quijote	"Quixote, idealist, saviour"
*** 4471 - 4480 (/course/195611/spanish-nouns-2-2/448/)	
el replanteamiento	rethinking
el sagrario	"sanctuary, tabernacle, shrine"
la subcomisión	"subcommission, subcommittee"
el obrero	"worker, workman, laborer"
la masía	country house
la veterana	veteran
el mercenario	"mercenary, hireling"
la sobreproducción	overproduction
la carlota	charlotte
la cristianización	Christianization
*** 4481 - 4490 (/course/195611/spanish-nouns-2-2/449/)	
la limpidez	clarity
el masoquismo	masochism
el medievo	Ages
el demérito	demerit
la perturbadora	"jammer, disturbing images"
la haba	"bean, tumour UK, tumor US"
el borrón	"blot, stain, splodge"
la carabela	"caravel, carvel"
el cruzamiento	crossing
el gladiador	gladiator
*** 4491 - 4500 (/course/195611/spanish-nouns-2-2/450/)	
la grama	"grama, lawn, couch-grass"
el abuelito	"grandfather, grandpa, grandpapa"
la imbecilidad	"idiocy, imbecility"
(el)(la) infiel	"infidel, unbeliever"
la suplencia	"substitution, supply"
la trilla	"threshing, thresh, threshing season"
la tienta	"trial, test"
el antílope	antelope
el aragonés	Aragonese
el rebuzno	"bray, braying"
*** 4501 - 4510 (/course/195611/spanish-nouns-2-2/451/)	
el camaleón	chameleon
la ensoñación	"daydream, dream state, unconsciousness"
el pegamento	"glue, cement, adhesive"
la manivela	"handle, crank"
el trajín	hustle and bustle
la guerrera	"mess jacket, combat jacket"
el belén	"nativity scene, impatiens, busy Lizzie"
la bolita	"pellet, marble, wad"
la resigna	resigns
(el)(la) vidente	seer
*** 4511 - 4520 (/course/195611/spanish-nouns-2-2/452/)	
el chelín	"shilling, bob"
el rejón	spear
(el)(la) sindicalista	"syndicalist, trade unionist"
la traviesa	"tie, sleeper"
el titán	titan
el remolcador	"tug, tugboat"
el confesionario	confessional
el astrólogo	astrologer
el mentiroso	"liar, deceiver"
el voluntario	volunteer
*** 4521 - 4530 (/course/195611/spanish-nouns-2-2/453/)	
la marinería	seamanship
el montañismo	"mountaineering, climbing, mountain climbing"
la pseudociencia	pseudoscience
la recurrencia	"recurrence, recourse, appeal"
la uretra	urethra
la deflación	deflation
el emporio	"emporium, mart"
la asistenta	"home help, cleaner, maid"
la lama	"lama, mud, slat"
la lubricación	lubrication
*** 4531 - 4540 (/course/195611/spanish-nouns-2-2/454/)	
el corregidor	"mayor, mayor appointed by the king, chief magistrate"
el múltiplo	multiple
el nocturno	nocturne
la premonición	"premonition, hunch, prescience"
el panecillo	"roll, dinner roll"
el sátiro	"satyr, letch, lecher"
el reintegro	"stamp, rehiring, reinstatement"
el paredón	"thick wall, face, wall"
la cincuentena	fifty
la coreógrafa	choreographer
*** 4541 - 4550 (/course/195611/spanish-nouns-2-2/455/)	
el neerlandés	Netherlander
la fiambrera	"lunch box, lunch pail"
la contextura	"contexture, make-up, composition"
el humorismo	humor
el manierismo	"mannerism, Mannerism, affectation"
el panteísmo	pantheism
el peroné	fibula
la reasignación	reallocation
la telegrafía	telegraphy
el postor	bidder
*** 4551 - 4560 (/course/195611/spanish-nouns-2-2/456/)	
el almanaque	almanac
el inciso	"aside, point, comment"
el bicarbonato	"bicarbonate, bicarbonate of soda, bicarb"
el capó	"bonnet, hood"
el burgo	"burgh, burg"
la tajada	"chop, slice, cut"
la conflagración	conflagration
la apostura	handsomeness
el labriego	"laborer, farmhand"
la embocadura	"mouthpiece, tip"
*** 4561 - 4570 (/course/195611/spanish-nouns-2-2/457/)	
el portland	Portland cement
el baremo	"scale, pricelist, rates"
el entremés	"side dish, starter, entrée"
la succión	"suction, sucking"
el temario	"syllabus, list of topics, set of subjects"
el desbloqueo	"freeing-up, unblocking"
la ecuanimidad	"equanimity, impartiality"
la inmovilización	immobilization
la inteligibilidad	intelligibility
la santificación	sanctification
*** 4571 - 4580 (/course/195611/spanish-nouns-2-2/458/)	
el transbordo	"change, connection, transfer"
el betún	"bitumen, shoe polish, polish"
los brahmanes	Brahmins
el bromuro	bromide
la quemadura	"burn, scorch, burning"
la zarpa	"claw, paw, mitt"
(el)(la) electricista	electrician
el camposanto	"graveyard, cemetery, churchyard"
el azahar	"orange blossom, lemon blossom, citron blossom"
el asociado	partner
*** 4581 - 4590 (/course/195611/spanish-nouns-2-2/459/)	
el guijarro	"pebble, cobble, cobblestone"
la empanada	"pie, patty, turnover"
el retador	retador
los aledaños	surrounding
el anuario	"yearbook, annual, annual directory"
la caballerosidad	"chivalry, gentlemanliness, old-world manners"
la descontaminación	decontamination
el medioevo	middle
el progresismo	"progressivism, progressiveness"
la raigambre	"root ball, roots, mass of roots"
*** 4591 - 4600 (/course/195611/spanish-nouns-2-2/460/)	
el preboste	"provost, chief, leader"
el acuartelamiento	"quartering, billeting"
la conjuración	conjuration
el rizo	"curl, ripple, ringlet"
el epitalamio	epithalamium
el galeón	galleon
el pedrisco	hail
la hecatombe	"hecatomb, catastrophe, calamity"
el embuste	"lie, whopper, trick"
el monzón	monsoon
*** 4601 - 4610 (/course/195611/spanish-nouns-2-2/461/)	
el trinquete	"pawl, ratchet, foremast"
el vencejo	"swift, martlet"
la tiara	tiara
el azulejo	"tile, blue-grey tanager UK, blue-gray tanager US"
la aguada	"watercolour, wash"
el yermo	"wilderness, waste, wasteland"
el civismo	"civility, community spirit"
la semiótica	"semiotics, semeiotics, semiology"
el tintineo	"jingle, chink"
el secuestrador	"abductor, kidnapper, hijacker"
*** 4611 - 4620 (/course/195611/spanish-nouns-2-2/462/)	
el ascendiente	"ancestor, influence"
la filigrana	"filigree, watermark"
la pléyade	"pleiad, group, distinguished group"
la grabadora	"recorder, tape recorder"
la fusta	"riding crop, whip, crop"
(el)(la) derechista	rightist
la sindicación	syndication
el caciquismo	"tyranny, despotism, petty tyranny"
el jovencito	"young man, youngster"
el pollino	"donkey, ass, idiot"
*** 4621 - 4630 (/course/195611/spanish-nouns-2-2/463/)	
la convertibilidad	convertibility
la cuarentena	"quarantine, hold, forties"
el encéfalo	"gray matter, brain cells, brain"
el extrañamiento	estrangement
la farmacología	"pharmacology, pharmacologist"
la fluencia	creep
el pábulo	"pabulum, fuel"
la plantita	"plant, sole, floor"
el polvillo	"blight, tobacco refuse"
el mida	"bean larva, pulse larva"
*** 4631 - 4640 (/course/195611/spanish-nouns-2-2/464/)	
la brizna	"blade, strand, sliver"
la cesárea	"Caesarean section, caesarean section, caesarean"
los bastos	club
la fumigación	fumigation
la lascivia	"lewdness, lust, lustfulness"
la esclusa	"lock, floodgate"
el logaritmo	"logarithm, log"
la efímera	mayfly
el esperpento	"monstrosity, fright, sight"
el motocross	motocross
*** 4641 - 4650 (/course/195611/spanish-nouns-2-2/465/)	
el escapulario	"scapular, scapular prayer"
la estacada	"stockade, lurch, palisade"
el reingreso	re-entry
el banjo	banjo
el júpiter	"Jupiter, Jove"
la trifulca	"brawl, punch-up"
el peto	"breastplate, plastron, bib"
el ceremonial	ceremonial
el terráqueo	earthling
el grabador	engraver
*** 4651 - 4660 (/course/195611/spanish-nouns-2-2/466/)	
la sacudida	"shake, shaking, jolt"
el suborden	suborder
la austriaca	Austrian
el accésit	second prize
el bolchevismo	Bolshevism
(el)(la) centroderecha	center-right
la informatización	computerization
la insularidad	insularity
la mineralogía	mineralogy
el olorcillo	"whiff, faint smell, delicate aroma"
*** 4661 - 4670 (/course/195611/spanish-nouns-2-2/467/)	
la ovulación	ovulation
la madama	"madame, brothel keeper"
el picnic	picnic
el fagot	bassoon
el guardarropa	"cloakroom, wardrobe, checkroom US"
la colectivización	collectivization
la concupiscencia	"concupiscence, lust"
la duna	"dune, sand dune"
el exorcismo	exorcism
el gamo	fallow-deer
*** 4671 - 4680 (/course/195611/spanish-nouns-2-2/468/)	
la depuradora	"filter system, treatment system, purification system"
el caballito	"hobby horse, rocking horse"
el instigador	"instigator, abettor"
el alféizar	"ledge, embrasure, sill"
la melanina	melanin
el microorganismo	"microorganism, organism"
la reventa	"resale, ticket touts, third-party ticket ales"
la salamandra	"salamander, wood-burning stove"
la teocracia	theocracy
el sotobosque	understory
*** 4681 - 4690 (/course/195611/spanish-nouns-2-2/469/)	
el imprevisto	"unexpected event, surprise"
el polio	polio
las bambalinas	"drop, drop scene"
las contras	"opposite, antidote, double (bridge)"
la insubordinación	"insubordination, unruliness, rebelliousness"
el buzo	"diver, overalls, coverall"
el helecho	"fern, bracken"
el montero	huntsman
la indecencia	"indecency, nastiness, obscenity"
el lirio	"lily, iris, water hyacinth"
*** 4691 - 4700 (/course/195611/spanish-nouns-2-2/470/)	
el recitado	"recitation, recitative"
el rústico	"rustic, peasant"
(el)(la) solista	soloist
el pajar	straw loft
la chistera	"top hat, fish basket"
la tutoría	"tutorial, tutorship, class"
el tungsteno	"wolfram, tungsten"
el criollo	Creole person
la exhumación	exhumation
la microbiología	microbiology
*** 4701 - 4710 (/course/195611/spanish-nouns-2-2/471/)	
el minimalismo	minimalism
la morbilidad	"morbidity, sickness rate"
la placidez	"placidity, calmness, tranquillity"
la sincronía	synchrony
la pesquería	"fishery, fishing ground"
la pestaña	"flange, eyelash, flap"
la zalamería	"flattery, sliminess, smoothness"
las branquias	gills
la contraportada	"inside front cover, inside back cover"
la superiora	mother superior
*** 4711 - 4720 (/course/195611/spanish-nouns-2-2/472/)	
el muñoz	munoz
(el)(la) publicista	publicist
el cosido	sewing
la taquicardia	tachycardia
la directa	top gear
el quantum	quantum
la hombría	"manhood, manliness, masculinity"
el metanol	methanol
la mojadura	"dipping, damping, moistening"
el relajamiento	"relaxation, laxity, relaxing"
*** 4721 - 4730 (/course/195611/spanish-nouns-2-2/473/)	
la enramada	"arbor, entwined branches, thicket"
la piragua	"canoe, pirogue, piragua"
el aspa	"cross, blade"
el regadío	"irrigation, irrigated land, irrigable land"
el prestador	lender
la mezcolanza	"mixture, hodgepodge, hotchpotch"
el cenobio	monastery
la barquilla	"nacelle, basket"
la procuradora	"procurator, attorney, proctor"
el setecientos	seven hundred
*** 4731 - 4740 (/course/195611/spanish-nouns-2-2/474/)	
la sarta	"string, series"
el manolo	toff
la vaselina	"vaseline, tact, lob"
la cubana	Cuban
el techado	"roof, rooftop"
la antecesora	predecessor
la psicodelia	psychedelia
la compenetración	"rapport, understanding"
el testador	"testator, legator"
la universalización	universalization
*** 4741 - 4750 (/course/195611/spanish-nouns-2-2/475/)	
la zarina	"czarina, tsarina, tzarina"
la zurda	"southpaw, left-hand"
el sortilegio	spell
el templete	"pavilion, kiosk, small temple"
la jactancia	"boasting, boast, boastfulness"
el enroque	castling
la cosmogonía	cosmogony
el travesaño	"crossbar, crossbeam, traverse"
el excéntrico	"eccentric, oddball, screwball"
la desbandada	"escape, jailbreak,"
*** 4751 - 4760 (/course/195611/spanish-nouns-2-2/476/)	
la cuchillada	"gash, slash, thrust"
el kibutz	kibbutz
el pedúnculo	peduncle
el banderín	"pennant, pin, bunting"
el quebracho	quebracho
el acortamiento	"shortening, curtailment"
el frontispicio	"frontispiece, façade, face"
la desmoralización	demoralization
la excepcionalidad	exceptionality
la imprevisión	improvidence
*** 4761 - 4770 (/course/195611/spanish-nouns-2-2/477/)	
el tití	marmoset
(el)(la) denunciante	informer
la dejación	abandonment
la forestación	afforestation
la hebilla	buckle
el parachoques	bumper
la deformidad	deformity
el cultivador	"farmer, cultivator, tiller"
la inconstancia	"fickleness, inconstancy, unsteadiness"
el ganglio	"ganglion, ganglion cyst"
*** 4771 - 4780 (/course/195611/spanish-nouns-2-2/478/)	
la hostería	"hostel, inn"
la risotada	"laugh, cackle, hoot"
el transatlántico	"liner, ocean liner"
(el)(la) mutante	mutant
la caca	"poo, poop, crap"
el culebrón	"soap, soap opera, melodrama"
la tentadora	temptress
el tetraedro	tetrahedron
el hormigueo	"tingling, crawling sensation, prickling sensation"
la farmacéutica	"chemist, pharmacist, druggist"
*** 4781 - 4790 (/course/195611/spanish-nouns-2-2/479/)	
el bromo	bromine
el hedonismo	hedonism
la vacuidad	"vacuity, emptiness, vacancy"
las asentaderas	buttocks
la decapitación	decapitation
el acarreo	"haulage, transport, carriage"
la interioridad	interiority
el punzón	"punch, burin, graver"
el seminarista	"seminarist, seminarian"
el bofetón	"slap, punch"
*** 4791 - 4800 (/course/195611/spanish-nouns-2-2/480/)	
la mota	"speck, mote, hillock"
(el)(la) zombi	zombie
el cilantro	coriander
el póquer	"poker, hand"
el corpiño	"bodice, bra, stays"
la boya	"buoy, float"
la calculadora	"calculator, mathematical calculator"
la calibración	calibration
el epigrama	epigram
el apeadero	"halt, unstaffed station, mounting block"
*** 4801 - 4810 (/course/195611/spanish-nouns-2-2/481/)	
el asidero	"handle, grip, hold"
la inconveniencia	"inconvenience, impropriety, inappropriateness"
el consumado	"loot, swag"
la mayonesa	"mayo, mayonnaise"
la mena	ore
la pagoda	pagoda
el acogimiento	placement
el procónsul	proconsul
(el)(la) ultraderechista	right-wing
el bramido	"roar, bellow, howl"
*** 4811 - 4820 (/course/195611/spanish-nouns-2-2/482/)	
el balompié	"football, soccer"
el rebozo	shawl
la niñita	toddler
el decorador	decorator
el refugiado	refugee
la viudez	widowhood
el arrianismo	Arianism
la bulimia	bulimia
la convalidación	"validation, recognition"
el deuterio	deuterium
*** 4821 - 4830 (/course/195611/spanish-nouns-2-2/483/)	
el evolucionismo	evolutionism
la posmodernidad	post-modernity
el satanismo	Satanism
el mundillo	"word, circle"
los inducidos	armature
la batista	"batiste, cambric"
el chopo	"black poplar, black poplar wood, shooter"
el chaparrón	"cloudburst, downpour, shower"
la realizadora	director
las expensas	"expenses, costs"
*** 4831 - 4840 (/course/195611/spanish-nouns-2-2/484/)	
la hipotermia	hypothermia
el mazapán	"marzipan, marchpane"
el palmito	"palm heart, palmetto, fan palm"
el pellizco	"pinch, nip, nibble"
el adjudicatario	purchaser
el retoño	"shoot, sprout, scion"
el copo	"snowflake, ball"
el moldeado	"soft perm, loose perm"
la sublimidad	"sublimity, loftiness, elevation"
la trasformación	transformation
*** 4841 - 4850 (/course/195611/spanish-nouns-2-2/485/)	
la colombiana	Colombian
el vudú	"voodoo, hoodoo, voodoo spell"
la leva	"cam, levy"
el arcón	"bunker, chest"
el carretero	"carter, cartwright, wagoner"
el dengue	"dengue, dengue fever"
el dársena	"dock, basin, inner harbour"
la casucha	"hovel, slum, dump"
la instigación	"instigation, incitement, prompting"
el mechero	"lighter, burner, cigarette lighter"
*** 4851 - 4860 (/course/195611/spanish-nouns-2-2/486/)	
el tilo	"lime, linden, lime tree"
el colector	"manifold, collector, waste water pipe"
el azadón	"mattock, hoe"
el lucio	pike
el corrector	proofreader
la quintaesencia	quintessence
la recombinación	recombination
la reconstitución	"reconstitution, rebuilding, reconstruction"
el tufo	"stink, undertone, fumes"
el argelino	Algerian
*** 4861 - 4870 (/course/195611/spanish-nouns-2-2/487/)	
la albañilería	"masonry, building, construction"
el expansionismo	expansionism
el fiat	"fiat, official sanction, consent"
el malhumor	moodiness
el cachorrito	"puppy, offspring, baby mammal"
(el)(la) aneurisma	"aneurysm, aneurism"
el axón	axon
la disensión	"dissension, dissent, strife"
la evangelizadora	evangelizing
la ramera	"harlot, trollop, slut"
*** 4871 - 4880 (/course/195611/spanish-nouns-2-2/488/)	
el semillero	"hotbed, seedbed, nursery"
el millo	million
el bozal	"muzzle, halter"
el peatón	pedestrian
el pope	pope
el muestrario	samples
la germanía	slang
la escolástica	scholasticism
la sueca	"Swedish, Swede"
la interfase	interface
*** 4881 - 4890 (/course/195611/spanish-nouns-2-2/489/)	
el empedrado	paving
la aculturación	acculturation
el darwinismo	Darwinism
la dehiscencia	dehiscence
el devengo	accrual
la torada	Torada
la solariega	"manor, chateau, town house"
el mezquite	mesquite
el tapizado	upholstery
el camastro	rickety old bed
*** 4891 - 4900 (/course/195611/spanish-nouns-2-2/490/)	
la lapa	"barnacle, limpet, pest"
la encuadernación	"bookbinding, binding, binders"
el embrujo	"curse, bewitchment, charm"
el redil	"fold, enclosure"
el decomiso	forfeiture
la helada	"frost, freeze, freezing"
el galón	"gallon, braid"
la gradiente	"gradient, slope"
el saltador	"jumper, springer, diver"
la porosidad	"porosity, porousness"
*** 4901 - 4910 (/course/195611/spanish-nouns-2-2/491/)	
el acusador	"prosecutor, accuser, complainant"
el morral	"satchel, backpack, bag"
el autoservicio	"self-service, minimart, minimarket"
el separador	"separator, book marker, bookmark"
el ujier	"usher, sergeant, attendant"
el cabrío	goat
el feedback	feedback
la fonética	"phonetics, pronunciation"
la inadecuación	unfitness
el interregno	interregnum
*** 4911 - 4920 (/course/195611/spanish-nouns-2-2/492/)	
la lavanda	"lavender, lavender water"
la levedad	"lightness, mildness, tact"
la odontología	"dentistry, odontology, dental science"
el voluntarismo	voluntarism
el loor	praise
el ochocientos	eight hundred
el carrasco	Aleppo
(el)(la) criminal	"criminal, felon, murderer"
el desembarque	disembarkation
la drupa	drupe
*** 4921 - 4930 (/course/195611/spanish-nouns-2-2/493/)	
el intercambiador	exchanger
el exhibicionismo	"exhibitionism, showmanship, indecent exposure"
el regateo	"haggling, bargaining, feinting"
el humus	"humus, hummus"
la jovencita	"lass, bobbysoxer, lassie, chick"
la moscada	nutmeg
la jaca	"pony, cob, nag"
la resultante	resultant
los cortos	short
la manotada	"slap, smack, whack"
*** 4931 - 4940 (/course/195611/spanish-nouns-2-2/494/)	
la zapatilla	"slipper, washer, pad"
el frenazo	slowdown
el husillo	"spindle, drain"
el torio	thorium
el velódromo	velodrome
el hartazgo	"satiety, satiation, surfeit"
el contraespionaje	"counterespionage, counterintelligence"
el escorbuto	scurvy
la petulancia	petulance
el piragüismo	"canoeing, kayaking"
*** 4941 - 4950 (/course/195611/spanish-nouns-2-2/495/)	
la primicia	"beginning, first indication, first notice"
el bingo	"bingo, bingo hall, bingo club"
la zarza	"bramble, brier, briar"
los llamados	called
el chisme	"gossip, tattle, junk"
la guayaba	guava
la picaresca	"guile, wiliness"
la jaqueca	"headache, migraine, severe headache"
la montería	"hunting, hunt"
el alerce	larch
*** 4951 - 4960 (/course/195611/spanish-nouns-2-2/496/)	
el predicamento	predicament
el réquiem	"requiem, requiem mass"
el trino	"trill, roulade, warble"
la monitorización	monitoring
la majestuosidad	"majesty, stateliness"
la sobrevivencia	survival
el carey	"tortoiseshell, shell, tortoise"
el crescendo	"crescendo, swell"
el garbo	"grace, elegance, poise"
la mara	gang
*** 4961 - 4970 (/course/195611/spanish-nouns-2-2/497/)	
la metadona	methadone
la plétora	"plethora, abundance"
(el)(la) comercial	salesperson
el recluso	"convict, recluse"
la contracultura	counterculture
la desmesura	"excess, enormity, disproportion"
el falsete	falsetto
el hipocampo	hippocampus
los marcapasos	"pacemaker, artificial pacemaker"
la pigmentación	pigmentation
*** 4971 - 4980 (/course/195611/spanish-nouns-2-2/498/)	
la adormidera	poppy
el priorato	"priory, priorate, priorship"
el reumatismo	rheumatism
la pisada	"tread, footprint, footstep"
la triunfadora	"winner, success"
el avaro	"miser, tightwad"
el aviador	"aviator, airman, flier"
la radioactividad	radioactivity
la europeización	Europeanization
la hermenéutica	hermeneutics
*** 4981 - 4990 (/course/195611/spanish-nouns-2-2/499/)	
el monaguillo	"altar boy, server"
el barítono	baritone
los esponsales	betrothal
el carburador	"carburetor, carburettor"
los cátaros	Cathars
el converso	convert
el córtex	cortex
la medialuna	"crescent, half moon, half-moon"
el petate	"kitbag, bedroll, bed mat"
el otero	"knoll, hill"
*** 4991 - 5000 (/course/195611/spanish-nouns-2-2/500/)	
la esquela	"notice, announcement, note"
(el)(la) persa	"Persian, Farsi"
el andamiaje	"scaffolding, staging, structure"
el hidroavión	"seaplane, hydroplane"
la ovejita	sheep
(los)(las) inteligentes	smart people
la solterona	"spinster, old maid"
el palito	"stick, drumstick, clothes pin"
el estimulante	stimulant
el satanás	Satan
