*** 1 - 10 (/course/195613/spanish-nouns-4/1/)	
el pajecillo	little page
la manopla	"mitt, fingerless glove, mitten"
el pectoral	"pectoral, pectoral cross, player number"
el arrepentido	penitent
el gallardete	"pennant, pennon, burgee"
el peplo	peplum
el peticionario	"petitioner, claimant"
el ratero	"pickpocket, petty thief, sneak thief"
la palometa	pomfret
la psoriasis	psoriasis
*** 11 - 20 (/course/195613/spanish-nouns-4/2/)	
el recuperador	recuperator
la separata	"reprint, offprint, separate"
la jubilada	"retiree, senior citizen"
la friega	"rub, massage"
el satinado	satin finish
la umbría	the shady side
el mantecado	shortbread
los deportivos	sneakers
el mozuelo	"stripling, young boy"
la superintendencia	"superintendence, oversight"
*** 21 - 30 (/course/195613/spanish-nouns-4/3/)	
el taxímetro	taximeter
el magnetoscopio	VTR
el ambulatorio	"walk in clinic, outpatients clinic, outpatients department"
el encerado	"wax finish or coating, greenboard, whiteboard"
el casorio	wedding
el lupanar	"whorehouse, brothel, bawdy house"
la absurdidad	absurdity
la barcelonesa	woman from Barcelona
las comportas	behaviour
el descodificador	decoder
*** 31 - 40 (/course/195613/spanish-nouns-4/4/)	
la guanábana	soursop
(el)(la) fundamentalista	fundamentalist
el boquerón	anchovy
el patito	duckling
el prusiano	Prussian
el alforfón	buckwheat
la anafase	anaphase
el coladero	"strainer, colander"
el emú	emu
el etano	dimethyl
*** 41 - 50 (/course/195613/spanish-nouns-4/5/)	
la garriga	garrigue
el hieratismo	hieratic
la lasitud	lassitude
la lisura	"evenness, smoothness, rude remark"
el maderamen	timber
la melé	"scrum, ruck, scrummage"
el monofisismo	Monophysitism
la naftalina	"naphthalene, mothballs"
el permanganato	permanganate
la pillería	devilry
*** 51 - 60 (/course/195613/spanish-nouns-4/6/)	
la plausibilidad	plausibility
la prolina	proline
el sóleo	soleus
la toxicología	toxicology
(el)(la) zóster	zoster
la metempsicosis	metempsychosis
el bimotor	twin-engined aircraft
el barandal	"handrail, base support"
el docente	teacher
la accesión	accession
*** 61 - 70 (/course/195613/spanish-nouns-4/7/)	
la antigualla	antique
la maestranza	"armoury, armory, armourer"
el galardonado	award-winner
el balasto	ballast
el pajarraco	"big ugly bird, rogue, rascal"
la bombarda	"bombard, bombardon"
las creces	bulking up
el camafeo	cameo
el rebeco	chamois
el tapado	coat
*** 71 - 80 (/course/195613/spanish-nouns-4/8/)	
el repostero	coat of arms
la colitis	"colitis, diarrhoea"
la trituradora	"crusher, breaker, grinder"
la palabrota	"curse, oath, profanity"
el tajamar	"cutwater, mole"
el ebrio	"drunkard, inebriate"
el doblado	dub
el elevalunas	electric windows
la excrecencia	"excrescence, outgrowth"
la falsía	falsehood
*** 81 - 90 (/course/195613/spanish-nouns-4/9/)	
el patinazo	"gaffe, skid"
el hortelano	"gardener, ortolan bunting"
(el)(la) genetista	geneticist
el dorado	"gold finish, gilt, gilding"
la gorguera	"gorget, ruff"
la manecilla	"hand, hand-shaped sign, floor sign"
la manea	hobble
la giba	"hump, hunch"
la bellaquería	knavery
(el)(la) penca	main rib
*** 91 - 100 (/course/195613/spanish-nouns-4/10/)	
(los)(las) nahuas	Nahua
el engorro	nuisance
el guateque	"party, do, thrash"
el fantoche	"puppet, marionette, braggart"
el resquemor	resentment
el petirrojo	"robin, redbreast"
la silicosis	silicosis
el fleje	strip
la sopera	tureen
la menestra	"vegetable soup, vegetable stew"
*** 101 - 110 (/course/195613/spanish-nouns-4/11/)	
el baldío	"wasteland, vacant lot, uncultivated plot"
los hierbajos	weeds
el cava	"wine, cava, large vein"
la agricultora	"farmer, agriculturalist, agriculturist"
el natalicio	birthday
el formol	formaldehyde
el llantén	plantain
el sumergible	submarine
el guatemalteco	Guatemalan
el planning	planning
*** 111 - 120 (/course/195613/spanish-nouns-4/12/)	
el sureño	southerner
las veneras	scallop
la ampicilina	ampicillin
la ampulosidad	"bombast, puffiness"
el antropocentrismo	anthropocentrism
la apoyatura	appoggiatura
el bombín	"bowler hat, derby, bicycle pump"
la cachaza	"lethargy, slowness"
el caroteno	carotene
la cementita	cementite
*** 121 - 130 (/course/195613/spanish-nouns-4/13/)	
la cosificación	reification
el enrarecimiento	rarefaction
la estraza	kraft
la extraversión	extraversion
el fotomontaje	photomontage
el hectómetro	hectometer
el iglú	igloo
el intermezzo	intermezzo
la magnetita	magnetite
el mentol	menthol
*** 131 - 140 (/course/195613/spanish-nouns-4/14/)	
el metileno	methylene
la metionina	methionine
el miau	"miaow, meow"
el paddock	paddock
el prosaísmo	"prosaism, prose, prosiness"
la raleza	thinness
el ramadán	Ramadan
la riza	crimp
el secreter	"secretaire, secretary"
el símplex	simplex
*** 141 - 150 (/course/195613/spanish-nouns-4/15/)	
el titanio	titanium
el trajecito	outfit
el trirreme	trireme
el voleo	volley
la gemela	"soul, spirit"
el paseíto	"jaunt, little walk, gentlee stroll"
la ordenadora	milking machine
la morbidez	"softness, delicacy"
el devaneo	"a bit of a thing, a thing, a bit of a thing going on"
el acomodamiento	"accommodation, agreement"
*** 151 - 160 (/course/195613/spanish-nouns-4/16/)	
(los)(las) albigenses	Albigenses
(el)(la) chinche	"bug, bedbug, thumbtack"
el toril	"bullpen, pen"
los cromatóforos	chromatophores
el confeti	confetti
la cistitis	cystitis
el chapuzón	"dip, quick dip"
el caporal	"foreman, chief, leader"
el porrón	"glass wine jar with a long tapered drinking spout, lot, large amount"
el trasgo	"goblin, hobgoblin, sprite"
*** 161 - 170 (/course/195613/spanish-nouns-4/17/)	
el mequetrefe	good for nothing
el cabecero	headboard of bed
(el)(la) rompecorazones	Heartbreak
el mercachifle	huckster
el hidrato	hydrate
el puyazo	jab
el magnetómetro	magnetometer
el mixto	match
el caz	millrace
el brezal	"moor, heath, moorland"
*** 171 - 180 (/course/195613/spanish-nouns-4/18/)	
(el)(la) motociclista	"motorcyclist, rider"
la segadora	"mowing machine, reaper"
el nominativo	nominative
el onagro	onager
el ósculo	osculation
(el)(la) parisiense	Paris
la coima	"payola, concubine"
el pinocho	Pinocchio
el avío	"preparation, arrangement, provision"
el libramiento	riddance
*** 181 - 190 (/course/195613/spanish-nouns-4/19/)	
el bolillo	"roll, bread roll, bobbin"
el escudete	"shield, escutcheon, gusset"
la sudadera	"sweatshirt, saddle blanket, heavy sweating"
el prontuario	syllabus
la pretina	"waistband, girdle"
las entendederas	witted
la uralita	asbestos
la cirujana	surgeon
la cordera	"lamb, lambskin"
la enervación	enervation
*** 191 - 200 (/course/195613/spanish-nouns-4/20/)	
el cricket	cricket
el estoico	stoic
el napolitano	Neapolitan
la adenosina	adenosine
el alcano	alkane
el antifascismo	anti-fascism
la aromaterapia	aromatherapy
la barbita	beard
el biso	Bison
el buzamiento	dip
*** 201 - 210 (/course/195613/spanish-nouns-4/21/)	
el cabestrillo	"sling, splint"
el caliche	caliche
la conserjería	"post of janitor, post of superintendent, post of caretaker"
el cronometraje	"timekeeping, timing"
la datura	datura
la despolitización	depoliticization
la entente	Entente
el falucho	felucca
la fastuosidad	lavishness
la fondue	fondue
*** 211 - 220 (/course/195613/spanish-nouns-4/22/)	
el footing	"jog, jogging, running"
la frenología	phrenology
el gánster	gangster
el gustazo	splash out
el hipotiroidismo	hypothyroidism
la invalidación	"invalidation, nullification"
la laparoscopia	laparoscopy
el leviatán	leviathan
el mousse	mousse
la mudada	doffing
*** 221 - 230 (/course/195613/spanish-nouns-4/23/)	
el obstruccionismo	obstructionism
el percentil	percentile
el ratoncillo	little mouse
la sustantividad	substantivity
la troica	troika
el vapuleo	"whipping, mugging"
la vivisección	vivisection
el calefactor	heater
el chut	shot (at goal)
el octano	octane
*** 231 - 240 (/course/195613/spanish-nouns-4/24/)	
la banderita	"little flag, flag"
el gigantón	giant carnival figure
el astrágalo	"astragalus, astragal"
el astrofísico	astrophysicist
la gorrita	beanie
el barreno	"bore, shot hole, drill"
(el)(la) budista	buddhist
la macha	clam
la maquinilla	"clippers, razor"
la contraindicación	"contraindication, counter-indication"
*** 241 - 250 (/course/195613/spanish-nouns-4/25/)	
el condenado	"convicted, prisoner, damned soul"
el cuclillo	cuckoo
la quesería	dairy
el negador	denier
el detergente	detergent
(los)(las) gálatas	Galatians
el gauss	gauss
la muceta	"hood, cape"
la hipérbola	hyperbola
el tasajo	jerky
*** 251 - 260 (/course/195613/spanish-nouns-4/26/)	
el faldellín	kilt
el linóleo	"linoleum, lino"
la hilacha	"loose thread, frayed thread, odds and ends"
la lucerna	louver
el lunático	"lunatic, maniac, crackpot"
el macedonio	Macedonian
el menhir	menhir
la entreplanta	mezzanine
la minera	mining
el pececillo	"minnow, fry"
*** 261 - 270 (/course/195613/spanish-nouns-4/27/)	
la necropsia	necropsy
el fideo	"noodles, rake"
la cigala	"Norway lobster, Dublin Bay prawn, langoustine"
las parásitas	parasitic
(el)(la) paracaidista	"paratrooper, parachutist, sky diver"
el encurtido	pickled
el agujerito	Pinhole
el harapo	"rag, tatter, harapo"
la receptora	receiving
el repetidor	"repeater, relay"
*** 271 - 280 (/course/195613/spanish-nouns-4/28/)	
el retórico	"rhetoric, rhetorician"
el escombro	rubbish
la raspadura	"scratch, scrape, slivers"
el sépalo	sepal
la mosquita	small bird
el velocímetro	speedometer
el fogonero	stoker
el bronceado	"tan, suntan, sunburn"
el termopar	thermocouple
el estrangulador	throttle
*** 281 - 290 (/course/195613/spanish-nouns-4/29/)	
la tisana	tisane
el tónico	"tonic, skin lotion, skin toner"
la videocámara	video camera
(el)(la) vietnamita	Vietnamese
la biógrafa	biographer
el hastial	"gable, gable end"
la cofa	top
el neoyorquino	New Yorker
la agorafobia	agoraphobia
la arana	"spider, chandelier"
*** 291 - 300 (/course/195613/spanish-nouns-4/30/)	
la avienta	fans
la banquisa	"pack, icefield"
la baraúnda	turmoil
la bipolaridad	bipolarity
la creosota	creosote
la cucharita	spoon
el desvalimiento	helplessness
el ennoblecimiento	ennoblement
la inmaterialidad	immateriality
el inquilinato	occupation
*** 301 - 310 (/course/195613/spanish-nouns-4/31/)	
la irreflexión	"thoughtlessness, impetuosity"
la lena	"wood, firewood"
la marroquinería	"leather industry, leather tooling, leather goods store"
el minutero	"timer, minute hand"
el mocho	"kitty, mop, butt"
la musicoterapia	Music Therapy
la neurocirugía	neurosurgery
la perpetración	perpetration
la pesantez	heaviness
la prescindencia	regardless
*** 311 - 320 (/course/195613/spanish-nouns-4/32/)	
la razzia	raid
la reconfiguración	reconfiguration
la requisición	"seizure, confiscation, requisition"
el salmorejo	gazpacho
el socialcristiano	Social Christian
la sonorización	PA System
el store	sunblind
el terebinto	terebinth
(el)(la) mandante	principal
el besamanos	"royal audience, forelock touching"
*** 321 - 330 (/course/195613/spanish-nouns-4/33/)	
la pasionaria	passionflower
la cizalla	"wire cutters, metal shears, guillotine"
la amura	"bow, tack"
el canastillo	"wicker tray, small basket"
los asesorados	advised
los parecidos	"alike, similarity, likeness"
el astracán	astrakhan
el baobab	baobab
la cerbatana	"blowgun, blowpipe, peashooter"
el calderero	boilermarker
*** 331 - 340 (/course/195613/spanish-nouns-4/34/)	
el encuadernador	"bookbinder, binder"
la carbonada	carbon
el chaflán	"chamfer, bevel"
los mofletes	cheeks
las dicotiledóneas	dicots
la draga	"dredger, dredge, drag"
la gotita	droplet
el elástico	"elastic, sprung base"
el enema	"enema, clyster"
el escarpe	escarp
*** 341 - 350 (/course/195613/spanish-nouns-4/35/)	
(el)(la) industrial	"factory worker, industrialist, manufacturer"
la breva	"fig, plum job, cigar"
el flato	"flatulence, flatus, flatulency"
el flirteo	"flirtation, philandering"
la fluorita	fluorite
el glotón	"glutton, wolverine, gourmand"
la calima	"haze, calina"
el heliotropo	heliotrope
el camelo	"hoax, pack of lies, con"
la mentada	mented
*** 351 - 360 (/course/195613/spanish-nouns-4/36/)	
la micra	micron
(el)(la) cambista	moneychanger
el nitrito	nitrite
el robledo	oakwood
el ofertorio	offertory
el oxímoron	oxymoron
el farmacólogo	pharmacologist
el allegado	"relative, follower, close relative"
el resonador	resonator
la talega	"sack, bag, moneybag"
*** 361 - 370 (/course/195613/spanish-nouns-4/37/)	
el imperdible	safety pin
la esclava	"slave, bangle, bracelet"
el clasificador	"sorter, filing cabinet"
el espagueti	spaghetti
el escupitajo	"spittle, spit, gob"
el ramalazo	streak
el sobrescrito	superscription
la sínfisis	symphysis
la proclividad	tendency
el terminador	terminator
*** 371 - 380 (/course/195613/spanish-nouns-4/38/)	
la tesina	"thesis, dissertation"
la trilladora	"thresher, threshing machine"
los desbaratados	thwarted
el amaño	"trickery, deception, trick"
la perogrullada	"truism, platitude"
la umbela	umbel
el urólogo	urologist
(el)(la) cuentista	storyteller
el provincianismo	provincialism
la torrefacción	"roasting, toasting"
*** 381 - 390 (/course/195613/spanish-nouns-4/39/)	
el sonajero	rattle
el esquizofrénico	"schizophrenic, schizo"
los luxemburgueses	from Luxembourg
los binoculares	binoculars
la amoralidad	amorality
la antracita	anthracite
la brisca	Spanish card game
el cardumen	shoal
la casuística	casuistry
la comercialidad	commerciality
*** 391 - 400 (/course/195613/spanish-nouns-4/40/)	
el corindón	corundum
el egotismo	egotism
el entretiempo	spring
el espectrógrafo	spectrograph
la fóvea	fovea
la heparina	heparin
el herraje	"ironwork, metalwork, iron fittings"
el histrionismo	histrionics
el ichu	bunch grass
el laicado	laity
*** 401 - 410 (/course/195613/spanish-nouns-4/41/)	
la madona	Madonna
el mesencéfalo	midbrain
el mesocarpio	mesocarp
el monosacárido	monosaccharide
(el)(la) montañista	mountaineer
el mormonismo	Mormonism
el nadir	nadir
el neceser	"overnight bag, toilet bag, vanity case"
el papaíto	"dad, daddy"
la perfusión	perfusion
*** 411 - 420 (/course/195613/spanish-nouns-4/42/)	
la poliandria	polyandry
el rubidio	rubidium
el sansón	Samson
el sarín	sarin
el sintoísmo	"Shintoism, Shinto"
el teísmo	theism
la teledetección	remote sensing
la teodicea	theodicy
el turón	polecat
el vademécum	formulary
*** 421 - 430 (/course/195613/spanish-nouns-4/43/)	
(el)(la) atacante	"attacker, assailant"
la acedera	sorrel
la tabacalera	cigarette factory
la juguetera	toyshop owner
el tris	"crack, rip, tearing noise"
el acumulador	"accumulator, storage battery"
la encallada	aground
los alpes	Alps
(el)(la) anatomista	anatomist
el tasador	"appraiser, assessor"
*** 431 - 440 (/course/195613/spanish-nouns-4/44/)	
(el)(la) autodidacta	"autodidact, self-taught person"
el barrabás	Barabbas
la mordida	"bite, bribe, backhander"
(el)(la) bolchevique	Bolshevik
el bovino	bovine
el bronquio	"bronchus, bronchial tube"
el dogo	Bulldog
el carbohidrato	carbohydrate
la coneja	"doe, rabbit"
el electo	"elect, elected member/congressman etc."
*** 441 - 450 (/course/195613/spanish-nouns-4/45/)	
el atrincheramiento	entrenchment
(el)(la) etarra	ETA
el cuartelillo	firehouse
la pescadería	fish market
el florín	florin
la formadora	forming
el puntazo	hoot
la iluminadora	illuminating
el incisivo	incisor
(los)(las) inocentes	innocent
*** 451 - 460 (/course/195613/spanish-nouns-4/46/)	
el saber	"knowledge, wisdom"
el nudillo	"knuckle, joint"
los merovingios	Merovingian
la emigrada	migrated
la tata	"nanny, nursemaid, dad"
el nórdico	"Norse, Nordic"
el paralítico	paralytic
el pasquín	pasquinade
la patogénesis	pathogenesis
la piltrafa	"remains, scraps, poor specimen"
*** 461 - 470 (/course/195613/spanish-nouns-4/47/)	
la retorta	retort
el revolucionario	revolutionary
el destripador	ripper
la añagaza	ruse
los temporeros	seasonal
el secuenciador	sequencer
el costurero	"sewing box, sewing room"
la musaraña	"shrew, shrewmouse, speck"
el herma	sisters
(el)(la) matarife	"slaughterer, butcher, slaughterman"
*** 471 - 480 (/course/195613/spanish-nouns-4/48/)	
el intradós	soffit
la espiguilla	spikelet
el zumaque	sumac
la contera	"tip, ferrule"
el váter	"toilet, bathroom"
el reblandecimiento	softening
el acimut	azimuth
el casabe	cassava
el jardincito	garden
la linotipia	linotype
*** 481 - 490 (/course/195613/spanish-nouns-4/49/)	
el maníaco	maniac
el provincialismo	provincialism
el viticultor	winegrower
el bailador	dancer
el bagazo	chaff
el recamado	embroidery
el casimir	cashmere
el epidemiólogo	epidemiologist
el alfajor	alfalfa
la senescencia	senescence
*** 491 - 500 (/course/195613/spanish-nouns-4/50/)	
la acometividad	"energy, enterprise"
el alveolo	"socket, alveolus"
la bacteriología	bacteriology
la carbonilla	coal dust
la catolicidad	Catholicity
el cercenamiento	"curtailment, retrenchment"
la cumplimentación	completion
la descongelación	thawing
el ectoplasma	ectoplasm
el enclaustramiento	confinement
*** 501 - 510 (/course/195613/spanish-nouns-4/51/)	
el enrolamiento	shipment
la falibilidad	fallibility
el fiyiano	Fijian
la gasificación	"gasification, aeration"
la gerontología	gerontology
la homofonía	homophony
el jansenismo	jansenism
el keroseno	kerosene
la manaza	paw
la martensita	martensite
*** 511 - 520 (/course/195613/spanish-nouns-4/52/)	
la mescalina	mescaline
el neutralizador	neutralizer
la nitrocelulosa	nitrocellulose
la parabellum	automatic pistol
el polipéptido	polypeptide
el pródigo	"prodigal, spendthrift, squanderer"
el productivismo	productivism
el propileno	propylene
el tamborileo	"rattle, patter"
el tigriña	Tigrinya
*** 521 - 530 (/course/195613/spanish-nouns-4/53/)	
la traducibilidad	translatability
la vacación	"vacation, holiday"
(el)(la) contrabajista	"double-bass player, bass guitarist"
la corredora	"runner, broker, driver"
el demostrador	demonstrator
el descuartizamiento	"carving up, cutting up, quartering"
el acusativo	accusative
el afroamericano	Afro-American
la asechanza	"ambush, trap, snare"
la amniocentesis	amniocentesis
*** 531 - 540 (/course/195613/spanish-nouns-4/54/)	
el anotador	annotator
la banderilla	"banderilla, skewered pickled foods, gibe"
la alubia	"bean, haricot, haricot bean"
el rompiente	breaking
(el)(la) manazas	butterfingers
el cetáceo	cetacean
la capillita	chapel
el farallón	cliff
los empañados	clouded
la carbonera	"coal mine, coal cellar, coal bunker"
*** 541 - 550 (/course/195613/spanish-nouns-4/55/)	
el economato	"company store, company shop, staff shop"
el endocarpio	endocarp
la chancleta	"flip-flop, thong"
el catorce	fourteen
el frote	friction
la gardenia	gardenia
el vejestorio	"geezer, dodo, old git"
el chismorreo	"gossip, scandal, gossiping"
la explanación	grading
la diorita	greenstone
*** 551 - 560 (/course/195613/spanish-nouns-4/56/)	
la homonimia	homonymy
la intercalación	"intercalation, insertion"
la befa	jeer
la nenita	little girl
el mangle	mangrove
el monito	monkey
el off	"off, off button"
la jira	"picnic, tour, excursion"
el planisferio	planisphere
el plomero	plumber
*** 561 - 570 (/course/195613/spanish-nouns-4/57/)	
la pomposidad	"pomposity, magnificence, splendor"
la prelacía	prelacy
el serbal	"rowan, service tree, sorb"
el chotis	schottische
el adoratorio	shrine
el eslavo	"Slavic, Slav, Slavonic"
el picapinos	Spotted
la batata	"sweet potato, batata, yam"
el tagalo	Tagalog
el tahitiano	Tahitian
*** 571 - 580 (/course/195613/spanish-nouns-4/58/)	
el andrajo	"tatter, rag"
la puntera	toe
la nadería	"trifle, little thing, nothing"
el lavatorio	"washing, lavabo, Maundy"
el pesaje	weighing
el trallazo	whiplash
el dandi	"dandy, dude"
el menguado	decrease
el eritrocito	"red blood cell, erythrocyte"
el quimono	kimono
*** 581 - 590 (/course/195613/spanish-nouns-4/59/)	
el posparto	postpartum
el ablandamiento	softening
el restorán	restaurant
(el)(la) consultante	consultant
la interviú	interview
el peletero	"furrier, skinner"
la gravidez	pregnancy
el siciliano	Sicilian
el tunecino	Tunisian
el zambo	half-breed
*** 591 - 600 (/course/195613/spanish-nouns-4/60/)	
la abejita	bee
la chiripa	"fluke, scratch, flash in the pan"
la comprensibilidad	comprehensibility
la copropiedad	coparcenary
la densificación	densification
la desmitificación	demystification
el didactismo	didacticism
el encarne	quarry
el fajín	sash
la feracidad	"fertility, productivity"
*** 601 - 610 (/course/195613/spanish-nouns-4/61/)	
la glutamina	glutamine
la inmodestia	immodesty
la invocadora	invoking
(el)(la) maorí	Maori
el mesmerismo	mesmerism
el modulador	modulator
el nestorianismo	Nestorianism
el nucleósido	nucleoside
el rededor	surrounding area
el rococó	rococo
*** 611 - 620 (/course/195613/spanish-nouns-4/62/)	
el seseo	seseo
el smash	smash
la supranacionalidad	supranational
el teflón	Teflon
la tiesura	"stiffness, conceit, stubborness"
el tordillo	dapple
la transexualidad	transsexuality
el turbión	storm
el ultraconservador	ultraconservative
la vaqueta	cow
*** 621 - 630 (/course/195613/spanish-nouns-4/63/)	
el voseo	use of vos form
la parrafada	earful
la arenisca	sandstone
la harpa	harp guitar
la ablución	ablution
la abscisa	abscissa
(el)(la) aliancista	Alliance
el anestésico	anesthetic
(el)(la) anestesista	"anesthetist, anaesthesiologist"
el ángelus	Angelus
*** 631 - 640 (/course/195613/spanish-nouns-4/64/)	
la afonía	"aphonia, aphony, dysphonia"
el apotegma	"apothegm, apophthegm"
la aterosclerosis	atherosclerosis
la parrillada	"barbecue, grill"
el biotopo	biotope
la tasca	boozer
el telesilla	"chairlift, chair lift"
el tendedero	clothes dryer
el celaje	"cloudscape, light clouds, scattered clouds"
el comunero	commoner
*** 641 - 650 (/course/195613/spanish-nouns-4/65/)	
el utilitario	"compact, cycle-car"
la chalina	cravat
el crematorio	"crematory, crematorium"
(el)(la) terrícola	Earthman
el emprendedor	entrepreneur
el falcón	falcon
la imposta	fascia
el fórceps	"forceps, forcep"
el fusible	fuse
la genuflexión	genuflection
*** 651 - 660 (/course/195613/spanish-nouns-4/66/)	
el dorador	gilder
la glomerulonefritis	glomerulonephritis
el hemistiquio	hemistich
(el)(la) herbicida	"herbicide, weed-killer"
el hondureño	Honduran
(el)(la) hugonote	Huguenot
el lechón	"lucky duck, pig, pork"
el enmascarado	masked person
el felpudo	"mat, doormat"
la mixtificación	mystification
*** 661 - 670 (/course/195613/spanish-nouns-4/67/)	
(el)(la) zoquete	"oaf, duffer, dullard"
la oblación	oblation
(el)(la) oboísta	oboist
el proscrito	"outlaw, outcast"
la descamación	peeling
el perdigón	"pellet, shot, partridge chick"
la petroquímica	"petrochemistry, petrochemical science"
el martinete	pile driver
la lanzadora	"pitcher, thrower"
el polisacárido	polysaccharide
*** 671 - 680 (/course/195613/spanish-nouns-4/68/)	
(el)(la) retratista	portraitist
el fruncimiento	puckering
el reforzador	reinforcer
el resistor	resistor
el rollito	roll
el despistado	scatterbrain
la esquistosomiasis	schistosomiasis
el escuálido	scrawny
el escaque	slopes off
(el)(la) frotis	smear
*** 681 - 690 (/course/195613/spanish-nouns-4/69/)	
las tortícolis	"stiff neck, crick, torticollis"
el alhelí	"stock, wallflower"
la sabandija	"vermin, bug, louse"
la astrónoma	"astronomer, stargazer"
la erudita	"scholar, polymath"
la mosqueta	flycatcher
la palentina	Palencia
el atizador	poker
el afgano	Afghan
el toledano	Toledo
*** 691 - 700 (/course/195613/spanish-nouns-4/70/)	
el vallisoletano	Valladolid
las desaparecidas	missing person
el acíbar	aloe juice
el alófono	allophone
el arrabio	pig iron
el batín	dressing gown
la blástula	blastula
el cacareo	"cackle, cluck, clucking"
la covariancia	covariance
el crol	crawl
*** 701 - 710 (/course/195613/spanish-nouns-4/71/)	
la eslovena	"Slovenian, Slovene"
el hatajo	bunch
(el)(la) internacional	international
la lida	output
la miastenia	gravis
el mixteco	Mixtec
el monarquismo	"royalism, monarchism"
el morón	hummock
el palisandro	"rosewood, palisander"
el pericardio	pericardium
*** 711 - 720 (/course/195613/spanish-nouns-4/72/)	
el periostio	periosteum
la petrificación	"petrification, petrifaction"
el píloro	pylorus
el pizzicato	pizzicato
el poliestireno	polystyrene
la quincalla	"hardware, ironmongery, trinket"
la radioastronomía	radio astronomy
la rubéola	"rubella, German measles"
la síncopa	"syncope, syncopation"
el talonario	"book, receipt book, book of tickets, ticket book"
*** 721 - 730 (/course/195613/spanish-nouns-4/73/)	
(el)(la) pringue	"grease, dripping"
el gorgojo	weevil
el albino	albino
el altímetro	altimeter
la barbie	Barbie
el bongo	bongo drum
la camelia	camellia
(los)(las) cantonales	cantonal
el capuchino	"cappuccino, Capuchin, capuchin"
(el)(la) castellonense	Castellon
*** 731 - 740 (/course/195613/spanish-nouns-4/74/)	
la cebolleta	"chives, scallion, spring onion"
la coctelera	cocktail shaker
el collarín	"collar, ruff, bolster"
el cornetín	cornet
la divagación	"digression, vagary, divagation"
la vellosidad	"downiness, fuzziness"
el delineante	"draftsman, draftsman US, draughtsman UK"
los estes	East
la escarola	"endive, chicory, ruff"
el endoscopio	endoscope
*** 741 - 750 (/course/195613/spanish-nouns-4/75/)	
la embarrada	"gaffe, blunder, screw-up"
el geranio	geranium
los gigavatios	gigawatts
la gubia	gouge
el cañonero	gunner
el hioides	hyoid
el interrogador	"interrogator, examiner"
el jordán	Jordan
la tricota	knitted
el lanzazo	lance
*** 751 - 760 (/course/195613/spanish-nouns-4/76/)	
la lividez	lividness
el merodeador	"marauder, prowler"
los máximos	"maximum, high, possible"
el minio	"minium, red lead"
la moralina	moralizing
el narguile	"narghile, hookah, hooka"
el acaecimiento	occurrence
la ordalía	ordeal
la encuestadora	polling
la verdolaga	purslane
*** 761 - 770 (/course/195613/spanish-nouns-4/77/)	
el radiómetro	radiometer
la ropera	rapier
(el)(la) rebelde	"rebel, insurgent"
el renovador	renovator
la maroma	"rope, hawser, somersault"
la escoliosis	scoliosis
el cendal	sendal
los sietes	sevens
el apresto	"sizing, priming, size"
la cadenilla	small chain
*** 771 - 780 (/course/195613/spanish-nouns-4/78/)	
la sillita	small chair
las solanáceas	Solanaceae
el picapedrero	stonecutter
la ventosa	"sucker, suction pad"
(el)(la) turquesa	turquoise
el zigoto	zygote
el cúter	cutter
la delatora	"informer, delator"
la enviada	envoy
el stalinismo	Stalinism
*** 781 - 790 (/course/195613/spanish-nouns-4/79/)	
las gárgaras	"gargling, gargle"
el hipervínculo	hyperlink
el gollete	neck
la arterioesclerosis	arteriosclerosis
el caudillaje	leadership
el acelerómetro	accelerometer
el actinio	actinium
el agotador	exhausting
la alternación	"alternation, interchange, rotation"
la americanización	Americanization
*** 791 - 800 (/course/195613/spanish-nouns-4/80/)	
la bielorrusa	Belarusian
la bradicardia	bradycardia
la bruta	brute
el cafecito	cup of coffee
el claqué	claque
el clarete	claret
el colágeno	collagen
la conicidad	taper
la cumbrera	ridgepole
la defenestración	defenestration
*** 801 - 810 (/course/195613/spanish-nouns-4/81/)	
la denigración	denigration
el desaseo	"sleaze, slovenliness"
la desnuclearización	denuclearization
el desquiciamiento	dislocations
la electrocución	electrocution
el epigastrio	epigastrium
el escapismo	escapism
la eurovisión	eurovision
la gemación	gemmation
el guacamole	"guacamole, avocado dip"
*** 811 - 820 (/course/195613/spanish-nouns-4/82/)	
el guardapelo	locket
la habitualidad	habitual
el hipoclorito	hypochlorite
el lechazo	"young lamb, bash, swipe"
la manufacturación	manufacturing
el maquiavelismo	Machiavellianism
la mecanografía	typing
la melisa	"balm, lemon balm"
el milanés	Milanese
la morralla	whitebait
*** 821 - 830 (/course/195613/spanish-nouns-4/83/)	
el parsi	Parsi
el pedaleo	pedaling
el pentámetro	pentameter
la poliginia	polygyny
el robustecimiento	strengthening
la ropita	clothes
la serina	serine
la tarabilla	"chatterbox, featherbrained person, useless individual"
el tomahawk	tomahawk
la vitola	band
*** 831 - 840 (/course/195613/spanish-nouns-4/84/)	
(el)(la) contorsionista	contortionist
el ganchillo	"crochet hook, crochet"
el disentimiento	"dissent, disagreement"
el melocotonero	peach tree
el rappel	"abseiling, rappel"
la inasistencia	"absence, non-attendance, lack of support"
(el)(la) acróbata	acrobat
el anfibio	amphibian
la anilina	aniline
la bacante	"Bacchante, bacchanal"
*** 841 - 850 (/course/195613/spanish-nouns-4/85/)	
la bestezuela	beastie
la negrita	"bold type, bold face"
el prestatario	borrower
el coscorrón	"bump on the head, clout"
el burrito	burrito
la gargantilla	choker
la canaleta	chute
los cómicos	"comic, comedian"
el orientador	counselor
la espantada	"desertion, flight, fleeing"
*** 851 - 860 (/course/195613/spanish-nouns-4/86/)	
la detracción	detraction
la distintiva	distinctive
el diurno	"diurnal, day"
la chilaba	"djellaba, jellaba, hijab"
la mancuerna	"dumbbell, weight, rope"
la elefantiasis	elephantiasis
la expectoración	expectoration
la flatulencia	"flatulence, flatulency, wind"
el gladiolo	"gladiolus, gladiola"
el entorchado	"gold braid, bullion"
*** 881 - 890 (/course/195613/spanish-nouns-4/87/)	
la espata	shuck
el ruidito	small noise
(el)(la) sabelotodo	"smarty, smart ass, smart aleck"
el sembrador	sower
el espectroscopio	spectroscope
el aliviadero	spillway
la jarcia	"tackle, rigging"
la tarja	tally
el chivatazo	tip
el excusado	"toilet, lavatory, restroom"
*** 861 - 870 (/course/195613/spanish-nouns-4/88/)	
el horticultor	"horticulturist, nurseryman"
el justillo	jerkin
(el)(la) litigante	litigant
los longobardos	Lombards
el miligramo	"milligram, milligramme"
el barrizal	"mire, muddy area, muddy place"
(el)(la) marmolista	monumental mason
(el)(la) nasal	nasal
la notabilidad	"notability, notable"
el fonograma	phonogram
*** 871 - 880 (/course/195613/spanish-nouns-4/89/)	
el cascote	"piece of rubble, rubble"
los quevedos	pince-nez
el pistilo	pistil
las pulsaciones	pulsations
la metedura	putting
la péndola	queen post
el remache	"rivet, clinch, final touch"
el romano	"Roman, Romany"
el sargazo	sargasso
el escopetazo	shotgun
*** 911 - 920 (/course/195613/spanish-nouns-4/90/)	
la impresionabilidad	impressionability
el incordio	"nuisance, pain in the neck"
la incorruptibilidad	incorruptibility
el itrio	yttrium
el lunfardo	"slang, lunfardo, crook"
la magnesia	magnesia
el mentalismo	mentalism
el multiprocesador	multiprocessor
el octógono	octagon
el pareo	"matching, pareo, beach wrap"
*** 891 - 900 (/course/195613/spanish-nouns-4/91/)	
la menudencia	"trifle, minuteness, doit"
la vasectomía	vasectomy
el vagabundeo	"wandering, roam, wanderings"
el tarugo	"wooden peg, doorstep"
el zooplancton	zooplankton
(el)(la) portaestandarte	standard-bearer
el contraterrorismo	counterterrorism
la coronela	colonel
las babosas	slug
el feligrés	parishioner
*** 901 - 910 (/course/195613/spanish-nouns-4/92/)	
el isleño	islander
el acónito	"aconite, monkshood"
el adeudo	"duty, customs duty, debt"
la analgesia	analgesia
el antiguo	old one
el autobombo	"self-praise, self-advertisement"
el clasismo	classism
la exfoliación	exfoliation
el führer	Fuhrer
el galvanómetro	galvanometer
*** 941 - 950 (/course/195613/spanish-nouns-4/93/)	
la pajarera	"aviary, birdcage"
la bronquiolitis	bronchiolitis
la bufonada	"buffoonery, clowning, antic"
la hamburguesería	burger
el conciliábulo	cabal
el tallado	"carving, engraving, sculpting"
la acusada	"charged, accused, indicted"
la cigarrera	cigar case
el quino	cinchona
(el)(la) reclamante	claimant
*** 921 - 930 (/course/195613/spanish-nouns-4/94/)	
la pilosidad	"pilosity, furriness"
el praseodimio	praseodymium
el puff	"pouffe, pouf"
el pupilaje	"pupilage, pupillage"
la radícula	radicle
la salivación	salivation
el sanedrín	"sanhedrin, sanhedrim"
el tarjetero	card index
el terranova	Newfoundland
la urología	urology
*** 951 - 960 (/course/195613/spanish-nouns-4/95/)	
la abrazadera	"clamp, cleat, brace"
el peleador	cockish
la chirimoya	custard apple
(el)(la) marchante	dealer
el fumadero	den
(el)(la) proyectista	"designer, projector, draftsman"
el artificiero	explosive expert
la alharaca	"fuss, over-reaction, song and dance"
el gameto	gamete
la granulometría	granulometry
*** 931 - 940 (/course/195613/spanish-nouns-4/96/)	
la videncia	clairvoyance
la areola	"areola, areole"
(el)(la) arreglista	arranger
(el)(la) bonaerense	of/from Buenos Aires province
la terneza	tenderness
la premiada	prize winner
(el)(la) beisbolista	baseball player
el amnios	amnion
la anamorfosis	anamorphosis
la asonancia	assonance
*** 971 - 980 (/course/195613/spanish-nouns-4/97/)	
el níspero	"medlar, loquat"
el metatarso	metatarsus
la ocarina	ocarina
el palimpsesto	palimpsest
el perico	"parakeet, cocaine"
(el)(la) viandante	"passer-by, pedestrian"
el bancal	patch
el pentecostés	"Pentecost, Whitsuntide"
el pericarpio	pericarp
el neumococo	pneumococcus
*** 961 - 970 (/course/195613/spanish-nouns-4/98/)	
el bohío	"hut, shack"
el hiperboloide	hyperboloid
la inquisidora	Inquisitor
la pasantía	internship
el invertido	invert
la investigadora	"investigator, researcher"
la chinita	"jibe, taunt, side comment"
la lamprea	lamprey
la lanceta	lancet
(el)(la) medallista	medallist
*** 1001 - 1010 (/course/195613/spanish-nouns-4/99/)	
la errada	wrong
el velón	oil lamp
el eczema	eczema
la envenenadora	poisoner
(el)(la) vascuence	Basque
la asna	"ass, donkey, dolt"
la napolitana	Neapolitan
la otomana	Ottoman
la sílfide	sylph
la veterinaria	"vet, veterinarian, veterinary"
*** 991 - 1000 (/course/195613/spanish-nouns-4/100/)	
la escupidera	"spittoon, cuspidor, bedpan"
el fasto	splendor
(el)(la) semental	"stallion, stud, sire"
el estornino	starling
el subdiácono	subdeacon
el charrán	tern
la amigdalitis	tonsillitis
el golpeador	walloper
el lloriqueo	"whimpering, snivelling"
el bobinado	wound
*** 981 - 990 (/course/195613/spanish-nouns-4/101/)	
la poterna	"postern, sally port"
(el)(la) tratante	procurer
la estofa	"quilt, class"
la quinceañera	Quinceanera
el grajo	"rook, jackdaw, raven"
la naba	"rutabaga, swede"
la salvajada	"savagery, savageness"
el regaño	"scolding, chide, earful"
el amortiguador	"shock absorber, muffler, shock-absorbing"
la cajeta	"soft toffee, caramel"
*** 1011 - 1020 (/course/195613/spanish-nouns-4/102/)	
el apóstrofo	apostrophe
la yeguada	drove of horses
la descodificación	decoding
la focha	coot
el acabóse	last straw
la agenesia	agenesis
la angioplastia	angioplasty
el astigmatismo	astigmatism
la ataraxia	"ataraxy, ataraxia"
la avocación	certiorari
*** 1021 - 1030 (/course/195613/spanish-nouns-4/103/)	
la azulejería	tiling
la azurita	azurite
el cárter	"sump, chain guard"
el charlatanismo	charlatanism
la codecisión	codecision
la compresibilidad	compressibility
el conceptualismo	conceptualism
la depauperación	impoverishment
la dolorida	sore
el empujoncito	jog
*** 1031 - 1040 (/course/195613/spanish-nouns-4/104/)	
el encarte	"insert, inset, supplement"
el enciclopedismo	encyclopedic
el escandio	scandium
la esporulación	sporulation
la fritada	fry
el hexámetro	hexameter
el hotelito	detached house
la lenidad	"lenity, leniency, lenience"
el microordenador	"microcomputer, micro, computer"
la movilizadora	mobilizing
*** 1061 - 1070 (/course/195613/spanish-nouns-4/105/)	
el bao	beam
el osezno	"bear cub, cub"
el bielorruso	Belarus
la cenefa	"border, trimming, edging"
la cánula	cannula
el purpurado	cardinal
el castellanismo	Castilianism
el clínico	"clinician, doctor, GP"
la conjuntiva	conjunctiva
la continuadora	continuation
*** 1051 - 1060 (/course/195613/spanish-nouns-4/106/)	
la vacuola	vacuole
la vulcanización	vulcanization
la pescadera	fishmonger
el réprobo	reprobate
la calcomanía	transfer
la bocatoma	"water intake, inlet pipe"
los afirmados	affirmed
la locutora	announcer
el incendiario	"arsonist, incendiary"
la carnaza	bait
*** 1041 - 1050 (/course/195613/spanish-nouns-4/107/)	
el muralismo	muralism
el neptunio	neptunium
la neurofisiología	neurophysiology
el oreo	airing
el papito	daddy
el punteo	"plucking, spotting, picking"
el quiasma	chiasma
la quiromancia	"palmistry, chiromancy"
el tanteador	"scorekeeper, scorecard, scorer"
la transitividad	transitivity
*** 1071 - 1080 (/course/195613/spanish-nouns-4/108/)	
el cuadrito	cube
el curio	curium
la cortada	"cut, slice, piece"
el cibercafé	"cybercafé, Internet café"
(el)(la) documentalista	documentary
el apósito	dressing
el dieciocho	eighteen
el figurín	"exquisite, model"
la disquetera	floppy
el escarceo	foreplay
*** 1081 - 1090 (/course/195613/spanish-nouns-4/109/)	
el formulismo	formulism
la manilla	"handcuffs, cuffs, hand"
(el)(la) arpista	harpist
el mamotreto	"hefty volume, huge tome"
la vacada	herd
el yambo	"iambic, iamb"
la malquerencia	ill will
el levantador	lifter
la mandarina	"mandarin, tangerine, mandarin orange"
la mescolanza	medley
*** 1121 - 1130 (/course/195613/spanish-nouns-4/110/)	
el abolicionismo	abolitionism
la catalasa	catalase
el cocker	"cocker, cocker spaniel"
la codeína	codeine
la derechización	rightward
el desbaste	bloom
la desratización	deratting
la disfagia	dysphagia
la eritromicina	erythromycin
el golpismo	tendency to military coups
*** 1091 - 1100 (/course/195613/spanish-nouns-4/111/)	
la mononucleosis	mononucleosis
la narcosis	narcosis
el olivino	olivine
el fariseo	pharisee
la trastada	"prank, mischief, practical joke"
el castigador	punisher
la resma	ream
el cacheo	"search, searching, frisk"
el apeo	survey
la teca	teak
*** 1101 - 1110 (/course/195613/spanish-nouns-4/112/)	
(el)(la) tranquilizante	"tranquilizer, tranquillizer"
el truncamiento	truncation
el latiguillo	"tube, connecting tube, filler"
el presuntuoso	upstart
el versificador	versifier
el viático	"viaticum, travel allowance, allowance"
la milanesa	"Wiener schnitzel, escalope, breaded veal cutlet"
la ventolera	"wild idea, pinwheel, windmill toy"
la serrería	sawmill
el bumerang	boomerang
*** 1111 - 1120 (/course/195613/spanish-nouns-4/113/)	
el giroscopio	gyroscope
la serrana	"hill-dweller, mountain-dweller, mountain people"
el siclo	shekel
el tubito	tubule
la uruguaya	Uruguayan
la ascética	ascetic
el cervecero	brewer
la improbabilidad	improbability
el llorón	"crybaby, weeper"
el surcoreano	South Korean
*** 1131 - 1140 (/course/195613/spanish-nouns-4/114/)	
la hidroelectricidad	hydropower
la irascibilidad	"irascibility, testiness"
el jogging	"jogging, running"
(el)(la) lealista	loyalist
la llavecita	small key
el muón	muon
el parnaso	Parnassus
el posibilismo	possibilism
el prendimiento	apprehension
el remojo	soaking
*** 1141 - 1150 (/course/195613/spanish-nouns-4/115/)	
la ronquera	hoarseness
el sisal	sisal
el solipsismo	solipsism
el tendal	"awning, clothes line, washing line"
el tribalismo	tribalism
el trióxido	trioxide
el alzacuello	clerical collar
la camella	camel
las acciones	doings
el iluso	dreamer
*** 1151 - 1160 (/course/195613/spanish-nouns-4/116/)	
la boñiga	"cowpat, dung"
el radioaficionado	"radio enthusiast, radio ham"
el capirote	pointed hood
la conchita	"pussy, cunt"
el suscriptor	"executor, subscriber"
la recidiva	relapse
la amida	amide
la bacanal	"Bacchanalia, orgy"
el batallador	battler
el encarnado	blush
*** 1161 - 1170 (/course/195613/spanish-nouns-4/117/)	
el acantonamiento	cantonment
la cadenita	chainlet
la circunvolución	"convolution, circumvolution"
el tirabuzón	"corkscrew, ringlet, spiral"
la cotilla	"corset, stays"
la cínica	cynic
el denario	denarius
el hoyuelo	dimple
la equimosis	ecchymosis
la erisipela	erysipelas
*** 1171 - 1180 (/course/195613/spanish-nouns-4/118/)	
(el)(la) inmobiliario	estate agent
las fabáceas	Fabaceae
la platija	"fluke, plaice, flounder"
el godo	"Goth, Spaniard, loyalist"
los canalones	gutters
el chinchorro	"hammock, net, fishing boat"
el aislador	"isolator, insulator"
el arrendajo	jay
la laringitis	laryngitis
el cerillo	"match, species of gum tree, long thin candle"
*** 1181 - 1190 (/course/195613/spanish-nouns-4/119/)	
la plumilla	"nib, pen nib, fountain pen"
el recoveco	"nook, turning, hidden corner"
la odalisca	"odalisque, odalisk"
el abrelatas	"opener, bottle opener, can opener"
el desaguadero	"outlet, drain, outfall"
la granadilla	"passion fruit, passionflower"
los pecadillos	peccadillo
la fotocopiadora	photocopier
el plinto	plinth
la cataplasma	"poultice, cataplasm"
*** 1191 - 1200 (/course/195613/spanish-nouns-4/120/)	
la gacetilla	press release
la proveniencia	provenance
(el)(la) guardabosque	"ranger, forester, keeper"
el retardador	retarder
el rudimento	"rudiment, vestige"
la mesada	salary
la sinuosidad	sinuosity
el chiquito	small glass of wine
el estampado	"stamping, pattern, print"
el sulfito	sulphite
*** 1201 - 1210 (/course/195613/spanish-nouns-4/121/)	
el sinclinal	syncline
la aspiradora	"vacuum, vacuum cleaner, hoover"
el estrafalario	wack
la relojera	watchmaker
el pian	yaws
el cortador	cutter
el giróscopo	gyroscope
el interfono	intercom
la patita	duckling
el sustitutivo	substitute
*** 1211 - 1220 (/course/195613/spanish-nouns-4/122/)	
la surafricana	South African
el túbulo	tubule
la tartera	"lunch box, lunch pail"
el monárquico	"monarchist, royalist"
el sudamericano	South American
la absolutidad	absoluteness
la accidentalidad	"accident rate, number of accidents"
el albayalde	white lead
la amanita	amanita
el amorcito	sweetheart
*** 1221 - 1230 (/course/195613/spanish-nouns-4/123/)	
la anáfora	anaphora
la andalucita	andalusite
el aquietamiento	stilling
el arrancamiento	avulsion
la autoconstrucción	self-construction
el aviario	aviary
el beleño	henbane
el beriberi	beriberi
el bocabajo	facedown
el bristol	Bristol board
*** 1231 - 1240 (/course/195613/spanish-nouns-4/124/)	
el butano	butane
el calorímetro	calorimeter
la caquexia	cachexy
el consomé	"consommé, clear soup, soup"
el contoneo	swagger
(el)(la) crápula	"libertine, waster"
(el)(la) crupier	croupier
la cuscuta	dodder
el desintegrador	disintegrator
el deuteronomio	Deuteronomy
*** 1241 - 1250 (/course/195613/spanish-nouns-4/125/)	
el epiléptico	epileptic
la filípica	philippic
la frigidez	frigidity
la gimnástica	gymnastic
el gordito	pudge
la gutapercha	gutta-percha
la hidrofobia	"hydrophobia, rabies"
la huma	human
el ilion	ilium
la impavidez	"calmness, impassivity"
*** 1251 - 1260 (/course/195613/spanish-nouns-4/126/)	
la invariabilidad	invariability
la lanilla	fluff
la letalidad	lethality
la manicura	"manicure, manicurist"
el mueblaje	unfurnished
la norepinefrina	norepinephrine
el occipucio	occiput
la pasamanería	rider
la pepsina	pepsin
el pión	pion
*** 1261 - 1270 (/course/195613/spanish-nouns-4/127/)	
la primilla	Lesser
la retinopatía	retinopathy
la sinécdoque	synecdoche
la solla	plaice
el sollo	"pike, sturgeon"
el subidón	rush
la témpera	tempera
el trabajito	little job
el vicariato	vicariate
el voltímetro	voltmeter
*** 1271 - 1280 (/course/195613/spanish-nouns-4/128/)	
la retorsión	"twisting, wringing"
la bosta	"dung, droppings, manure"
el correaje	"straps, harness, leathers"
la broza	brushwood
el letón	Latvian
la arrancada	"sudden start, sudden accerlation, jerk"
el rimero	"stack, pile, heap"
el piolet	"ice axe, ice ax"
la adúltera	adulteress
el anemómetro	"anemometer, wind gauge"
*** 1281 - 1290 (/course/195613/spanish-nouns-4/129/)	
la anisotropía	anisotropy
los batoideos	batoids
la baya	"berry, bay horse, bean"
el babero	"bib, patch on the throat, smock"
la bravata	"bravado, threat, big talk"
el reventón	"burst, blowout, bust"
el cefalotórax	cephalothorax
la calcografía	chalcography
el nubarrón	"cloud, storm cloud, black cloud"
el codicilo	codicil
*** 1291 - 1300 (/course/195613/spanish-nouns-4/130/)	
el coetáneo	"contemporary, coeval"
el correlativo	correlative
la amanecida	dawn
la tumbona	deck chair
el desodorante	deodorant
la menguante	"ebb, ebbing"
el electroencefalograma	electroencephalogram
el gordo	"fat, first prize, grand prize"
el colgajo	"flap, pendant, straggler"
el matamoscas	"fly swatter, fly killer, insecticide"
*** 1301 - 1310 (/course/195613/spanish-nouns-4/131/)	
el cartapacio	"folder, zippered binder, notebook"
(el)(la) otorgante	grantor
la ralladura	"grated rind, zest"
la apretura	"keepsake, jams"
la reata	"lariat, train, string"
(el)(la) editorialista	leader-writer
el limonero	"lemon, lemon tree"
el licántropo	lycanthrope
el mallo	mall
el meato	meatus
*** 1311 - 1320 (/course/195613/spanish-nouns-4/132/)	
el morfo	morpho
el colgante	"necklace, pendant"
el descosido	open seam
la zarigüeya	"opossum, possum"
la plasta	"paste, botch-job, turd"
la penitenciaria	penitentiary
la pipeta	"pipet, pipette"
el pleonasmo	pleonasm
(el)(la) postulante	postulant
la puzolana	"pozzolana, pozzuolana"
*** 1321 - 1330 (/course/195613/spanish-nouns-4/133/)	
(el)(la) preliminar	preliminary
(el)(la) propagandista	propagandist
el publicano	publican
el envión	"push, shove"
el real	"real, penny, hapenny"
el recto	rectum
el refractor	refractor
la ricota	ricotta
la chorrera	ruffle
el sacabuche	sackbut
*** 1331 - 1340 (/course/195613/spanish-nouns-4/134/)	
el sacrificador	sacrificer
el festón	"scallop, festoon, scollop"
la chalana	scow
el seglar	"secular, layman/laywoman"
el zorrillo	skunk
el botellín	"small bottle, flask, vial"
el nevero	snowfield
la azotaina	"spanking, whipping, flogging"
el gastador	"spender, big spender"
(el)(la) okupa	squatter
*** 1341 - 1350 (/course/195613/spanish-nouns-4/135/)	
el tenderete	"stand, market stall"
los esteroles	sterols
el tirante	"strap, shoulder strap, brace"
las angarillas	stretcher
el subrogado	subrogated
el taponamiento	tamponade
el estanquero	tobacconist
el tropismo	tropism
la asiática	"Asian, Asiatic"
la italiana	Italian
*** 1351 - 1360 (/course/195613/spanish-nouns-4/136/)	
el dramón	melodrama
el memo	memorandum
la redactora	"editor, redactor"
el esnob	snob
el fratricidio	fratricide
el pesticida	pesticide
la conductibilidad	conductivity
el holgazán	"idler, laggard, bum"
la mnemotecnia	mnemonics
el neoclásico	neoclassical
*** 1361 - 1370 (/course/195613/spanish-nouns-4/137/)	
el norteamericano	"American, North American"
el afeitado	"shaving, shave"
el amerizaje	"landing, splashdown, touchdown"
el aperturismo	openness
la cajuela	"trunk, boot, luggage compartment"
la cápita	capita
el cerio	cerium
(el)(la) constitucionalista	constitutionalist
el criptógrafo	cryptographer
la encriptación	encryption
*** 1371 - 1380 (/course/195613/spanish-nouns-4/138/)	
el epidídimo	epididymis
la escopolamina	scopolamine
el ferretero	ironmonger
la intemporalidad	timelessness
la interdisciplinariedad	interdisciplinarity
el mahometismo	mohammedanism
el megabyte	megabyte
el microbiólogo	microbiologist
el montecillo	"hummock, hillock, hump"
el pigmalión	Pygmalion
*** 1381 - 1390 (/course/195613/spanish-nouns-4/139/)	
el pizarrín	slate pencil
el precalentamiento	preheating
la resucitación	"resuscitation, revival"
el tetracloruro	tetrachloride
el verdín	"fresh green, verdigris, scum"
la montañesa	"mountain, highland"
el voladizo	cantilever
la radiocomunicación	radio communication
el sicomoro	sycamore
la cantilena	"ballad, song"
*** 1391 - 1400 (/course/195613/spanish-nouns-4/140/)	
el cabezo	"hillock, small hill, reef"
el cavador	digger
el aerogenerador	wind turbine
(el)(la) agonista	agonist
la chita	"anklebone, game played with bone"
el anunciador	"annunciator, announcer, herald"
el arpegio	arpeggio
(el)(la) asambleísta	assemblyman
la mona	"bow, puff, leg armour"
la moña	"bow, puff, skinful"
*** 1401 - 1410 (/course/195613/spanish-nouns-4/141/)	
los peleles	bubblers
la acampada	"camp site, camp"
la charada	charade
la clepsidra	clepsydra
(el)(la) oficinista	"clerk, clerical"
el condensado	condensate
la huevera	"egg box, egg carton, egg cup"
el potenciador	enhancer
la escarpa	"escarpment, scarp, bluff"
el aguamanil	"ewer, basin, sink"
*** 1411 - 1420 (/course/195613/spanish-nouns-4/142/)	
la andanza	"fortune, fate"
el numerito	"full-in act, short act"
la guardilla	garret
el hoplita	hoplite
el islandés	"Icelandic, Icelander"
la indagatoria	inquiry
la chiva	"kid, nanny goat, nanny"
el besito	kiss
la bribona	"knave, rascal, villain"
el lípido	lipid
*** 1421 - 1430 (/course/195613/spanish-nouns-4/143/)	
(los)(las) mercantilistas	mercantilist
(el)(la) mudéjar	Mudéjar
los nabateos	Nabataeans
el nazareno	"Nazarene, penitent"
los nestorianos	Nestorians
el organillero	organ grinder
el portaherramientas	pad
(el)(la) copartícipe	"partner, copartner"
el picotazo	"peck, sting"
(el)(la) concurrente	"person attending, present, attendee"
*** 1431 - 1440 (/course/195613/spanish-nouns-4/144/)	
el galanteador	"philanderer, flatterer"
el arrozal	"ricefield, rice paddy, paddy"
el salteador	"robber, highwayman, bandit"
la alfombrilla	rug
la roya	"rust, blight"
(el)(la) saharaui	Saharan
la sinusoide	"sinusoid, sine curve"
la mofeta	"skunk, polecat, firedamp"
el somnífero	sleeping pill
el sumiller	sommelier
*** 1441 - 1450 (/course/195613/spanish-nouns-4/145/)	
la descarnada	stark
la termita	termite
la talasemia	thalassemia
(el)(la) tradicionalista	traditionalist
la convidada	uninvited
(el)(la) mayorista	"wholesaler, wholesale supplier, distributor"
los zelotes	Zealots
el teleobjetivo	zoom lens
el peluquín	toupee
la escocesa	"Scottish, Scots, Scotch"
*** 1451 - 1460 (/course/195613/spanish-nouns-4/146/)	
la guerrillera	"guerrilla, partisan"
el hospedero	host
la licorería	distillery
el libanés	Lebanese
la luxemburguesa	from Luxembourg
el arrinconamiento	shelving
la autopromoción	self-promotion
la callecita	alley
la cohetería	rocketry
la cortisona	cortisone
*** 1461 - 1470 (/course/195613/spanish-nouns-4/147/)	
la cuestación	"charity collection, appeal"
el deicidio	deicide
la diglosia	diglossia
el duramen	heartwood
el efod	ephod
la fisiografía	physiography
el gouache	gouache
el grafema	grapheme
la hematología	hematology
la hiperglucemia	hyperglycemia
*** 1471 - 1480 (/course/195613/spanish-nouns-4/148/)	
el irredentismo	irredentism
el isquion	ischium
el librepensamiento	freethinking
el muermo	"bore, dump, drip"
el muflón	mouflon
el ñaque	"odds and ends, junk"
el niobio	niobium
el peonaje	peonage
la propiciación	propitiation
el radioisótopo	radioisotope
*** 1481 - 1490 (/course/195613/spanish-nouns-4/149/)	
la razonadora	reasoning
el supresor	suppressor
la taxidermia	taxidermy
la tiamina	thiamine
el yeyuno	jejunum
el pucherazo	"rigging, electoral fiddle"
la trinca	"group of three, set of three, threesome"
la yacija	"rough bed, to sleep badly, grave"
los extraños	alien
el antidepresivo	antidepressant
*** 1491 - 1500 (/course/195613/spanish-nouns-4/150/)	
la changa	"arrangement, odd job, joke"
los bienes	"assets, property, goods"
la rosquilla	"bagel, ring-shaped pastry, donut"
el fanfarrón	"braggart, blusterer, bragging"
el zarzal	bush
la chiquillada	childish
el cortante	"cleaver, chopper"
el cognado	cognate
el contorneado	contoured
el miriñaque	"crinoline, pannier"
*** 1501 - 1510 (/course/195613/spanish-nouns-4/151/)	
el esqueje	"cutting, slip"
el címbalo	cymbal
los dentículos	denticles
los dinoflagelados	dinoflagellates
el disacárido	disaccharide
la destemplanza	distemper
el adarme	dribblet
el faquir	fakir
el batiente	"frame, shoreline"
el testarazo	header
*** 1511 - 1520 (/course/195613/spanish-nouns-4/152/)	
el analfabeto	"illiterate, illiterate person"
(el)(la) desleal	infidel
la intensión	intensity
la lamia	lamia
el nivelador	leveler
la excelsitud	loftiness
el lubricante	lubricant
la madraza	madrassah
el manómetro	"manometer, pressure gauge, gauge"
la fresadora	milling machine
*** 1521 - 1530 (/course/195613/spanish-nouns-4/153/)	
(el)(la) orientalista	orientalist
el alicate	"pliers, clippers"
el refinado	refining
el cazaminas	Sapper
(los)(las) sármatas	Sarmatian
la hilatura	spinning
la salpicadura	"splash, splatter, spatter"
el estreptococo	streptococcus
el tocón	"stump, stub, butt"
los jerséis	sweaters
*** 1531 - 1540 (/course/195613/spanish-nouns-4/154/)	
los alisios	trade
la truculencia	truculence
el violeta	"violet, gentian, gentian violet"
la arandela	"washer, candlestick holder, bobeche"
la atunera	tuna
el convertible	convertible
el cazón	dogfish
la eslovaca	Slovak
el resfrío	"cold, flu"
el vermú	vermouth
*** 1541 - 1550 (/course/195613/spanish-nouns-4/155/)	
el camper	camper
(el)(la) minorista	retailer
el enlazador	linker
el hotelero	hotelier
el aguarrás	turpentine
el almagre	"raddle, red ocher, reddle"
(el)(la) caddie	caddy
la chocolatada	hot chocolate party
el chucrut	sauerkraut
la cóclea	cochlea
*** 1551 - 1560 (/course/195613/spanish-nouns-4/156/)	
el cosmólogo	cosmologist
el desvelamiento	unveiling
el encefalograma	encephalogram
el estridor	stridor
la hidrosfera	hydrosphere
la hidrostática	hydrostatic
el interiorismo	interior design
la lateralidad	laterality
el lenitivo	lenitive
el maracuyá	"passion fruit, passionfruit"
*** 1561 - 1570 (/course/195613/spanish-nouns-4/157/)	
la mayólica	majolica
el muchachote	big boy
la oficiosidad	officiousness
la panela	brown sugar
el periquete	"jiffy, jiff, instant"
el pietismo	pietism
la planimetría	planimetry
el poto	"calabash, earthenware jug"
el puerperio	puerperium
el simón	simon
*** 1571 - 1580 (/course/195613/spanish-nouns-4/158/)	
el sintonizador	tuner
el tantalio	tantalum
la úvula	uvula
la vainillina	vanillin
la zootecnia	husbandry
la garrocha	"goad, spear, vaulting pole"
el viajecito	jaunt
la almenara	beacon
el dedito	"little finger, little toe"
el provincial	provincial
*** 1581 - 1590 (/course/195613/spanish-nouns-4/159/)	
el sarpullido	rash
el donjuán	"womanizer, womaniser, lady-killer"
el trasbordador	"ferry, shuttle, space shuttle"
la chicuela	a slip of a girl
el adúltero	adulterer
el suramericano	american
el róbalo	"bass, sea bass"
la fanfarronada	"bluster, bluff, fanfaronade"
el coñazo	"bore, drudgery, pain in the ass"
la brucelosis	brucellosis
*** 1591 - 1600 (/course/195613/spanish-nouns-4/160/)	
la rabona	camp follower
la cabriola	"caper, skip, prance"
(el)(la) carmelita	Carmelite
la calesita	"carousel, merry-go-round"
el capazo	carrycot
la carúncula	caruncle
la payasada	"charade, clownish trick, buffoonery"
el encubierto	cloaking
el cotillón	"cotillon, cotillion, New Year´s Eve party"
la quebradura	"crack, fissure, rupture"
*** 1601 - 1610 (/course/195613/spanish-nouns-4/161/)	
el cruasán	croissant
el deportado	deportee
la medianera	dividing
el zahorí	dowser
la doxología	doxology
el droguero	druggist
el epígono	epigone
(el)(la) falangista	Falangist
el pepinillo	"gherkin, pickle"
el halconero	"hawker, falconer"
*** 1611 - 1620 (/course/195613/spanish-nouns-4/162/)	
el endecasílabo	hendecasyllable
el historiógrafo	historiographer
la perezosa	"idler, lazybones"
el imponderable	imponderable
los desmesurados	inflated
el foque	jib
la jocosidad	"jocularity, pleasantry"
el corderillo	lambskin
el pernil	"leg, ham, haunch"
el timbrazo	loud ring
*** 1621 - 1630 (/course/195613/spanish-nouns-4/163/)	
el bandazo	"lurch, heeling, roll"
la mantisa	mantissa
el miasma	"miasma, vapour"
el nártex	narthex
la nunciatura	nunciature
el forajido	"outlaw, desperado"
(el)(la) panegirista	panegyrist
el paraboloide	paraboloid
el potenciómetro	potentiometer
el laureado	prizewinner
*** 1631 - 1640 (/course/195613/spanish-nouns-4/164/)	
(el)(la) salmista	psalmist
la purgación	purgation
el romboide	rhomboid
la salina	"saline, salina, salt mine"
el emparedado	"sandwich, butty"
el fregado	"scrub, scouring, scrubbing"
la estremecedora	shocking
el lustrabotas	"shoeshine boy, bootblack, shoeblack"
el chute	"shot, injection"
(el)(la) tizne	smut
*** 1641 - 1650 (/course/195613/spanish-nouns-4/165/)	
la subordinada	"subordinate, underling, ancillary"
el deshollinador	"sweep, chimney sweep"
(el)(la) comprobante	"voucher, receipt, proof"
los loberos	Wolfhounds
la boticaria	"apothecary, druggist"
la ginecóloga	gynecologist
el porcino	"pig, hog"
la rapaza	kid
el sarraceno	Saracen
la vespa	scooter
*** 1651 - 1660 (/course/195613/spanish-nouns-4/166/)	
el patinete	scooter
el aligeramiento	relief
el anquilosamiento	stagnation
la apacibilidad	mildness
la astronáutica	astronautics
el avalúo	"valuation, appraisal"
la biomecánica	biomechanics
la burlona	"joker, scoffer, mockingbird"
el calo	"slang, Romany"
el calostro	colostrum
*** 1661 - 1670 (/course/195613/spanish-nouns-4/167/)	
la carburación	"carburization, carburation"
el chafarote	cutlass
la chispita	sparklet
la compacidad	compactness
el cuarentón	person in their forties
la culinaria	culinary
el cuproníquel	cupro
el destajo	piecework
el diaconado	diaconate
el entreguismo	appeasement
*** 1671 - 1680 (/course/195613/spanish-nouns-4/168/)	
la escalerita	ladder
el frufrú	"rustling, rustle"
la globina	globin
el hiperrealismo	hyperrealism
la isometría	isometry
la marica	"sissy, pansy, milksop"
el matonismo	bullying
el moblaje	furniture
la mojigatería	"sanctimony, prudery, priggishness"
la morisma	Moors
*** 1691 - 1700 (/course/195613/spanish-nouns-4/169/)	
la revalidación	revalidation
la seño	"breast, sinus, sine"
el sismólogo	seismologist
el sobrecogimiento	awe
la sustancialidad	substantiality
la teleconferencia	teleconference
la teletienda	"TV shop, home shopping service"
el triptófano	tryptophan
la vinicultura	viniculture
la visceralidad	visceral
*** 1681 - 1690 (/course/195613/spanish-nouns-4/170/)	
la morriña	"homesickness, nostalgia, murrain"
el negativismo	negativism
el organdí	"organdie, organza, organdy"
el overol	overall
la palinodia	palinode
el partero	accoucheur
el polivinilo	polyvinyl
la precognición	precognition
el rapónchigo	Rapunzel
la reprivatización	reprivatization
*** 1701 - 1710 (/course/195613/spanish-nouns-4/171/)	
el buje	"axle box, bushing"
el pingajo	"rag, shred"
el valedor	"protector, guardian"
la derrochadora	"spendaholic, compulsive spender, spendthrift"
la fruslería	"silly thing, trifle, triviality"
la libranza	order of payment
la monitora	"monitor, instructor, supervisor"
el actuario	actuary
(el)(la) aeta	Aeta
la amiloidosis	amyloidosis
*** 1721 - 1730 (/course/195613/spanish-nouns-4/172/)	
el alcaraván	curlew
el degollador	Cutthroat
el sordomudo	deaf-and-dumb
el decímetro	"decimeter, decimetre"
la diuresis	diuresis
el volcado	"dump, dumping"
(los)(las) ambientalistas	environmentalists
la epacta	epact
el excipiente	excipient
los afrontados	faced
*** 1711 - 1720 (/course/195613/spanish-nouns-4/173/)	
la barracuda	barracuda
el bético	Betis
la boliviana	Bolivian
el loquero	booby hatch
los bronquiolos	bronchioles
el peralte	"camber, bank"
la cista	cist
las clementinas	clementines
los pastorcillos	cowherd
el lisiado	"cripple, disabled person"
*** 1731 - 1740 (/course/195613/spanish-nouns-4/174/)	
el guantelete	gauntlet
el germanismo	Germanism
el ánsar	goose
los jardines	grounds
el almez	hackberry
el haitiano	Haitian
la himalaya	Himalayas
(el)(la) ilusionista	illusionist
la agüita	"infusion, tea"
la intermisión	intermission
*** 1741 - 1750 (/course/195613/spanish-nouns-4/175/)	
el tejano	jeans
el manito	little hand
(los)(las) marianistas	Marianists
el papamoscas	marsh warbler
(el)(la) miope	myopic
el caballejo	nag
la prójima	"neighbor, fellow"
la nefritis	nephritis
(el)(la) nómada	"nomad, wanderer"
el aquilón	north
*** 1751 - 1760 (/course/195613/spanish-nouns-4/176/)	
la nota	"note, notice, footnote"
la organizadora	Organising
el otorrinolaringólogo	otolaryngologist
la afloración	outcrop
los palmares	palm grove
el pelado	"peeling, skinning, shelling"
el pensionado	"pensioner, boarder"
el pilote	"pile, stilt, piling"
el pistolete	pistol
el caniche	poodle
*** 1761 - 1770 (/course/195613/spanish-nouns-4/177/)	
la prostatitis	prostatitis
el purgante	"purgative, purge"
el rodillazo	push with the knee
el cuadrúpedo	quadruped
la reduplicación	reduplication
la recordatoria	reminder
el esquirol	"scab, blackleg, fink"
el patineta	"scooter, kick scooter, skateboard"
el soplón	"snitch, informer, squealer"
el bife	"steak, beefsteak, slap"
*** 1771 - 1780 (/course/195613/spanish-nouns-4/178/)	
la termogénesis	thermogenesis
los trillizos	"triplet, triple"
la tuberosidad	tuberosity
el gallinazo	"turkey buzzard, turkey vulture, buzzard"
(el)(la) unionista	unionist
el carretón	"wagon, cart, bogie"
la mesera	waitress
el calce	"wedge, shim"
el maremágnum	welter
el escogido	"workers' meeting, selection process, selection room"
*** 1781 - 1790 (/course/195613/spanish-nouns-4/179/)	
el géiser	geyser
el minibús	minibus
los defendidos	defence client
el arcedianato	"archdeaconry, archdeaconship, archdeaconate"
el austro	Austro
la barita	baryta
la chamba	"fluke, pure chance, occupation"
la cloración	chlorination
el clóset	"closet, wardrobe"
el craqueo	cracking
*** 1791 - 1800 (/course/195613/spanish-nouns-4/180/)	
la cumplidora	dutiful
el eliseo	"Elysium, elisha"
la epinefrina	epinephrine
la excisión	excision
la floculación	flocculation
el gamberrismo	"hooliganism, rowdyism"
la guipuzcoana	Guipuzcoa
el haluro	halide
la imperturbabilidad	imperturbability
la inspiradora	inspirator
*** 1811 - 1820 (/course/195613/spanish-nouns-4/181/)	
el planetoide	planetoid
la risilla	giggle
la sagita	sagittal
la sobreprotección	overprotection
la tapioca	"tapioca, cassava"
el tipismo	"local colour, picturesque, traditionalism"
(el)(la) trombonista	trombonist
la turmalina	tourmaline
los ravioles	ravioli
el apadrinamiento	sponsorship
*** 1821 - 1830 (/course/195613/spanish-nouns-4/182/)	
la retadora	challenger
el depravado	degenerate
la acémila	"beast of burden, mule, thick-headed person"
la bobería	"silliness, idiocy"
la hormiguita	busy bee
el áloe	"aloe, aloes"
el antiséptico	antiseptic
el beduino	Bedouin
(el)(la) bengalí	Bengali
(el)(la) mandamás	"big shot, top dog"
*** 1801 - 1810 (/course/195613/spanish-nouns-4/183/)	
el kantismo	Kantianism
la listeza	"cleverness, gumption"
el lumbago	lumbago
la manejabilidad	manageability
el narcoterrorismo	narco
la neuropsicología	neuropsychology
la niacina	niacin
el oncogén	oncogene
el pantógrafo	pantograph
la papiroflexia	origami
*** 1831 - 1840 (/course/195613/spanish-nouns-4/184/)	
el farolero	bluffer
el bichito	bug
la hornilla	"burner, ring, hob"
la palmeta	"cane, caning"
el cañuto	canute
el caribú	caribou
la chavala	"chick, lass"
la china	"china, guessing game using pebbles, porcelain"
el teñido	"colouring, coloring, dyeing"
el concentrado	"concentrate, extract, concentration"
*** 1841 - 1850 (/course/195613/spanish-nouns-4/185/)	
el amigote	"crony, pal, chum"
el detractor	detractor
la esforzada	effortful
la estilográfica	fountain pen
el churro	"fritter, churro, doughnut"
el duendecillo	"gremlin, elfin"
la gualdrapa	horse blanket
el chusco	"hunk of bread, crust"
el estúpido	idiot
la inexperta	inexperienced
*** 1851 - 1860 (/course/195613/spanish-nouns-4/186/)	
el inyector	"injector, nozzle"
el marbete	"label, tag"
la ligada	linked
la lobotomía	lobotomy
el somier	mattress base
el moca	mocha
el abdías	obadiah
la turbera	peatbog
los pedipalpos	pedipalps
el poderoso	"person in power, powerful person"
*** 1861 - 1870 (/course/195613/spanish-nouns-4/187/)	
el trazador	"plotter, tracer"
la neumonitis	pneumonitis
los presbiterianos	Presbyterians
(el)(la) regionalista	regionalist
la rotativa	"rotary press, press"
el autoanálisis	self-analysis
el espádice	spadix
la hambrienta	starveling
(el)(la) tecnócrata	technocrat
la tenca	tench
*** 1871 - 1880 (/course/195613/spanish-nouns-4/188/)	
el caco	"thief, burglar"
el trapezoide	trapezoid
el trillón	"trillion, quintillion"
el sinsabor	trouble
(el)(la) valencianista	Valencia
la vicisitud	"vicissitude, avatar, difficulty"
la curruca	warbler
el picamaderos	woodpecker
la quásar	quasar
la panadera	baker
*** 1881 - 1890 (/course/195613/spanish-nouns-4/189/)	
la mecanógrafa	typist
el ohm	ohm
el lebrel	hound
la tintorera	shark
la tocaya	namesake
la matraca	rattle
la celdilla	cell
la paraplejia	paraplegia
el visigodo	Visigoth
el afinamiento	fine tuning
*** 1891 - 1900 (/course/195613/spanish-nouns-4/190/)	
el americio	americium
(el)(la) ascensorista	elevator
el cesarismo	Caesarism
la chuta	"needle, works"
la dentífrica	dentifrice
la despresurización	depressurization
el ecónomo	trustee
el eglefino	haddock
el ensalzamiento	exaltation
el escolio	scholium
*** 1911 - 1920 (/course/195613/spanish-nouns-4/191/)	
el nucléolo	nucleolus
la particularización	particularization
la pavura	struck terror
el pinole	pinole
la prednisona	prednisone
el providencialismo	providentialism
el rafe	raphe
el ritualismo	ritualism
el rosco	"biscuit, bread-roll, doughnut"
el secesionismo	secessionism
*** 1901 - 1910 (/course/195613/spanish-nouns-4/192/)	
el espato	spar
la ictiología	ichthyology
el jacarandá	jacaranda
la ludopatía	gambling
la maltosa	maltose
el mayoreo	wholesale
la melatonina	melatonin
la nema	Nema
el neonato	neonate
el neurobiólogo	neurobiologist
*** 1921 - 1930 (/course/195613/spanish-nouns-4/193/)	
la sobreexposición	overexposure
la tembladera	scrapie
el transceptor	transceiver
la transigencia	compromise
el triodo	triode
el vendimiario	vendémiaire
el porteador	"porter, bearer, carrier"
el talabartero	"saddler, harness maker"
el pastelillo	"small cake, tart"
el taray	tamarisk
*** 1931 - 1940 (/course/195613/spanish-nouns-4/194/)	
la dispensadora	dispensing
el antiinflamatorio	antiinflammatory
el violón	"bass, double bass"
las benzodiazepinas	benzodiazepines
el apostador	bettor
el bilbaíno	Bilbao
la borraja	"borage, starflower, Borago officinalis"
los britanos	Britons
el abombamiento	bulge
el marimacho	"butch, hoyden"
*** 1941 - 1950 (/course/195613/spanish-nouns-4/195/)	
el ratonero	buzzard
el quilate	"carat, karat"
los cofactores	cofactors
el colirio	"collyrium, eye drops, eyewash"
la concusión	"concussion, extortion"
(el)(la) polizonte	"cop, copper"
la crepitación	"crepitation, roar, crackle"
la autoescuela	driving school
la disartria	dysarthria
la elaboradora	Elaboration
*** 1951 - 1960 (/course/195613/spanish-nouns-4/196/)	
el fijador	"fixer, fixative, gel"
la oropéndola	golden oriole
la torva	grim
el grog	grog
la rayita	hairline
la taracea	inlay
la chirigota	"joke, fun, chirigota"
la personita	little person
el malvavisco	"marshmallow, Althaea officinalis"
la albóndiga	"meatball, ball"
*** 1971 - 1980 (/course/195613/spanish-nouns-4/197/)	
la baca	"roof, rack, top"
la escarlata	scarlet
el lavador	scrubber
las ñas	sized
(el)(la) bolsista	stockbroker
la azucarera	sugar bowl
el tebano	Theban
la tibia	"tibia, shinbone"
el dobladillo	"turn-up, cuff"
la perinola	whirligig
*** 1981 - 1990 (/course/195613/spanish-nouns-4/198/)	
la alemána	German
la cantinera	"barman, sutler"
el chupo	"furuncle, boil, carbuncle"
la examinadora	examiner
la contrafigura	counterpart
el orfelinato	orphanage
el boyardo	boyar
la aguanieve	sleet
el cornudo	cuckold
el sexólogo	sexologist
*** 1961 - 1970 (/course/195613/spanish-nouns-4/199/)	
los oculares	ocular
(el)(la) telefonista	"operator, telephonist"
las pares	"par, couple, pair"
la filia	philia
el reservado	"private room, private booth"
la prestadora	provider
la psicopatía	psychopathy
la radioemisora	radiostation
la maraca	"rattle, maraca"
la menguada	reduced
*** 1991 - 2000 (/course/195613/spanish-nouns-4/200/)	
el acilo	acyl
el addenda	addendum
el aflojamiento	"relaxation, release"
el amamantamiento	breast-feeding
la ambliopía	amblyopia
el anabolismo	anabolism
la bisectriz	"bisector, bisectrix"
el brahmanismo	Brahmanism
(el)(la) chaveta	"key, pin, cotter"
la coedición	coedition
*** 2001 - 2010 (/course/195613/spanish-nouns-4/201/)	
el crup	croup
la dulcería	confectionery store
la eclampsia	eclampsia
el etólogo	ethologist
el indiferentismo	indifference
el iterbio	ytterbium
la marijuana	"marijuana, cannabis, pot"
la masilla	"putty, filler"
el moquillo	"distemper, pip"
la musiquilla	tune
*** 2011 - 2020 (/course/195613/spanish-nouns-4/202/)	
la panga	"canoe, barge"
el pateo	boo
la picea	spruce
la piedrita	"rock, stone, hailstone"
la sepiolita	sepiolite
el septeto	"septet, septette"
la cachucha	cap
la instigadora	instigator
(el)(la) orate	"lunatic, bonkers"
la anfibología	amphibology
*** 2021 - 2030 (/course/195613/spanish-nouns-4/203/)	
el arabesco	arabesque
el áureo	aureus
la balalaica	balalaika
el balaustre	"baluster, banister"
la pelotita	beanbag
la cabrona	bitch
el santísimo	Blessed
los direccionales	blinker
el carozo	carp
la canana	cartridge belt
*** 2031 - 2040 (/course/195613/spanish-nouns-4/204/)	
el cafetal	coffee plantation
la contramarcha	countermarch
la dalia	dahlia
el deflector	"deflector, baffle, baffle plate"
los alteradores	disrupters
la rencilla	fight
el calvero	glade
el colmado	"grocer's shop, grocery store, bodega"
la lechada	"grout, whitewash"
el gacetillero	"hack, paragrapher, paragraphist"
*** 2041 - 2050 (/course/195613/spanish-nouns-4/205/)	
el almiar	"hayrick, stack, haystack"
el escaramujo	"hip, rose hip, wild rose"
los acaparadores	hoarders
el mesonero	"host, innkeeper, landlord"
la matadora	"killer, matador"
la falencia	"lack, thing lacking, bankruptcy"
el pintalabios	lipstick
la litiasis	lithiasis
el pegote	"mass, blotch, blob"
las autocaravanas	"mobile home, camper"
*** 2051 - 2060 (/course/195613/spanish-nouns-4/206/)	
(el)(la) monopolista	monopolist
la midriasis	mydriasis
el billetero	notecase
el guarismo	numeral
el solterón	"old bachelor, bachelor, confirmed bachelor"
la osteomielitis	osteomyelitis
el anorak	"parka, anorak"
el recogedor	"picker, dustpan, scoop"
el encharcamiento	ponding
los póngidos	pongids
*** 2121 - 2130 (/course/195613/spanish-nouns-4/207/)	
la recalada	landfall
la ridiculización	"ridicule, mockery"
la riolita	rhyolite
el satín	"satin, satinwood"
el semitismo	Semitism
el substantivo	noun
el subtexto	subtext
el superíndice	superscript
el talio	thallium
la tanqueta	tanker
*** 2061 - 2070 (/course/195613/spanish-nouns-4/208/)	
el poni	pony
el publicador	Publisher
la cuáquera	Quakeress
el replicador	replicator
(el)(la) secante	"secant, drying, siccative"
el torpedero	shortstop
la sentada	"sitting, sit-in"
el hollejo	"skin, husk"
el apilamiento	stacking
la estirada	"stretch, full length save, dive"
*** 2071 - 2080 (/course/195613/spanish-nouns-4/209/)	
los bastarnos	suffice
el superlativo	superlative
la sobrepelliz	surplice
el hojalatero	tinsmith
el desocupado	unemployed person
el lavamanos	washbasin
la escrita	writing
el azimut	azimuth
el cobaya	guinea pig
el mondadientes	toothpick
*** 2081 - 2090 (/course/195613/spanish-nouns-4/210/)	
la civeta	civet
el bizantino	Byzantine
el perpetrador	perpetrator
la loncha	slice
el escotillón	trap door
la aducción	adduction
la amarillez	yellowness
el anaranjado	orange color
el ayunador	hunger artist
el biotipo	biotype
*** 2091 - 2100 (/course/195613/spanish-nouns-4/211/)	
el cabestrante	winch
el calzador	shoehorn
el campanilleo	"ringing, tinkling, tinkle"
el chumbo	pear
el cínife	gadfly
la cordobesa	Cordoba
la curtiduría	tannery
la dataría	would date
el dativo	dative
la destructividad	destructiveness
*** 2101 - 2110 (/course/195613/spanish-nouns-4/212/)	
la edafología	"edaphology, pedology"
la efusividad	effusivity
el enrollamiento	curl
la esparcidora	spreaders
el fibrinógeno	fibrinogen
la fumada	drag
el hafnio	hafnium
el hipérbaton	hyperbaton
la hiperventilación	hyperventilation
el iconostasio	iconostasis
*** 2111 - 2120 (/course/195613/spanish-nouns-4/213/)	
la instantaneidad	instantaneity
la isotropía	isotropy
el lulú	Lulu
la marcialidad	martial
el monorraíl	monorail
el neorromanticismo	neoromanticism
el obstat	nulla
el pestañeo	blinking
la piquera	"hole, vent"
la procuración	"proxy, procuration"
*** 2131 - 2140 (/course/195613/spanish-nouns-4/214/)	
el tecnicolor	Technicolor
el teósofo	Theosophist
la totalización	totalization
la virología	virology
la volatería	poultry
la yola	yawl
el burgalés	from Burgos
el coturno	"buskin, cothumus"
la potranca	"filly, young mare"
la aspillera	loophole
*** 2151 - 2160 (/course/195613/spanish-nouns-4/215/)	
la lazada	"bow, bowknot"
los corredores	Brokers
el circunloquio	circumlocution
la trepanación	clambering
el envuelto	cocoon
el roquedo	crag
la cretona	cretonne
el equino	"equine, echinus"
el etmoides	ethmoid
el comedero	"feeder, trough"
*** 2141 - 2150 (/course/195613/spanish-nouns-4/216/)	
la gamberrada	"piece of hooliganism, loutish thing"
el batidor	"scout, gold beater, informer"
el coletazo	"blow or thrash or swipe of the tail, swaying movement"
(el)(la) trapecista	"aerialist, trapeze artist"
la angélica	angelica
el antónimo	"antonym, opposite"
la bayeta	"baize, dishcloth, duster"
el percebe	"barnacle, goose barnacle"
el campanillazo	bells ringing
la bocaza	"bigmouth, loudmouth"
*** 2161 - 2170 (/course/195613/spanish-nouns-4/217/)	
la quintilla	five-line stanza
el ijar	flank
el volador	"flying, flying fish, jumbo flying squid"
el cantador	"folksinger, chorister"
el gondolero	gondolier
el verde	"green, greenback, buck"
el hit	hit
el avispón	hornet
la planchadora	ironer
la francachela	jamboree
*** 2171 - 2180 (/course/195613/spanish-nouns-4/218/)	
el chascarrillo	joke
la lasaña	lasagne
la pernera	"leg, trouser leg"
los marcomanos	Marcomanni
el sollado	mess-deck
el berenjenal	"mess, trouble, aubergine field"
la meticulosa	meticulous
el nidal	"nest, haunt"
la feromona	pheromone
el cortinón	portiere
*** 2181 - 2190 (/course/195613/spanish-nouns-4/219/)	
la lindeza	prettiness
el rododendro	rhododendron
el arenero	sandbox
la burrada	"shitload, herd of donkeys, gross error"
las carnestolendas	Shrovetide
el silenciador	"silencer, muffler"
(el)(la) esclavista	slave holder
el ahumado	"smoking, curing"
el estafilococo	staphylococcus
la sinalefa	synalepha
*** 2191 - 2200 (/course/195613/spanish-nouns-4/220/)	
el tesauro	thesaurus
el díscolo	"tight-fisted sod, stingy bugger, tightwad"
la ondina	Undine
el acomodador	"usher, attendant"
el mirón	"voyeur, peeper, onlooker"
el calzonazos	"wimp, wuss, henpecked husband"
el palurdo	"yokel, hick"
la bienaventurada	blessed
la entrevistadora	interviewer
el folclórico	folk
*** 2201 - 2210 (/course/195613/spanish-nouns-4/221/)	
el hiperenlace	hyperlink
el parteluz	mullion
el pandemónium	pandemonium
la mosquitera	mosquito
la pavesa	ember
el tailandés	Thai
el uruguayo	Uruguayan
el abulón	abalone
la alanina	alanine
el avenimiento	"compromise, agreement"
*** 2211 - 2220 (/course/195613/spanish-nouns-4/222/)	
el blancor	whiteness
la bronconeumonía	bronchopneumonia
el calcáneo	calcaneus
la carrerilla	"quick step, musical octave, run"
la compaginación	collating
la conejita	bunny
el cornezuelo	ergot
el descifre	decipherment
el deservicio	disservice
el deslizador	"speedboat, powerboat, slider"
*** 2221 - 2230 (/course/195613/spanish-nouns-4/223/)	
la desmemoria	forgetfulness
el ensayador	tester
la esplenomegalia	splenomegaly
la estanflación	stagflation
el estator	stator
el gatopardo	Leopard
el hipocentro	hypocenter
la informadora	reporting
la intercambiabilidad	interchangeability
el invernáculo	hothouse
*** 2231 - 2240 (/course/195613/spanish-nouns-4/224/)	
la iracundia	ire
la isomería	isomerism
la microelectrónica	microelectronics
el montanismo	"mountaineering, climbing"
la panificación	bread
el papamóvil	popemobile
el paralogismo	paralogism
la polonesa	polonaise
el prendedor	brooch
la preterición	"pretermission, preterition"
*** 2241 - 2250 (/course/195613/spanish-nouns-4/225/)	
la ritualización	ritualization
el sidecar	sidecar
el siroco	sirocco
la subalimentación	underfeeding
la testificación	witness
el tiranicidio	tyrannicide
el toronjil	melissa
la trompetería	trumpets
el vaporizador	"vaporizer, atomizer"
el conglomerante	conglomerate
*** 2251 - 2260 (/course/195613/spanish-nouns-4/226/)	
la lezna	awl
el mojinete	"ridge, tiling, coping"
el ayudador	helper
(el)(la) urbanista	urban planner
la recaudadora	"tax office, IRS"
la trompetilla	ear trumpet
la toxicomanía	drug-addiction
el redoblante	snare drum
la alcalosis	alkalosis
(el)(la) altruista	altruist
*** 2261 - 2270 (/course/195613/spanish-nouns-4/227/)	
la anastomosis	anastomosis
(el)(la) apologista	apologist
la agresora	"attacker, aggressor, assailant"
el abejaruco	bee-eater
el blastocito	blastocyst
el blanqueador	"bleach, bleacher"
el desenfoque	blur
el localizador	booking reference
la callada	brush-off
la constructora	"builder, maker, building company"
*** 2271 - 2280 (/course/195613/spanish-nouns-4/228/)	
el anacardo	cashew
los sabañones	chilblains
la contorsión	"contortion, twist"
la floritura	"curlicue, flourish"
la dendrita	dendrite
el baratillo	dime store
el vahído	"dizzy turn, dizzy spell, black-out"
la embutición	drawing
el automotor	electric train
el electrodoméstico	"electrical appliance, white goods"
*** 2281 - 2290 (/course/195613/spanish-nouns-4/229/)	
la epiglotis	epiglottis
la épsilon	epsilon
la lipotimia	"fainting, fainting fit"
los sentires	feelings
el funky	"funky, funk"
la mueblería	"furniture shop, furniture store, furniture factory"
la galopada	"gallop, gallopade"
la gavota	gavotte
la genista	genista
el agarrón	grab
*** 2291 - 2300 (/course/195613/spanish-nouns-4/230/)	
el hierofante	hierophant
la imitadora	"impersonator, imitator, mimic"
el indonesio	Indonesian
el interpretador	interpreter
el lagunar	lagoon
la avefría	"lapwing, peewit, pewit"
el bogavante	lobster
el madrileño	Madrilenian
el monosílabo	monosyllable
la mialgia	myalgia
*** 2301 - 2310 (/course/195613/spanish-nouns-4/231/)	
la ñoña	"ninth, shit"
los descolgados	off the hook
el analgésico	"painkiller, analgesic"
la parestesia	paresthesia
el parasismo	paroxysm
las petequias	petechiae
el divulgador	popularizer
(el)(la) positivista	positivist
el posesivo	possessive
el prebendado	"prebendary, prebend"
*** 2311 - 2320 (/course/195613/spanish-nouns-4/232/)	
la prolepsis	prolepsis
el protonotario	"protonotary, prothonotary"
la reservación	"reservation, booking"
el aclarado	"rinse, rinse cycle, rinsing"
la sacramental	sacramental
la ensaladilla	salad
la paletada	shovelful
la trompada	"slap, blow, punch"
el chivato	sneak
los solípedos	solipeds
*** 2321 - 2330 (/course/195613/spanish-nouns-4/233/)	
la espinela	spinel
el espondeo	spondee
los acerados	steely
las zancas	stringer
el sinóptico	synoptics
la chufa	tiger nut
la triquiñuela	"trick, dodge"
el toscano	Tuscan
el estafermo	"twit, quintain"
el desvalido	underdog
*** 2331 - 2340 (/course/195613/spanish-nouns-4/234/)	
la ampolleta	"vial, sand timer, hourglass"
el andador	"walker, walkway"
el silbador	whistler
el zirconio	zirconium
la destructora	destroyer
el gablete	"gable, gable end"
la recolectora	picker
el efectismo	sensationalism
el vinicultor	winegrower
el ecólogo	ecologist
*** 2341 - 2350 (/course/195613/spanish-nouns-4/235/)	
el adulador	"flatterer, bootlicker"
la hemiplejía	hemiplegia
la mariguana	marijuana
el salmantino	from Salamanca
el acristalamiento	glazing
(el)(la) aimara	Aymara
la angulación	angulation
la anhidrita	anhydrite
la animalización	animalization
la aprendiza	"trainee, apprentice, learner"
*** 2391 - 2400 (/course/195613/spanish-nouns-4/236/)	
el remendón	"cobbler, tinker"
el rutilo	rutile
la saponificación	saponification
la satanización	demonization
la serología	serology
la sirga	towpath
el snooker	snooker
el tamboreo	drumming
el tapeo	tapas
el valentón	bully
*** 2421 - 2430 (/course/195613/spanish-nouns-4/237/)	
el trinchante	"carver, carving knife"
el castañeteo	"chatter, rattle"
la cunita	cradle
el torvisco	daphne
la diáfisis	diaphysis
la endecha	dirge
la desemejanza	dissimilarity
el perrero	dog fancier
el muñequito	doll
el afeminado	"effeminate, sissy"
*** 2361 - 2370 (/course/195613/spanish-nouns-4/238/)	
el coquito	nutsedge
la cronicidad	chronicity
el dáctilo	dactyl
la deceleración	deceleration
el derrick	derrick
la diarquía	diarchy
el ferromagnetismo	ferromagnetism
la gammagrafía	scintigraphy
la geriatría	geriatrics
el gobernalle	rudder
*** 2351 - 2360 (/course/195613/spanish-nouns-4/239/)	
la autoinducción	autoinduction
el baldeo	flushing
el berbiquí	"brace, bitbrace"
el blazer	blazer
la calcedonia	chalcedony
el calé	gypsy
el cañamazo	embroidery canvas
la catatonía	catatonia
la chirona	"pen, jug, nick"
la contraguerrilla	counterinsurgency
*** 2381 - 2390 (/course/195613/spanish-nouns-4/240/)	
la micología	mycology
la náutica	art of navigation
el orillo	"selvage, selvedge"
la osteopatía	osteopathy
el panizo	panic grass
la pardela	shearwater
el politburó	it politburo
la psicometría	psychometry
la punición	punishment
el relumbrón	"flash, trumpery"
*** 2401 - 2410 (/course/195613/spanish-nouns-4/241/)	
la lechuguilla	"frill, flounce, ruff"
la silleta	"small chair, seat, chair"
el herrerillo	tit
el torcedor	"spindle, torment, torture"
la pájara	"hen, hen bird, sneaky bitch"
el secadero	"drying place, dry plain, scrubland"
la azuela	"adz, adze"
la acordada	agreed
el ápex	apex
el correccional	approved school
*** 2371 - 2380 (/course/195613/spanish-nouns-4/242/)	
la hebe	Hebe
la hermeticidad	tightness
la heurística	heuristic
el hilio	hilum
la hiperemia	hyperemia
el hipertiroidismo	hyperthyroidism
la imprescriptibilidad	applicability
la indemnidad	indemnity
la leucorrea	leukorrhea
la lidocaína	lidocaine
*** 2411 - 2420 (/course/195613/spanish-nouns-4/243/)	
el argonauta	Argonaut
la bombacha	"baggy trousers, baggy pants, panties"
la bergamota	bergamot
el carnal	"brother, friend, pal"
el brocha	"brush, paintbrush, hanger-on"
la amurada	bulwark
la bursitis	bursitis
el cánido	canid
la cantárida	"cantharides, blister beetle"
(los)(las) cartaginenses	Carthaginians
*** 2451 - 2460 (/course/195613/spanish-nouns-4/244/)	
el piyama	pajamas
la paronomasia	paronomasia
la parotiditis	parotitis
(el)(la) partícipe	"participant, sharer, part"
la botana	"patch, plug, stopple"
el ordenante	payer
el plexiglás	"plexiglas, plexiglass, perspex"
la polaroid	Polaroid
(el)(la) pragmatista	pragmatist
los procariontes	prokaryotes
*** 2431 - 2440 (/course/195613/spanish-nouns-4/245/)	
el triturador	"garbage disposal unit, waste disposal unit"
la dorada	gilt head bream
la cacha	"handle, cheek"
el barbijo	headscarf
el berrido	howl
la infractora	infringing
la interventora	intervener
la burra	"jenny, female donkey, she-donkey"
el pelmazo	"jerk, bore, nuisance"
la barreta	jimmy
*** 2441 - 2450 (/course/195613/spanish-nouns-4/246/)	
el merecido	just deserts
la mocita	lass
la lila	"lilac, gay"
(el)(la) marsupial	marsupial
la habladuría	"nasty remark, scuttlebutt"
el obligado	"obbligato, prominent instrumental part"
(el)(la) oferente	offerer
el marginado	"outcast, dropout, outsider"
el oviducto	oviduct
el amo	owner
*** 2461 - 2470 (/course/195613/spanish-nouns-4/247/)	
el pegador	"puncher, glue"
la ajusticiada	put to death
el chanchullo	"racket, fiddle, scam"
(el)(la) replicante	replicant
la hendedura	"rift, slit, cleft"
(el)(la) imperial	"roof, top"
el bendito	"saint, simpleton"
el zapador	"sapper, pioneer"
el montado	small sandwich
el salivazo	spittlebug
*** 2481 - 2490 (/course/195613/spanish-nouns-4/248/)	
la videocasete	videocassette
el muñidor	ward-heeler
la tejeduría	weaving
(el)(la) justificante	"written proof, receipt, proof"
la hilaza	yarn
el contraveneno	antidote
la avara	"miser, tightwad"
la mezcladora	mixer
el ohmio	ohm
el postparto	postpartum
*** 2471 - 2480 (/course/195613/spanish-nouns-4/249/)	
el partidor	splitter
el supositorio	"suppository, cock, dick"
los treses	threes
el hachón	"torch, flambeau"
la domadora	"trainer, tamer, ringmaster"
la charola	tray
el triduo	triduum
el bombillo	"U-bend, trap, cylinder"
la versta	verst
la veza	vetch
*** 2491 - 2500 (/course/195613/spanish-nouns-4/250/)	
la sexóloga	sexologist
(el)(la) pakistaní	Pakistani
el segoviano	Segovia
el abundamiento	"abundance, plenty"
la acefalía	acephalia
el aerógrafo	"airbrush, aerograph"
la angiografía	angiography
la angora	angora
el apocamiento	bashfulness
el arao	guillemot
*** 2511 - 2520 (/course/195613/spanish-nouns-4/251/)	
la compunción	compunction
la copresidenta	Co-Chair
la cordada	roped
la embaucadora	trickster
el enajenamiento	alienation
la encamisada	jacketed
la estreptomicina	streptomycin
la fabada	"fabada, fabada asturiana"
el facilitador	facilitator
la galvanoplastia	electroplating
*** 2541 - 2550 (/course/195613/spanish-nouns-4/252/)	
el superagente	super agent
el tartán	"tartan, plaid, Tartan"
la tatarabuela	great-great-grandmother
la tenuidad	"tenuity, slenderness, feebleness"
el termoplástico	thermoplastic
el trimarán	trimaran
la usurera	"loan shark, usurer, shylock"
la verificabilidad	verifiability
el vitae	vita
el volantazo	swerve
*** 2501 - 2510 (/course/195613/spanish-nouns-4/253/)	
la astenosfera	asthenosphere
la azitromicina	azithromycin
la bentonita	bentonite
la bioingeniería	bioengineering
la calderería	boiler
el chapuz	"duck, plunge, ducking"
el cheddar	Cheddar
el chiísmo	Shiism
la comisionada	Commissioner
la compulsa	attested copy
*** 2521 - 2530 (/course/195613/spanish-nouns-4/254/)	
la guajira	"guajira, Cuban folksong"
el hegelianismo	Hegelianism
la indestructibilidad	indestructibility
la inmunoterapia	immunotherapy
la insipidez	"tastelessness, tameness, insipidness"
la leontina	fob
el llavín	latchkey
la maicena	"cornstarch, cornflour"
la malaventura	misadventure
el neurofisiólogo	neurophysiologist
*** 2531 - 2540 (/course/195613/spanish-nouns-4/255/)	
la onagra	evening primrose
la paleogeografía	"palaeogeography, paleogeography"
la pastorela	pastourelle
la perpendicularidad	perpendicularity
(el)(la) pertiguista	pole vaulter
la psicolingüística	psycholinguistics
el remozamiento	renovation
la retranca	breeching
el sarro	"scale, tartar, fur"
la somatotropina	somatotropin
*** 2561 - 2570 (/course/195613/spanish-nouns-4/256/)	
el aloe	"aloes, aloe"
los archeros	archers
la aspergilosis	aspergillosis
el bávaro	Bavarian
la cubrecama	bedspread
el primerizo	beginner
el machetazo	"blow with a machete, slash with a machete, knife-wound"
(el)(la) valiente	"brave, valiant, brave man"
la británica	Briton
el baldaquín	"canopy, baldachin"
*** 2551 - 2560 (/course/195613/spanish-nouns-4/257/)	
el capacete	hardhat
(el)(la) invidente	blind
el rapapolvo	"telling-off, talking-to, ticking off"
el tullido	cripple
la desgarradora	heartbreaking
el plenipotenciario	plenipotentiary
el apuntalamiento	"propping-up, underpinning"
(el)(la) conferencista	"lecturer, speaker, attendee"
el cachorrillo	pup
el sacador	server
*** 2571 - 2580 (/course/195613/spanish-nouns-4/258/)	
el pitufo	"career politician, policeman"
el cartulario	cartulary
la cauterización	"cauterization, cautery"
los censales	census
la chequera	"cheque book, check book, cheque book wallet"
el comedio	Comedio
el urinario	"comfort station, urinal, public lavatory"
el consignatario	consignee
el portacontenedores	container
(el)(la) contratante	"contractor, contracting party"
*** 2581 - 2590 (/course/195613/spanish-nouns-4/259/)	
el criptograma	cryptogram
el difusor	diffuser
la charretera	"epaulette, epaulet"
el floreo	flourish
la arrebolada	flushed
el apuntamiento	fussiness
el gaje	"gauge, perk, gage"
(el)(la) geómetra	"geometrician, geometer"
el geriátrico	geriatric
la estría	"groove, score, flute"
*** 2601 - 2610 (/course/195613/spanish-nouns-4/260/)	
la macromolécula	macromolecule
la menina	"maid of honour UK, maid of honor US, young lady-in-waiting"
(los)(las) masagetas	Massagetae
el entrepiso	"mezzanine, loft"
(el)(la) modernista	modernist
la nebulosidad	"nebulosity, fogginess"
el negrillo	Negrillo
(el)(la) caradura	"nerve, cheek, face"
la neurotoxina	neurotoxin
el ordinario	ordinary
*** 2591 - 2600 (/course/195613/spanish-nouns-4/261/)	
el grotesco	grotesque
el jaique	haik
la ilustrada	illustrated
la siempreviva	immortelle
el junquillo	"jonquil, bead, baguette"
la cetoacidosis	ketoacidosis
el linier	linesman
el altoparlante	loudspeaker
el chichón	"lump, bump, swelling"
el altramuz	Lupin
*** 2611 - 2620 (/course/195613/spanish-nouns-4/262/)	
el práctico	pilot
el prevaricador	prevaricator
(el)(la) psicoterapeuta	psychotherapist
el ranchero	"rancher, estate car, station wagon"
la superfluidad	"redundancy, superfluity"
el avivamiento	revival
el roquete	rochet
la frotación	rub
el septenario	septenary
el engaste	"setting, mount, mounting"
*** 2621 - 2630 (/course/195613/spanish-nouns-4/263/)	
la pacotilla	"shoddy, rubbish, trash"
las cuclillas	squatting
el taquígrafo	"stenographer, shorthand writer"
el espesante	thickener
el tique	"ticket, voucher, coupon"
el tiralíneas	tracer
la baratija	"trinket, knick-knack, bric-a-brac"
el uréter	ureter
la vampiresa	vamp
la roncha	"weal, welt"
*** 2631 - 2640 (/course/195613/spanish-nouns-4/264/)	
la argelina	Algerian
(el)(la) campista	camper
la canaria	canary
la controladora	controller
la cortadora	cutter
la desarrolladora	developer
las egipcias	Egyptian
la electora	"elector, constituent"
la estoica	stoic
la hospedadora	host
*** 2641 - 2650 (/course/195613/spanish-nouns-4/265/)	
la impostora	"impostor, sham"
la limeña	Lima person
la lituana	Lithuanian
la mocosa	"brat, punk"
la pagana	"heathen, pagan"
el roto	"tear, rip"
la tailandesa	Thai
el lucernario	skylight
el tañedor	minstrel
el portabrocas	chuck
*** 2661 - 2670 (/course/195613/spanish-nouns-4/266/)	
el cateterismo	catheterization
el cerbero	Cerberus
el chupito	shot (alcohol)
la denudación	denudation
el desiderátum	desideratum
el devanagari	Devanagari
el difosfato	diphosphate
(el)(la) elitista	elitist
el empalamiento	impalement
el endoesqueleto	endoskeleton
*** 2651 - 2660 (/course/195613/spanish-nouns-4/267/)	
el saboteador	saboteur
el tecnólogo	technologist
el almete	Shadowcraft Cap
el amaranto	amaranth
el amontillado	amontillado
el aparatito	gizmo
el aragonito	aragonite
la arboricultura	arboriculture
el blanqueamiento	whitening
el bruxismo	bruxism
*** 2671 - 2680 (/course/195613/spanish-nouns-4/268/)	
el ennegrecimiento	blackening
el esaú	Esau
la escancia	pours
la escarda	spud
el espéculo	speculum
la exultación	"exultation, exultancy"
la gazmoñería	"prudery, prudishness"
el geniecillo	genie
el gravitón	graviton
la grisalla	grisaille
*** 2691 - 2700 (/course/195613/spanish-nouns-4/269/)	
el odeón	Odeon
el pipí	"pee, piss, peepee"
la plegadera	paper folder
la plomería	plumbing
la porfiria	porphyria
la procaína	procain
la procreadora	procreative
la rafia	"raffia, raffia palm, raffia fibre US"
el regatón	"tip, ferrule, haggler"
la registración	enrollment
*** 2681 - 2690 (/course/195613/spanish-nouns-4/270/)	
la hidrodinámica	hydrodynamic
el hipogrifo	hippogriff
la inalienabilidad	inalienability
la infatuación	"infatuation, conceit, crush"
la intercesora	intercessory
la librera	bookshop
la litispendencia	lis pendens
la logopedia	speech
el mesenterio	mesentery
la nefrología	nephrology
*** 2711 - 2720 (/course/195613/spanish-nouns-4/271/)	
el zascandil	"busybody, featherbrained person"
la almadía	raft
el auditivo	receiver
el niquelado	nickel plating
la hortera	"a person with vulgar taste, a pretentious person"
la candelilla	"aglet, aiglet"
el anón	anon
(el)(la) arabista	Arabist
la chuchería	"bauble, trinket, candy"
el contemplador	beholder
*** 2701 - 2710 (/course/195613/spanish-nouns-4/272/)	
la reluctancia	reluctance
la reseda	"reseda, mignonette"
el salpicón	"seafood salad, splash, dash"
el sari	sari
el sibaritismo	sybaritism
el sismógrafo	seismograph
la sobretasa	"surcharge, surtax, levy"
el sumador	adder
el tarjetón	Cards
el xileno	xylene
*** 2721 - 2730 (/course/195613/spanish-nouns-4/273/)	
la bucólica	bucolic
el calculador	calculator
la caloría	calorie
la cureña	carriage
el cartaginés	Carthaginian
la cidra	citron
el corozo	cohune
la combinatoria	combinatorial
la barragana	"concubine, hooker, cutty"
el copto	Copt
*** 2731 - 2740 (/course/195613/spanish-nouns-4/274/)	
la cotangente	cotangent
la rajadura	"crack, split"
el maldito	darn
el dentífrico	"dentifrice, toothpaste"
la diaforesis	diaphoresis
las dioptrías	diopters
la chunga	dodgy
el buñuelo	"donut, sweet fritter, profiterole"
los onces	eleven
(el)(la) federalista	federalist
*** 2741 - 2750 (/course/195613/spanish-nouns-4/275/)	
el trapicheo	fiddle
los foraminíferos	foraminifera
las tenacillas	forceps
el defraudador	fraudster
el frutero	"fruit bowl, fruit dish, fruit basket"
el murmurador	"gossip, backbiter"
el alabardero	halberdier
la carraspera	"hoarseness, have a frog in the throat"
(el)(la) intolerante	intolerant person
la tulipa	Lens
*** 2761 - 2770 (/course/195613/spanish-nouns-4/276/)	
el naranjal	Orangery
(el)(la) perfeccionista	perfectionist
los pompeyanos	Pompeian
el protozoo	protozoon
el azogado	quicksilvering
el gazapo	rabbit
el escribidor	Scriptwriter
el alcaudón	"shrike, butcher bird"
los sirenios	Sirenia
el escorial	"slagheap, dump"
*** 2771 - 2780 (/course/195613/spanish-nouns-4/277/)	
el ranurado	slotted
el ligado	"slur, ligature"
el piscolabis	"snack, bite, munchie"
(el)(la) aguafiestas	"spoilsport, killjoy, wet blanket"
el aspersor	sprinkler
el entrepuente	"steerage, steering"
la mayordomía	stewardship
el orzuelo	"stye, sty"
la subdominante	subdominant
(el)(la) opa	takeover bid
*** 2781 - 2790 (/course/195613/spanish-nouns-4/278/)	
los tuberculosos	TB
los valores	"values, securities, stock"
el verbalismo	verbalism
la desoladora	desolation
la bailadora	dancer
la dobladora	bender
la ermitaña	hermit
la constipación	constipation
el facsímile	facsimile
la puertorriqueña	Puerto-Rican
*** 2751 - 2760 (/course/195613/spanish-nouns-4/279/)	
el arrasamiento	"leveling, annihilation, desolation"
la elucubración	lucubration
la mayor	"major, mainsail, main"
(el)(la) masoquista	masochist
los milesios	Milesians
la batidora	"mixer, whisk, beater"
el montenegrino	Montenegrin
(el)(la) neonazi	neo-Nazi
el escandinavo	Norseman
la aceitada	oiled
*** 2791 - 2800 (/course/195613/spanish-nouns-4/280/)	
el colocador	setter
el financiero	financier
el relajante	sedative
(el)(la) sunita	Sunni
el alicantino	Alicante
la endivia	"chicory, endive"
el jorobado	"humpback, hunchback"
el rosarino	Rosario
el serrano	"hill-dweller, mountain-dweller, mountain people"
el tanzano	Tanzanian
*** 2801 - 2810 (/course/195613/spanish-nouns-4/281/)	
el tibetano	Tibetan
el achatamiento	"flattening, loss of moral fibre"
el afinador	"tuning key, tuner (piano)"
el amaine	subsidence
el amárico	Amharic
el arseniuro	arsenide
el atropellamiento	runover
la bañadera	"bath, bathtub"
el barboquejo	chinstrap
la batimetría	bathymetry
*** 2811 - 2820 (/course/195613/spanish-nouns-4/282/)	
el broncoespasmo	bronchospasm
el burbujeo	"bubble, burble"
la cachimba	"hookah, water pipe, hubble-bubble pipe"
el carrilero	winger
la cayena	cayenne
el cerrador	finisher
el chale	chalet
la chismografía	gossip
la cocinita	kitchenette
la correduría	brokerage
*** 2821 - 2830 (/course/195613/spanish-nouns-4/283/)	
(el)(la) corregente	regent
el cronicón	chronicle
el curling	curling
la divorciada	divorcee
el encañado	"pipe, conduit"
la endodoncia	endodontics
el ensalmo	incantation
el enyesado	"cast, plaster cast"
el espolique	footman
la eufrasia	euphrasy
*** 2841 - 2850 (/course/195613/spanish-nouns-4/284/)	
el jedive	Khedive
el lamaísmo	Lamaism
el legalismo	legalism
la leñera	woodshed
la leucina	leucine
la lubricidad	lubricity
el mildiu	mildew
el nabab	nabob
la naranjada	"orangeade, orange squash"
la nitrificación	nitrification
*** 2831 - 2840 (/course/195613/spanish-nouns-4/285/)	
el forfait	"lift pass, ski pass"
la garlopa	"jointer, trying plane"
la gastroenterología	gastroenterology
el guaro	liquor
la haraganería	truancy
la hipermetropía	farsightedness
el humero	flue
la incomprensibilidad	incomprehensibility
la indistinción	"indistinctness, vagueness"
la inulina	inulin
*** 2851 - 2860 (/course/195613/spanish-nouns-4/286/)	
la oclocracia	ochlocracy
el papo	"food for birds of prey, cheek, nerve"
la parótida	parotid
la pimpinela	burnet
la pinga	"stick, pinch, hook"
el pleistoceno	Pleistocene
la poliamida	polyamide
el probabilismo	probabilism
el proteo	Proteus
la rodopsina	rhodopsin
*** 2861 - 2870 (/course/195613/spanish-nouns-4/287/)	
el sinólogo	"sinologist, sinologue"
el snobismo	"snobbery, snootiness"
la tablazón	"plank, planking"
el tacómetro	tachometer
el tecleo	"typing, keying"
(el)(la) titi	"bird, chick"
el tósigo	Venom
la trombina	thrombin
el ultranacionalismo	ultra-nationalism
el varillaje	"ribs, ribbing, rods"
*** 2881 - 2890 (/course/195613/spanish-nouns-4/288/)	
la muda	"abscission, leaf drop, leaf fall"
el activador	activator
el apriorismo	apriority
el sotabanco	attic
el notable	B grade
(el)(la) aeronauta	"balloonist, aeronaut"
la guasa	"banter, joke, jest"
el bípedo	biped
la murria	"blues, depression"
el fangal	"bog, slough"
*** 2891 - 2900 (/course/195613/spanish-nouns-4/289/)	
el retumbo	"boom, rumble, reverberation"
la panera	"breadbasket, bread bin, bread basket"
la descompostura	breakdown
el enladrillado	brick paving
el brochazo	"brushstroke, dab"
el desafiador	"challenger, challenge"
la mascada	"chewing motion, bite, scarf"
el cilio	cilium
(el)(la) concertista	concert
la cordelería	cordage
*** 2871 - 2880 (/course/195613/spanish-nouns-4/290/)	
el ventrílocuo	ventriloquist
la pajuela	"spill, match, toothpick"
el chorrillo	steady trickle
el mutilado	"mutilated person, cripple, war amputee"
el berlinés	Berliner
el mejunje	concoction
el gracioso	"joker, comic character, fool"
el encordado	"ring, strings, guitar"
los veintes	"twenties, twentieth"
el subastador	auctioneer
*** 2901 - 2910 (/course/195613/spanish-nouns-4/291/)	
el corimbo	corymb
el bastoncillo	cotton swab
la prímula	"cowslip, primula, polyanthus"
el transtorno	disorder
el arete	earring
el zarcillo	"earring, tendril, holdfast"
el filtrador	filter
los platelmintos	flatworms
la mullida	fluffy
la inocentada	Fool
*** 2921 - 2930 (/course/195613/spanish-nouns-4/292/)	
la entena	lateen yard
el lixiviado	leached
la trola	"lie, fib, whopper"
el infundio	"malicious lie, false story, false rumour"
los manchegos	Mancha
la martingala	martingale
el camellón	median
(el)(la) múltiplex	multiplex
el nanómetro	naked
la novísima	newest
*** 2911 - 2920 (/course/195613/spanish-nouns-4/293/)	
la agalla	"gill, gall, white indigoberry"
la vidriería	glassmaking
el rallador	grater
la hopalanda	greatcoat
el capacho	"hamper, hod"
el zarzo	"hurdle, wattle"
el higrómetro	hygrometer
(el)(la) idólatra	"idolater, heathen"
el jacobino	Jacobean
(el)(la) yonqui	junkie
*** 2931 - 2940 (/course/195613/spanish-nouns-4/294/)	
la perseguidora	persecutor
el profanador	profaner
el minino	"pussy, pussycat, puss"
el piroxeno	pyroxene
los quintillizos	"quintuplets, quins"
el reclutador	recruiter
el salmonete	red mullet
la reformada	reformed
el rescripto	rescript
el responsorio	response
*** 2961 - 2970 (/course/195613/spanish-nouns-4/295/)	
el soufflé	souffle
la vallisoletana	Valladolid
la pantufla	slipper
el endocrinólogo	endocrinologist
la panoja	panicle
el panqueque	pancake
la absorbencia	absorbency
el acápite	"paragraph, section, heading"
el acotamiento	gating
el adminículo	accessory
*** 2941 - 2950 (/course/195613/spanish-nouns-4/296/)	
la juncia	sedge
la autodefinición	self-
los seropositivos	seropositive
la sextina	sestina
la balda	shelf
la aplanadora	steamroller
el subsahariano	Sub-Saharan
la peladilla	sugar almond
el trillado	thorough investigation
la desgarrada	torn
*** 2951 - 2960 (/course/195613/spanish-nouns-4/297/)	
el velocípedo	velocipede
los vibrantes	vibrant
el afectado	"victim, person affected"
el reglaje	adjustment
el autoestop	hitch-hiking
la alholva	fenugreek
la gaditana	Cadiz
la ganadera	"cattle rancher, rancher, breeder"
la introductora	introducer
la samaritana	Samaritan
*** 2971 - 2980 (/course/195613/spanish-nouns-4/298/)	
la alexia	alexia
la aliara	allied
el alioli	aioli
el angoleño	Angolan
la autobomba	pumper
el autoerotismo	autoerotism
el bálago	thatch
la biblioteconomía	librarianship
el bolsito	placket
el bonapartismo	Bonapartism
*** 2981 - 2990 (/course/195613/spanish-nouns-4/299/)	
la botavara	sprit
la cabezonería	pigheadedness
la cacharrería	crockery shop
el cartabón	set square
el cascabillo	husk
la chueca	"chueca, bone"
la cienciología	Scientology
la clamidia	chlamydia
el climaterio	climacteric
la confortabilidad	comfort
*** 2991 - 3000 (/course/195613/spanish-nouns-4/300/)	
la cromosfera	chromosphere
la dimensionalidad	dimensionality
el discursito	little speech
el doctrinarismo	doctrinairism
la doncellez	maidenhood
la ebonita	ebonite
la endemoniada	devilish
la espelta	spelt
la espineta	spinet
el esquileo	shearing
*** 3001 - 3010 (/course/195613/spanish-nouns-4/301/)	
la eufonía	euphony
la extroversión	extroversion
el factótum	"factotum, busybody"
el gadolinio	gadolinium
la hidroponía	hydroponics
la hifa	hyphae
la insinceridad	insincerity
el joule	joule
la lambada	lambada
el latirismo	lathyrism
*** 3011 - 3020 (/course/195613/spanish-nouns-4/302/)	
el macroproyecto	macroproject
la mantita	"blanket, coarse cotton cloth, poncho"
el mecano	meccano
la neumología	pulmonology
el ñoño	drip
la orofaringe	oropharynx
(el)(la) otomí	Otomi
la palingenesia	palingenesis
el papismo	"popery, papism, papistry"
el pelagianismo	Pelagianism
*** 3041 - 3050 (/course/195613/spanish-nouns-4/303/)	
la torrentera	"gully, watercourse"
la rojez	"redness, blotch"
el vilano	thistledown
el botalón	outrigger
la acompañada	accompanied
el aerostato	"aerostat, air balloon"
el portaaeronaves	aircraft carrier
el alsaciano	Alsatian
los amalgamados	amalgamated
el arabismo	Arabism
*** 3031 - 3040 (/course/195613/spanish-nouns-4/304/)	
el tártago	"spurge, mishap, misfortune"
la termorregulación	thermoregulation
la tetraciclina	tetracycline
el trasgresor	transgressor
la uremia	"uremia, uraemia"
la vicerrectora	rector
el atracadero	pier
el alavés	from Alava
el lampazo	"burdock, floor mop, whipping"
el cebador	choke
*** 3021 - 3030 (/course/195613/spanish-nouns-4/305/)	
el peloteo	"knock up, rally, warm-up"
el pluriempleo	moonlighting
la poliuria	polyuria
la procuraduría	attorney
el radiólogo	radiologist
el saxófono	"saxophone, saxophonist, sax"
la sericultura	sericulture
la sexología	sexology
el sobreparto	childbed
el tableteo	"rat-a-tat, rat-tat-tat"
*** 3071 - 3080 (/course/195613/spanish-nouns-4/306/)	
el retorcimiento	contortion
el crocante	crocante
la bocamanga	cuff
las estaquillas	cuttings
la degollación	Decapitation
el engañador	"deceiver, impostor, cheat"
la delicatessen	"delicatessen, deli"
la depravada	depraved
la documentada	documented
la taladradora	drill
*** 3111 - 3120 (/course/195613/spanish-nouns-4/307/)	
el preparativo	preparative
el merodeo	"prowl, marauding"
el pterodáctilo	pterodactyl
la pubescencia	pubescence
el trapero	"ragman, ragpicker"
el pluviómetro	"rain gauge, pluviometer"
la ranchera	"rancher, ranchera, woman ranch-owner"
(el)(la) montaraz	Ranger
las reconditeces	recesses
la repetidora	repeater
*** 3191 - 3200 (/course/195613/spanish-nouns-4/308/)	
la hosquedad	surliness
el indagador	searcher
la irreductibilidad	irreducibility
la justa	"joust, jousting"
la lectoescritura	literacy
el listín	"telephone directory, phone book"
la longanimidad	longsuffering
el malacate	"winch, capstan, spindle"
el oocito	oocyte
la pachanga	"pachanga, party, rowdy celebration"
*** 3051 - 3060 (/course/195613/spanish-nouns-4/309/)	
el butacón	armchair
(el)(la) azteca	Aztec
el golpetazo	bash
la bazuca	bazooka
el cojinete	"bearing, bushing, pin cushion"
el apaleamiento	beating
el verraco	"boar, male pig"
la bolina	bowline
la tacada	break
el amiguete	buddy
*** 3061 - 3070 (/course/195613/spanish-nouns-4/310/)	
el chubasquero	"cagoule, raincoat, slicker"
el canino	"canine, canine tooth"
el contado	cash
el catecúmeno	catechumen
el formón	"chisel, mortise chisel"
el cebollino	"chive, scallion"
la gordita	chubby
el clisé	cliche
la polvera	"compact, powder compact, powder box"
el conciliador	"conciliator, peacemaker"
*** 3081 - 3090 (/course/195613/spanish-nouns-4/311/)	
el electrochoque	electroshock
el maléfico	evil
la extractora	extractor
la fallera	faller
el falso	false evidence
el cervato	"fawn, brocket"
el forzamiento	forcing
el nomeolvides	forget-me-not
el expósito	foundling
(el)(la) genocida	genocidal
*** 3091 - 3100 (/course/195613/spanish-nouns-4/312/)	
(el)(la) gerundense	Girona
el cosechero	"harvester, reaper"
(el)(la) helenista	"Hellenist, Greek scholar"
la herboristería	herbalist's
la ociosa	idler
el kleenex	Kleenex
la cifosis	kyphosis
el grumo	"lump, clot, grume"
el macrocosmo	macrocosm
el masetero	masseter
*** 3171 - 3180 (/course/195613/spanish-nouns-4/313/)	
la coloratura	coloratura
la comunicabilidad	communicability
la conglomeración	conglomeration
el creso	Croesus
el curanderismo	"folk medicine, quack medicine, quackery"
la deseabilidad	desirability
el desencantamiento	disenchantment
la disuria	dysuria
la elastina	elastin
el emboque	tight passage
*** 3141 - 3150 (/course/195613/spanish-nouns-4/314/)	
la decoradora	decorator
el eccema	eczema
la francotiradora	sniper
la luterana	Lutheran
la murciana	from Murcia
la peletera	"furrier, skinner"
la veneciana	Venetian
el decantador	decanter
el lisonjero	flatterer
el meloncillo	mongoose
*** 3101 - 3110 (/course/195613/spanish-nouns-4/315/)	
el milpiés	"millipede, millepede"
la palomilla	moth
la neuritis	neuritis
el octante	octant
los envasadores	packers
el pimentero	"pepper shaker, pepper, pepperbox"
el fotograbado	"photoengraving, photogravure"
(el)(la) carterista	pickpocket
el pictograma	pictogram
el encuestador	pollster
*** 3181 - 3190 (/course/195613/spanish-nouns-4/316/)	
el encendimiento	"passion, ardour, eagerness"
la endocrinología	endocrinology
la espinita	thorn
el fletamento	affreightment
el francio	francium
el globulina	globulin
el gramaje	weight
la grifa	"griffin, gryphon, dope"
la guata	"wadding, wad, batting"
el hirsutismo	hirsutism
*** 3201 - 3210 (/course/195613/spanish-nouns-4/317/)	
la pana	"corduroy, cord, corduroys"
el pillín	"rascal, scamp"
el pirofosfato	pyrophosphate
el plasmodio	plasmodium
el polibuteno	polybutene
la potabilidad	potability
el presbiterianismo	Presbyterianism
el profetismo	prophecy
la prostaglandina	prostaglandin
el protoplasto	protoplast
*** 3221 - 3230 (/course/195613/spanish-nouns-4/318/)	
el tetragrama	tetragram
el tiramisú	tiramisu
la tiroxina	thyroxine
la tocadora	toucher
el traque	"crack, bang, noisy fart"
el trinitrotolueno	trinitrotoluene
el trípoli	tripoli
la turbiedad	turbidity
la vetustez	antiquity
el vomitivo	emetic
*** 3231 - 3240 (/course/195613/spanish-nouns-4/319/)	
el zimbabuo	Zimbabwean
la medianería	"party wall, partnership, sharecropping"
la raña	frog
el alcaucil	artichoke
el ñame	yam
la bovedilla	cove
la almadraba	"tunny fishing, fishery, net"
el descifrador	"mystery solver, decipherer"
la atrapamoscas	flypaper
el desesperado	a desperate person
*** 3281 - 3290 (/course/195613/spanish-nouns-4/320/)	
el jónico	Ionic
el pijo	"knob, dick, cock"
el ñudo	"knot, joint"
el bracero	laborer
el laminado	"laminate, lamination"
el lineamiento	lineament
el guacamayo	macaw
el nematodo	nematode
(los)(las) neofascistas	neo-fascist
el diecinueve	"nineteen, nineteenth"
*** 3291 - 3300 (/course/195613/spanish-nouns-4/321/)	
el palanquín	palanquin
el centón	patchwork quilt
la flebitis	phlebitis
el piquero	pikeman
el piño	"pine, tooth"
el enlucido	"plastering, plaster"
la plaqueta	"platelet, plaquette, tile"
el asegurado	"policy holder, policy-holder, insuree"
la presuntuosa	presumptuous
el protozoario	protozoan
*** 3311 - 3320 (/course/195613/spanish-nouns-4/322/)	
el espejuelo	small looking-glass
la mojada	"soaking, wetting"
la freza	"spawn, spat, seed"
el espeleólogo	"speleologist, spelunker, potholer"
la espiroqueta	spirochaete
la espondilitis	spondylitis
el rezagado	"straggler, latecomer"
el biplaza	tandem
el tetrarca	tetrarch
la nada	"the void, nothing, void"
*** 3121 - 3130 (/course/195613/spanish-nouns-4/323/)	
la rodada	"rut, track, tyre track"
el santón	saint
la ajedrea	savory
los encestadores	scorers
la sinecura	sinecure
la endrina	sloe
la estalagmita	stalagmite
el camillero	stretcher-bearer
el estucado	"stucco, plasterwork"
el tanga	"tanga, G-string"
*** 3131 - 3140 (/course/195613/spanish-nouns-4/324/)	
los dieces	tens
el golpazo	"thump, wallop"
los tribunales	"tribunal, court"
la recalcada	upset
el vulcanólogo	volcanologist
la eñe	"with a tilde, tilde"
el palier	shield
el culantro	coriander
las comunitarias	Community
el cóccix	coccyx
*** 3151 - 3160 (/course/195613/spanish-nouns-4/325/)	
la yugoslava	Yugoslav
la aceitera	"oil cruet, oil bottle"
la acrimonia	acrimony
la acromatopsia	achromatopsia
la adicta	addict
la aerostación	aerostation
la alcaravea	caraway
la alcuza	"olive oil bottle, cruet, cruet stand"
el altimetría	altimetry
el anecdotario	anecdote
*** 3161 - 3170 (/course/195613/spanish-nouns-4/326/)	
el archimandrita	archimandrite
el arribismo	social climbing
la aventurera	adventuress
el blastodermo	blastoderm
el calicanto	masonry
la calina	haze
el campanil	campanile
la capitación	"capitation, poll, poll tax"
(el)(la) carioca	inhabitant of Rio de Janeiro
la chifla	"whistle, whistling, skiver"
*** 3261 - 3270 (/course/195613/spanish-nouns-4/327/)	
el confite	"confection, sweetmeat, sugarplum"
el anticonceptivo	contraceptive
la rea	"convict, culprit"
el cosmético	"cosmetic, beauty product"
el miedoso	"coward, scaredy cat"
(el)(la) maleante	"crook, villain"
el balero	"cup-and-ball, balero"
la natilla	custard
la cisticercosis	cysticercosis
el desorientador	disorienting
*** 3241 - 3250 (/course/195613/spanish-nouns-4/328/)	
la anfisbena	amphisbaena
(el)(la) antisemita	anti-Semite
la autohipnosis	autohypnosis
(el)(la) abulense	Avila
la avoceta	"avocet, scooper, avoset"
el lanchón	barge
el coleóptero	beetle
(el)(la) conductista	behaviorist
(el)(la) belga	Belgian
la blonda	"blond lace, silk lace"
*** 3301 - 3310 (/course/195613/spanish-nouns-4/329/)	
la ponchera	punch-bowl
los radiados	radiated
la rastrillada	raked
la tranquilizadora	reassuring
el cordoncillo	"rib, milling, soutache"
la taleguilla	satchel
el esgrafiado	sgraffito
el expedidor	"shipper, forwarder"
el guardagujas	"shunter, switchman, points man UK"
la tonta	"silly, fool, dummy"
*** 3211 - 3220 (/course/195613/spanish-nouns-4/330/)	
el quimo	chyme
el radiocasete	radiocassette
el radiocontrol	radio control
la recrudescencia	recrudescence
la runfla	Runfla
la sobrecubierta	"jacket, dust jacket"
el sombrerete	bonnet
el sueste	"southwester, sou'wester"
la telemática	telematics
la testamentaría	"execution of a will, estate"
*** 3321 - 3330 (/course/195613/spanish-nouns-4/331/)	
la tromboflebitis	thrombophlebitis
el timbalero	timpanist
el revendedor	tout
el cachivache	"trash, junk, crap"
el triplano	triplane
(el)(la) tupí	Tupi
el velillo	veil
el vienés	"Viennese, Vienna coffee, Viennese coffee"
el advertimiento	WARNINGS
el gusanito	worm
*** 3271 - 3280 (/course/195613/spanish-nouns-4/332/)	
los dinamiteros	dynamite
el soponcio	Faint
la gorda	fat woman
la cisura	fissure
(el)(la) futurista	futurist
la guardabarrera	gatekeeper
la hemólisis	hemolysis
el eremitorio	hermitage
(el)(la) homosexual	"homosexual, gay"
los entreverados	interspersed
*** 3361 - 3370 (/course/195613/spanish-nouns-4/333/)	
la browning	browning
la búfala	buffalo
la cablevisión	Cablevision
la calistenia	"callisthenics, calisthenics"
la camisita	chemise
el canelón	"cannelloni, icicle, braid"
el carajillo	black coffee with added liquor
la carbonería	coalyard
la carnosidad	fleshiness
el cascabeleo	jingle
*** 3331 - 3340 (/course/195613/spanish-nouns-4/334/)	
el yatagán	yataghan
el jabato	young wild boar
la alfabetizada	literate
la bizantina	Byzantine
la florentina	Florentine person
la hospedera	host
el nosocomio	hospital
el podenco	hound
la librepensadora	freethinker
la neófita	neophyte
*** 3381 - 3390 (/course/195613/spanish-nouns-4/335/)	
la demodulación	demodulation
el desfogue	venting
la dulcedumbre	sweetness
el entablado	"boarding, planking"
el esplín	"melancholy, depression, the blues"
la estafadora	"swindler, sharper, racketeer"
la estearina	stearin
el flirt	"fling, date, girlfriend"
la foliación	foliation
el francesito	Frenchie
*** 3251 - 3260 (/course/195613/spanish-nouns-4/336/)	
la brocheta	"brochette, skewer, kebab"
la pollada	"brood, hatch"
las rositas	buttered
el miraje	candling
los canoeros	canoeists
el fullero	"cheat, sharp, sharper"
la pamplina	chickweed
la palmada	"clap, slap, smack"
la presilla	"clip, loop, fastener"
la peinadora	comber
*** 3351 - 3360 (/course/195613/spanish-nouns-4/337/)	
la valva	valve
el acrilonitrilo	acrylonitrile
la álaga	Alaga
la alheña	"henna, privet"
el amperímetro	"ammeter, amperemeter"
la archivística	archival
la autoflagelación	flagellation
el bestialismo	bestiality
la brahma	Brahma
el bromazo	a practical joke
*** 3371 - 3380 (/course/195613/spanish-nouns-4/338/)	
el cáustico	caustic
la cedilla	cedilla
la cianita	kyanite
el cincuentón	in one's fifties
el climatizador	climate
el codaste	stern
la concoide	conchoid
la criocirugía	cryosurgery
la defoliación	defoliation
la demacración	emaciation
*** 3341 - 3350 (/course/195613/spanish-nouns-4/339/)	
el escarbadientes	toothpick
la bordadora	embroidery
(el)(la) repórter	reporter
el superego	superego
el bañero	life guard
el envenenador	poisoner
la evasiva	excuse
el generalizador	generalizing
la hemiplejia	hemiplegia
el mecanógrafo	typist
*** 3401 - 3410 (/course/195613/spanish-nouns-4/340/)	
la incorporeidad	"incorporeity, disembodiment"
la indelicadeza	"indelicacy, abruptness"
la insustancialidad	insubstantiality
la jábega	seine
el jaquetón	bully braggart
el julepe	julep
la kinesiología	kinesiology
la maquilladora	makeup
el marchitamiento	wilt
la melamina	melamine
*** 3411 - 3420 (/course/195613/spanish-nouns-4/341/)	
la mesosfera	mesosphere
el meteoroide	meteoroid
el natrón	natron
el neutralismo	neutralism
la noosfera	noosphere
la notita	little note
el paleógrafo	"palaeographer, paleographer"
la palotada	Palotada
la picadora	"picador, mincer"
el picoteo	pecking
*** 3391 - 3400 (/course/195613/spanish-nouns-4/342/)	
el fueloil	fuel oil
la gambia	Gambia
la geofísica	geophysics
la gerontocracia	gerontocracy
la grajilla	"jackdaw, daw"
la hachemita	Hashemite
el hipocondríaco	hypochondriac
el íbice	ibex
la imploración	entreaty
la inconsideración	"thoughtlessness, recklessness"
*** 3421 - 3430 (/course/195613/spanish-nouns-4/343/)	
el pis	"pee, piss, wee-wee"
el portorriqueño	Puerto Rican
la presbicia	"presbyopia, farsightedness"
el prolongamiento	"prolongation, protraction"
la radiobaliza	radio beacon
el radiofaro	radiobeacon
el reconciliador	reconciler
la refulgencia	refulgence
el rutherfordio	rutherfordium
la sobreactuación	overacting
*** 3441 - 3450 (/course/195613/spanish-nouns-4/344/)	
la cochinada	"filth, filthiness, filthy remark"
el flux	"flush, stroke of luck"
el vidriado	"glaze, glazing, glazed earthenware"
el arriate	"bed, border, road"
el bayonetazo	bayonet thrust
el angelote	angelfish
la antífrasis	antiphrasis
el arácnido	"arachnid, arachnoid"
el aspirador	aspirator
la agredida	assaulted
*** 3431 - 3440 (/course/195613/spanish-nouns-4/345/)	
el socinianismo	Socinianism
la sombrerería	millinery
el sumerio	Sumerian
el tantrismo	Tantrism
(el)(la) tarambana	crackpot
la televenta	telesales
la timocracia	timocracy
el trullo	"nick, jail, can"
la baladronada	"boast, brag, piece of bravado"
el faradio	farad
*** 3451 - 3460 (/course/195613/spanish-nouns-4/346/)	
el agustino	Augustinian
el pespunte	backstitch
la barrilla	barilla
la habichuela	"bean, string bean, kidney bean"
la gayuba	bearberry
el primordio	blank
el rubio	"blond, sea robin, gurnard"
la niveladora	bulldozer
el juanete	bunion
el telefonazo	buzz
*** 3461 - 3470 (/course/195613/spanish-nouns-4/347/)	
la chocolatina	"candy bar, chocolate, chocolate bar"
la playera	"canvas shoe, beach shoe"
el consiliario	chaplain
el perifollo	chervil
el orfeón	choir
el cítrico	citrus fruits
(el)(la) colorista	colorist
los contraceptivos	contraceptives
el rechinamiento	creak
(el)(la) chipriota	Cypriote
*** 3481 - 3490 (/course/195613/spanish-nouns-4/348/)	
la generadora	generating
la driza	halyard
la agarradera	"handle, bar, rail"
(el)(la) excursionista	"hiker, tourist, tripper"
el bocinazo	"honk, hoot, blast"
la buscona	hooker
(el)(la) camorrista	hooligan
el carámbano	icicle
la labradora	Labrador
el laxante	laxative
*** 3471 - 3480 (/course/195613/spanish-nouns-4/349/)	
la diátesis	diathesis
el minusválido	"disabled, handicapped, handicapped person"
el bordador	embroiderer
el efímero	ephemeral
(el)(la) existencialista	existentialist
la admiradora	"fan, admirer"
el pasamano	fare
los deshilados	frayed
la fritanga	"fried food, fry-up"
el garitero	gambler
*** 3491 - 3500 (/course/195613/spanish-nouns-4/350/)	
el deshecho	"leak, dumps, dismantling"
el marrajo	mako
los manresanos	Manresa
el minibar	minibar
el tejemaneje	"monkey business, fuss, bustle"
el trasnochador	"night-walker, night-bird"
la paya	"non-gypsy, gorgio, improvised song"
el nubio	Nubian
el nucleón	nucleon
la paisana	one from the same country
*** 3531 - 3540 (/course/195613/spanish-nouns-4/351/)	
los tolanos	Tollan
el vegetariano	"vegetarian, vegan"
la tejedora	weaver
la obrada	wrought
la postema	abscess
la germana	German
(el)(la) socorrista	life guard
la dominicana	Dominican
la ecléctica	eclectic
el titulado	graduate
*** 3501 - 3510 (/course/195613/spanish-nouns-4/352/)	
los ópticos	optical
(el)(la) parietal	parietal bone
el copropietario	part-owner
el filisteo	philistine
la filacteria	phylactery
el platónico	Platonist
(el)(la) chorlito	"plover, curlew"
el propretor	"propretor, propraetor"
el pigmeo	pygmy
la desastrada	ragged
*** 3521 - 3530 (/course/195613/spanish-nouns-4/353/)	
el sorbito	sip
el granizado	"slush, slushie"
el blusón	"smock, big shirt, camp shirt"
la especuladora	speculative
la estalactita	stalactite
el estirado	straightening
el tartamudo	"stutterer, stammerer, stuttering"
el suburbano	suburban
la tangencia	tangency
el tracio	Thracian
*** 3541 - 3550 (/course/195613/spanish-nouns-4/354/)	
el amolador	grinder
la multimillonaria	multimillionaire
la neuróloga	neurologist
la primitiva	primitive
(el)(la) regicida	regicide
la reprimida	repressed
el rasgón	"tear, rip"
la siciliana	Sicilian
la surcoreana	South Korean
la tirana	tyrant
*** 3511 - 3520 (/course/195613/spanish-nouns-4/355/)	
las matarratas	"rat poison, rotgut, blue rum"
la rozadura	"rubbing, chafing, gall"
el chatarrero	"scrap dealer, scrap merchant, junkman"
el raspado	"scraping, scrape, curettage"
la escrófula	scrofula
(el)(la) sensacionalista	sensationalist
la separadora	separating
(el)(la) sefardí	sephardi
las borras	"shag, stuffing, sediment, thick wool"
la coquilla	shell
*** 3581 - 3590 (/course/195613/spanish-nouns-4/356/)	
el chiribitil	"cubby, cubby hole"
el chorreo	"gushing, spouting, drain"
el contrafagot	double bassoon
la cornalina	cornelian
el cotiledón	"cotyledon, seed leaf"
el desagradecimiento	ingratitude
la descalcificación	decalcification
el dosier	dossier
la dulía	dulia
el emparrillado	"grate, grating"
*** 3551 - 3560 (/course/195613/spanish-nouns-4/357/)	
las troyanas	Trojan
(el)(la) integrista	fundamentalist
el contrachapado	plywood
la mesonera	landlady
la estatalización	nationalization
el huerfanito	orphan
el limeño	Lima person
el moretón	bruise
el merino	merino
el peruano	Peruvian
*** 3561 - 3570 (/course/195613/spanish-nouns-4/358/)	
el abigarramiento	variegation
el acróstico	acrostic
la agrimonia	agrimony
la aguatinta	aquatint
la almáciga	"plantation, nursery"
la amalgamación	amalgamation
el amodorramiento	drowsiness
el antiprotón	antiproton
el armamentismo	armament
el asterismo	asterism
*** 3571 - 3580 (/course/195613/spanish-nouns-4/359/)	
la beatería	"sanctimoniousness, sanctimony, piousness"
el benjuí	"benzoin, benjamin"
el birimbao	"jew's-car, jew's-harp"
la blenda	blende
el bonachón	goody
el bultito	bump
el cacumen	"height, nous"
el cagadero	"bog, can, head"
la cangrejera	crabeater
la cariópside	caryopsis
*** 3591 - 3600 (/course/195613/spanish-nouns-4/360/)	
el endiosamiento	"vanity, conceit, haughtiness"
la escandalera	uproar
el espiráculo	spiracle
la eurocracia	eurocracy
el euroescéptico	Eurosceptic
el freón	freon
la fumarola	fumarole
la gallera	"coop, henhouse, chicken coop"
el gametófito	gametophyte
la gástrula	gastrula
*** 3601 - 3610 (/course/195613/spanish-nouns-4/361/)	
la glande	glans
el hibisco	hibiscus
el ictiólogo	ichthyologist
el imprimátur	imprimatur
la inculcación	inculcation
la inexorabilidad	inexorability
el jeto	ject
el kilobyte	kilobyte
la leprosería	leprosarium
el lutecio	lutetium
*** 3611 - 3620 (/course/195613/spanish-nouns-4/362/)	
el meristemo	meristem
el metaplasmo	metaplasm
la microcefalia	microcephaly
la milenrama	"yarrow, milfoil"
la mucina	mucin
el multiprocesamiento	multiprocessing
la nasofaringe	nasopharynx
el oriol	oriole
la paresia	paresis
la partitocracia	partitocracy
*** 3621 - 3630 (/course/195613/spanish-nouns-4/363/)	
la pateada	booted
el planchador	person who does the ironing
la posesividad	possessiveness
el prerromanticismo	preromanticism
la principalidad	principality
el ragú	ragout
el respe	respected
el retaco	shorty
el rímel	mascara
el rosbif	roast beef
*** 3631 - 3640 (/course/195613/spanish-nouns-4/364/)	
la semiesclavitud	semislavery
la superveniencia	supervenience
el tartrato	tartrate
la temperancia	moderation
la teneduría	position of bookkeeper
el terbio	terbium
la tiradora	"handle, shooter"
la ultratumba	"hereafter, beyond"
el vallecito	valley
el zampullín	grebe
*** 3641 - 3650 (/course/195613/spanish-nouns-4/365/)	
la contemporización	"temporizing, appeasement"
la verdulera	"greengrocer, grocer"
el jerezano	from Jerez
la catalana	Catalonian
el saltito	"jump, leap"
la millonada	fortune
el abusador	abuser
el acadio	Akkadian
la alidada	alidade
el aleluya	"alleluia, hallelujah"
*** 3651 - 3660 (/course/195613/spanish-nouns-4/366/)	
el alodio	"allodium, alodium"
la amatista	amethyst
el florilegio	"anthology, treasury"
la aféresis	aphaeresis
la asilada	asylee
la begonia	begonia
la trencilla	braid
el bugle	bugle
la candelaria	candlemas
la carnalidad	carnality
*** 3671 - 3680 (/course/195613/spanish-nouns-4/367/)	
el cultismo	cultism
los danzadores	dancers
(el)(la) polemista	"debater, polemicist, polemic"
la negadora	denying
el destilador	distiller
la taquillera	draw
(el)(la) estupefaciente	"drug, narcotic, opiate"
el moribundo	dying
el esmeril	emery
la alentadora	encouraging
*** 3661 - 3670 (/course/195613/spanish-nouns-4/368/)	
el catarrino	catarrhine
los quilópodos	Chilopoda
la clorosis	chlorosis
la escaladora	climber
el tortazo	"clout, slap, smack"
el engrane	"cogwheel, cog"
el serpentín	"cooling coil, heating coil"
el llanero	"cowboy, plainsman"
el criminólogo	criminologist
(los)(las) cubistas	Cubist
*** 3691 - 3700 (/course/195613/spanish-nouns-4/369/)	
el trancazo	"flu, blow with a stick, blow with a club"
el comestible	"food, groceries"
el falsario	"forger, falsifier"
el aspaviento	"fuss, wild gesticulation"
la gingivitis	gingivitis
la tenebrosidad	gloom
la gónada	gonad
la grosella	"gooseberry, currant, redcurrant"
el agarradero	"grip, handgrip"
el paleto	"hick, bumpkin, peasant"
*** 3681 - 3690 (/course/195613/spanish-nouns-4/370/)	
el entimema	enthymeme
la enuresis	enuresis
los efesios	Ephesians
el evaporador	evaporator
las extralimitaciones	excesses
(el)(la) fetichista	fetishist
la potra	"filly, good luck, luck"
el cinéfilo	"film fan, cinephile, film buff"
el pirómano	firebug
la florería	"flower shop, florist's"
*** 3701 - 3710 (/course/195613/spanish-nouns-4/371/)	
el honorario	honorarium
el cañizo	hurdle
el botarate	"idiot, fool, dumbass"
la ensambladura	"joint, scarfing"
el kazajo	Kazakh
la encajera	Lacemaker
(el)(la) latifundista	landowner
el andarivel	lifeline
la candileja	limelight
la mujercilla	little woman
*** 3721 - 3730 (/course/195613/spanish-nouns-4/372/)	
la pelada	"prickly pear, poor person, tongue-sole"
el propóleos	propolis
los prosternados	prostrate
la siquis	psyche
el radián	radian
la calificadora	ratings
la reflectora	reflective
la regurgitación	regurgitation
la refrenada	restrained
el rulo	"roller, curler, curl"
*** 3711 - 3720 (/course/195613/spanish-nouns-4/373/)	
el encantador	"magician, enchanter/enchantress"
el mauritano	Mauritanian
el metacarpo	metacarpus
el nectario	nectary
(el)(la) obstetra	OB
la perlesía	palsy
la percalina	percaline
el horcón	"pitchfork, forked prop, wooden post"
el arador	plowman
(el)(la) ceramista	"potter, ceramist"
*** 3731 - 3740 (/course/195613/spanish-nouns-4/374/)	
la esclerótica	sclera
el asimiento	"seizure, hold, grasp"
el varal	"shaft, batten"
la culebrilla	shingles
el tijeretazo	snip
la centolla	spider crab
las ascidias	squirts
los pisados	stepped
la oclusiva	stop
(el)(la) maje	sucker
*** 3751 - 3760 (/course/195613/spanish-nouns-4/375/)	
la aviadora	"aviator, airman, flier"
el danzarín	dancer
la cántabra	Cantabrian
la científica	scientist
la extremeña	Extremadura
la charnela	hinge
el cuanto	quantum
el ajustamiento	adjustment
(el)(la) detallista	retailer
(el)(la) sunnita	Sunni
*** 3741 - 3750 (/course/195613/spanish-nouns-4/376/)	
la mantelería	"table linen, linen, linens"
la casca	"tan, bark"
(el)(la) telegrafista	telegraphist
la tesela	tile
el libraco	tome
el mastelero	topmast
el desagradecido	"ungrateful person, ingrate"
la videocinta	video tape
la adulta	adult
la armadora	"shipowner, ship operator"
*** 3761 - 3770 (/course/195613/spanish-nouns-4/377/)	
el birmano	Burmese
el bailable	dance
la licuación	liquefaction
el trapeador	mop
el puterío	whoring
el tinerfeño	Tenerife
la viceconsejera	Deputy Minister
el aburguesamiento	gentrification
la acromegalia	acromegaly
el afrontamiento	confrontation
*** 3771 - 3780 (/course/195613/spanish-nouns-4/378/)	
el aletargamiento	lethargy
el alevoso	traitor
el amito	amice
la andrómeda	Andromeda
la anochecida	dusk
el areópago	Areopagus
el ausentismo	absenteeism
la autodirección	homing
la auxina	auxin
la brillantina	"brilliantine, glitter, hair oil"
*** 3801 - 3810 (/course/195613/spanish-nouns-4/379/)	
la espumadera	skimmer
la estolidez	stolidity
el estramonio	stramonium
el facistol	lectern
el fogueo	blanks
el frascuelo	Frascuelo
el fundente	flux
la futurología	futurology
la galena	galena
la geminación	gemination
*** 3781 - 3790 (/course/195613/spanish-nouns-4/380/)	
la calorimetría	calorimetry
el calzo	"wedge, chock, shoe"
la capona	Capona
la casiterita	cassiterite
el cernido	sifting
la coalescencia	coalescence
la coctelería	cocktail
el compañerito	fellah
la consustancialidad	consubstantiality
el conversador	conversationalist
*** 3791 - 3800 (/course/195613/spanish-nouns-4/381/)	
(el)(la) culturista	bodybuilder
el desaprovechamiento	wastage
la devanadera	winder
el duraluminio	duralumin
la ébola	Ebola
el ecualizador	equalizer
la electrostática	electrostatics
la emersión	emersion
el engendramiento	breeding
la espaciosidad	roominess
*** 3831 - 3840 (/course/195613/spanish-nouns-4/382/)	
el mirabel	mirabelle
la navajita	grama
(el)(la) nepalí	Nepalese
el nonagenario	nonagenarian
la notaria	notary's office
la ornitina	ornithine
la paralela	parallel
la piromanía	pyromania
la prensión	prehension
el presbiterado	presbyterate
*** 3811 - 3820 (/course/195613/spanish-nouns-4/383/)	
la gentecilla	little people
la geoquímica	geochemistry
el gibón	gibbon
el gluón	gluon
el gremialismo	labour movement
el heliógrafo	heliograph
la hematoxilina	hematoxylin
la herpetología	herpetology
(el)(la) hijoputa	motherfucker
la hojalatería	sheet shop
*** 3821 - 3830 (/course/195613/spanish-nouns-4/384/)	
la impuntualidad	"unpunctuality, lack of punctuality, slowness"
la inseparabilidad	inseparability
la intubación	intubation
el jebe	rubber
la labilidad	lability
la laica	secular
la lexicología	lexicology
la macrofiesta	macro party
la manida	hackneyed
la miopatía	myopathy
*** 3881 - 3890 (/course/195613/spanish-nouns-4/385/)	
el soplador	blower
los tablones	"board, plank"
el bichero	boathook
el ladrillero	brickmaker
la colleja	campion
el palmetazo	"caning, blow, slap in the face"
el cardias	cardia
(el)(la) catequista	catechist
el desdeñoso	cavalier
los terrones	"clod, lump"
*** 3851 - 3860 (/course/195613/spanish-nouns-4/386/)	
la sobrasada	Majorcan sausage
la sodoma	Sodom
el solideo	"skullcap, cap"
el tricentenario	"tercentenary, tricentenary"
la tropopausa	tropopause
el vagabundaje	vagrancy
la vituperación	vituperation
el blandón	"wax taper, large candlestick"
la literata	bluestocking
el arbotante	flying buttress
*** 3861 - 3870 (/course/195613/spanish-nouns-4/387/)	
la navecilla	nacelle
la colegiatura	fellowship
la pesquera	"fishing boat, factory boat"
la virada	"tack, tacking"
el adherente	"adherent, glue, adhesive"
la gestoría	"agency that undertakes administrative work, administrator"
los aerofrenos	airbrake
(el)(la) alienista	alienist
los aligátores	alligators
el antioxidante	antioxidant
*** 3841 - 3850 (/course/195613/spanish-nouns-4/388/)	
(el)(la) proyeccionista	projectionist
el puñetero	pest
el quiche	quiche
el quiosquero	newsagent
el radioteléfono	radiotelephone
el repe	repeated
la repetitividad	repeatability
la riboflavina	riboflavin
el sandinismo	Sandinista
la semidiosa	demigoddess
*** 3871 - 3880 (/course/195613/spanish-nouns-4/389/)	
la artería	"artery, cunning, artfulness"
los artiodáctilos	artiodactyls
el austral	austral
(el)(la) automotriz	automotive
la cornamusa	bagpipe
el abalorio	"bead, trinket, glass bead"
el fréjol	beans
el biselado	bevelling
(el)(la) rompehuelgas	"blackleg, strikebreaker"
la cegadora	blinding
*** 3891 - 3900 (/course/195613/spanish-nouns-4/390/)	
los coligados	coalesced
el chicharrón	"crackling, chicharrones, pork rind"
la crepe	"crepe, pancake"
(el)(la) penalista	"criminal lawyer, penologist"
el visillo	"curtain, lace curtain, net curtain"
la deslumbradora	dazzling
el divorciado	divorcé/divorcée
el gotero	dropper
la garceta	"egret, aigrette"
(el)(la) equilibrista	"equilibrist, aerialist, balancer"
*** 3921 - 3930 (/course/195613/spanish-nouns-4/391/)	
(el)(la) heterosexual	heterosexual
la hurí	houri
el aerodeslizador	"hovercraft, hydrofoil"
el integrador	integrator
la jarrita	jar
el pateador	kicker
la rodillera	"kneepad, knee guard, knee-patch"
la laberintitis	labyrinthitis
el vejamen	"lampoon, obloquy"
la reidora	Laughing
*** 3901 - 3910 (/course/195613/spanish-nouns-4/392/)	
el contravalor	equivalent
las euforbiáceas	Euphorbiaceae
el gamonal	"expr, cacique, chieftain"
el fibroma	fibroma
el cortafuego	firewall
(los)(las) flagelantes	flagellants
la parvada	flock
el macetero	flowerpot stand
la fluxión	fluxion
el guiri	"foreigner, foreign tourist"
*** 3931 - 3940 (/course/195613/spanish-nouns-4/393/)	
el portaminas	"leadholder, mechanical pencil, propelling pencil"
la leishmaniosis	leishmaniasis
el abrecartas	letter opener
el pardillo	linnet
el litre	liter
el taparrabo	loincloth
el losange	"lozenge, diamond"
la lúnula	lunula
las ménades	maenads
el mahometano	"Mahometan, Mohammedan"
*** 3911 - 3920 (/course/195613/spanish-nouns-4/394/)	
(los)(las) legistas	forensic
el frecuentador	frequenter
el calibrador	"gauge, callipers, calipers"
el pececito	goldfish
la empastada	grassed
el bosquete	grove
el guineano	Guinea
el alucinógeno	hallucinogen
el audífono	"hearing aid, earphone"
la bastilla	hem
*** 3961 - 3970 (/course/195613/spanish-nouns-4/395/)	
el abastecedor	"provider, caterer, grocer"
la podadera	"pruning shear, secateurs, pruning knife"
la compradora	"purchaser, buyer, shopper"
(el)(la) purasangre	pureblood
los matasanos	"quack, sawbones"
el cuarterón	"quadroon, quarter pound"
el tremedal	"quagmire, quag, quaking bog"
el radiotransmisor	radio transmitter
el apreciador	rater
los canalillos	rill
*** 3941 - 3950 (/course/195613/spanish-nouns-4/396/)	
el morabito	marabout
el zurcido	"mend, darn"
la purpurina	"metallic paint, metallic powder, metallic flakes"
el microsegundo	microsecond
las microsporas	microspores
la sombrerera	"milliner, bandbox"
el inadaptado	misfit
los mezclados	mixed
el modelador	"modeller, modeler"
el amarradero	"mooring, berth, moorage"
*** 3991 - 4000 (/course/195613/spanish-nouns-4/397/)	
el victimario	victimizer
el gritito	yelp
la veladura	glazing
el setter	setter
el decibel	decibel
la descubridora	"discoverer, finder"
el repente	start
(el)(la) financista	financier
la generalizadora	generalizing
la hostelera	"owner, innkeeper"
*** 3981 - 3990 (/course/195613/spanish-nouns-4/398/)	
(los)(las) somalíes	"Somali, Somalian"
el cuentakilómetros	"speedometer, odometer, milometer"
el estereoscopio	stereoscope
(el)(la) subcontratista	subcontractor
las subzonas	subzones
la pella	"suet, lard, debt"
la sumadora	summing
los tardígrados	tardigrades
la atormentadora	tormenting
el atormentador	tormentor
*** 3951 - 3960 (/course/195613/spanish-nouns-4/399/)	
la miocarditis	myocarditis
la tirilla	neckband
(los)(las) nihilistas	nihilist
la chorrada	"nonsense, silly comment, clutter"
los odonatos	Odonata
el oloroso	oloroso
(el)(la) ovetense	Oviedo
los chícharos	pea
la pletina	platen
el politiqueo	"political jobbery, party politics"
*** 3971 - 3980 (/course/195613/spanish-nouns-4/400/)	
el romántico	romantic
la andana	"row, swath, line"
el bocata	sandwich
el santanderino	Santander
el escafoides	scaphoid
el diecisiete	"seventeen, seventeenth"
el esquilador	"shearer, sheepshearer"
la escota	sheet
el simplón	"simpleton, nitwit"
el retal	snippet
*** 4001 - 4010 (/course/195613/spanish-nouns-4/401/)	
el iberoamericano	Latin American
la liquidadora	liquidator
la mercenaria	"mercenary, hireling"
el mainel	mullion
(el)(la) plaguicida	pesticide
la provinciana	"provincial, countryman, country dweller"
la prusiana	Prussian
la puerca	"pig, hog"
la tísica	consumptive
(el)(la) depositante	depositor
*** 4011 - 4020 (/course/195613/spanish-nouns-4/402/)	
la algalia	civet
el ecléctico	eclectic
el enervamiento	enervation
el magnolio	magnolia
la religiosa	nun
la aguijada	goad
la alevosa	treacherous
la anestesiología	anesthesiology
el anisete	anisette
el arráez	Arráez
*** 4021 - 4030 (/course/195613/spanish-nouns-4/403/)	
el arrebatamiento	"snatching away, seizure, captivation"
el averno	shades
la avilantez	audacity
el bacará	baccarat
la brotación	sprouting
el caldito	broth
el capibara	capybara
la casia	cassia
la chinga	"butt, beating, hiding"
la ciática	sciatica
*** 4031 - 4040 (/course/195613/spanish-nouns-4/404/)	
la ciclotimia	cyclothymia
la cistina	cystine
la cleptomanía	"kleptomania, kleptomaniac"
la cocinilla	stove
el constitutivo	constituent element
la contractilidad	contractility
el cuatrimestre	"triannual, four-month period"
el desangramiento	bleeding
el descoco	shamelessness
el descompresor	decompressor
*** 4041 - 4050 (/course/195613/spanish-nouns-4/405/)	
la diabasa	diabase
la encimera	"worktop, countertop"
la endemia	endemic
el entrometido	"busybody, meddler"
el entrometimiento	"interference, obtrusion, meddlesomeness"
el ergotismo	ergotism
la exigüidad	exiguity
la falsación	falsification
el favorcito	little favor
la fracturación	fracturing
*** 4051 - 4060 (/course/195613/spanish-nouns-4/406/)	
el gastroenterólogo	gastroenterologist
la gnomónica	gnomonic
el granjeo	earned
el hipocausto	hypocaust
el idiolecto	idiolect
la impenitencia	impenitence
la intermediaria	"intermediate, intermediary, middleman"
(el)(la) junior	"junior, rich boy"
el lebeche	libeccio
el limosnero	"almoner, purse, coin purse"
*** 4071 - 4080 (/course/195613/spanish-nouns-4/407/)	
el palmoteo	clap
el pangolín	pangolin
la petrología	petrology
la picha	"bit, iota, dick"
el pirómetro	pyrometer
la podología	chiropody
la previsora	sighted
el príamo	Priam
el radiogoniómetro	direction-finder
el rebobinado	rewinding
*** 4061 - 4070 (/course/195613/spanish-nouns-4/408/)	
la luminotecnia	lighting
la macrocefalia	macrocephaly
el marabú	"marabou, adjutant"
la mayordoma	Mistress
el melanismo	melanism
el mohair	mohair
la mosquetería	musketry
el muecín	muezzin
la nuclearización	nuclearization
la orquestra	orchestra
*** 4091 - 4100 (/course/195613/spanish-nouns-4/409/)	
la vulcanología	volcanology
la restinga	"sandbar, shoal, mud bank"
el guarnicionero	"leather worker, leather craftsperson, harness maker"
(el)(la) golpista	coup participant
el licitador	"bidder, auctioneer"
los abisinios	Abyssinian
los algonquinos	Algonquin
la azagaya	assegai
el babilonio	Babylonian
la ajorca	bangle
*** 4081 - 4090 (/course/195613/spanish-nouns-4/410/)	
la reología	rheology
la retrospección	"retrospect, retrospection"
la robotización	robotization
la sacarina	"saccharine, saccharin"
la sextilla	sextuplet
la temporalización	temporalization
la tonelería	cooperage
el tóner	toner
(el)(la) utilitarista	utilitarian
la verdea	turns green
*** 4101 - 4110 (/course/195613/spanish-nouns-4/411/)	
los barbitúricos	barbiturates
el abejero	beekeeper
la bloqueadora	blocking
el sobresueldo	bonus
el bóvido	bovid
el desposado	bridegroom
el guapo	"bully, tough guy"
el topetazo	butt
el cauterio	cautery
la coroides	choroid
*** 4121 - 4130 (/course/195613/spanish-nouns-4/412/)	
la bandería	faction
el ricachón	filthy rich man
la frutera	fruit dish
los tahures	"gambler, blackleg"
la gestapo	gestapo
el glucósido	glucoside
la pintada	"graffiti, guinea-fowl"
el gruñón	"grouch, grumbler"
el borbotón	"gush, burble, bubbling"
el hematólogo	"haematologist, hematologist"
*** 4111 - 4120 (/course/195613/spanish-nouns-4/413/)	
(el)(la) comunista	communist
el cornejo	cornel
el aduanero	customs officer
el difamador	defamer
el desfibrilador	defibrillator
la insulsez	dullness
la eflorescencia	efflorescence
el emolumento	emolument
la enteritis	enteritis
el ojete	"eyelet, coward, asshole"
*** 4131 - 4140 (/course/195613/spanish-nouns-4/414/)	
el alción	halcyon
la cabezuela	head of the flower
la hiperhidrosis	hyperhidrosis
la moradora	"inhabitant, denizen"
el invertebrado	invertebrate
la isoterma	isotherm
(el)(la) kitsch	kitsch
la curda	Kurdish
la cántara	large pitcher
el legatario	legatee
*** 4141 - 4150 (/course/195613/spanish-nouns-4/415/)	
el liberiano	Liberian
el libio	Libyan
el mogollón	"loads, heaps, fuss"
el luminar	luminal
el maquillador	"makeup artist, makeup man"
las albondiguillas	meatballs
(los)(las) madianitas	Midianites
el laminador	mill
la mimosa	"mimosa, sensitive plant, touch-me-not"
(el)(la) miniaturista	miniaturist
*** 4151 - 4160 (/course/195613/spanish-nouns-4/416/)	
el multicolor	"multicolor, multicolour"
la murmuradora	murmuring
el parmesano	Parmesan
la petunia	petunia
la pictografía	"pictography, pictograph, picture writing"
el acerico	pincushion
el vergajo	pizzle
los politiqueros	politicians
el granado	pomegranate
el pompón	Pompon
*** 4161 - 4170 (/course/195613/spanish-nouns-4/417/)	
el pornógrafo	pornographer
el presumido	poseur
el disoluto	"profligate, debauchee"
los fruncidos	pursed
el agostadero	rangeland
el dimisionario	resigned
la escaleta	rundown
el saladar	"saltings, alkali soil"
la semicorchea	semiquaver
la sensitiva	sensitive plant
*** 4171 - 4180 (/course/195613/spanish-nouns-4/418/)	
el picapleitos	"shyster, pettifogger"
el dormilón	"sleepyhead, easy chair"
el portaligas	suspender belt
el esgrimidor	"swordsman, fencer"
la tachuela	"tack, thumbtack"
el comején	"termite, fire ant"
la tumoración	tumor
la unitaria	unit
el vulgarismo	vulgarism
la quejumbre	whine
*** 4181 - 4190 (/course/195613/spanish-nouns-4/419/)	
el pipiolo	"youngster, novice, tyro"
la albanesa	Albanian
el chabacano	apricot
la antepasada	ancestor
la jibia	cuttlefish
la licorera	decanter
la despilfarradora	spendthrift
la donadora	donor
la cebadura	fattening
la mantenedora	maintainer
*** 4191 - 4200 (/course/195613/spanish-nouns-4/420/)	
el macillo	hammer
la magulladura	bruise
el pandemonio	pandemonium
la mamola	chuck
la predicadora	preacher
el suflé	souffle
el avisador	timer
la usuaria	user
el toxicómano	drug addict
(el)(la) siquiatra	psychiatrist
*** 4231 - 4240 (/course/195613/spanish-nouns-4/421/)	
el celacanto	coelacanth
la chupeta	"Peruvian tunic, lollipop, roundhouse"
el clac	"opera hat, crushhat"
la claqueta	clapperboard
la colchicina	colchicine
el coquetismo	coquetry
la cordita	cordite
la credencia	credence
el cuatrillón	quadrillion
el demógrafo	demographer
*** 4211 - 4220 (/course/195613/spanish-nouns-4/422/)	
el samaritano	Samaritan
el zaragozano	Zaragoza
la adhesividad	adhesiveness
el afeminamiento	effeminacy
el alizar	Alizar
la apatita	apatite
la areca	"areca, betel nut"
la asparagina	asparagine
la astringencia	astringency
el atontamiento	stunning
*** 4201 - 4210 (/course/195613/spanish-nouns-4/423/)	
los boloñeses	Bolognese
el checheno	Chechen
la regidora	Councillor
el corintio	Corinthian
la desforestación	deforestation
el inmunólogo	immunologist
el lombardo	Lombard
la mamaíta	Mommy
el palentino	Palencia
el rescatador	rescuer
*** 4221 - 4230 (/course/195613/spanish-nouns-4/424/)	
el avenamiento	drainage
el azaque	zakat
el barrenero	driller
el bastoncito	"cane, walking stick, baton"
la benefactora	benefactress
el bisbiseo	whispering
el bureo	razzle
el calafateo	calk
el cantonés	canton
el cardenillo	verdigris
*** 4241 - 4250 (/course/195613/spanish-nouns-4/425/)	
la digestibilidad	digestibility
(el)(la) diletante	"dilettante, dabbler"
la disimilación	dissimilation
el dujo	duced
la electrotecnia	electrical engineering
el embelesamiento	rapture
el empalagoso	sickly sweet
el entrehierro	"air gap, spark gap"
el epicúreo	"epicurean, gourmet"
la erogación	outlay
*** 4251 - 4260 (/course/195613/spanish-nouns-4/426/)	
el esculapio	Aesculapius
el étimo	etymon
el externado	externship
(el)(la) farfulla	"jabber, sputter, babbling"
la finalísima	finals
la fotosensibilidad	photosensitivity
el fulcro	fulcrum
el funículo	funiculus
la greca	border
la harinera	flour mill
*** 4271 - 4280 (/course/195613/spanish-nouns-4/427/)	
el maltusianismo	Malthusianism
la mandataria	"leader, attorney"
la mendacidad	mendacity
el natural	"native, nature"
la necromancia	necromancy
el neocórtex	neocortex
la neuroanatomía	neuroanatomy
el obscurantismo	obscurantism
la obsequiosidad	obsequiousness
la orientadora	"career advisor, counsellor"
*** 4261 - 4270 (/course/195613/spanish-nouns-4/428/)	
la heredada	inherited
el hermafroditismo	hermaphroditism
la hiperestesia	hyperesthesia
la histerectomía	hysterectomy
la irreligiosidad	irreligion
la jugosidad	"fruitiness, sappiness"
la juzgadora	judging
la laureola	spurge laurel
el limitador	limiter
la limonita	limonite
*** 4301 - 4310 (/course/195613/spanish-nouns-4/429/)	
la tetania	tetany
la tontina	tontine
el tranquillo	knack
la traspuesta	transposition
la treonina	threonine
la veranda	"veranda, verandah"
la vertedera	moldboard
el vindicador	vindicator
la zafiedad	rudeness
el zapoteco	Zapotec
*** 4281 - 4290 (/course/195613/spanish-nouns-4/430/)	
la ortoclasa	orthoclase
el pangermanismo	Pan-Germanism
la pelagra	pellagra
la perentoriedad	"peremptoriness, instancy"
la piamadre	pia mater
el pífano	fife
la prefabricación	prefabrication
el pudín	pudding
la recula	recoils
el refrescamiento	cooling
*** 4321 - 4330 (/course/195613/spanish-nouns-4/431/)	
la chancha	"sow, small wooden cart, bike"
el evaluador	assessor
el atalaje	"team, team of horses"
el contralto	"alto, contralto"
el amonites	ammonites
la andina	Andean
la iracunda	angry
la anquilosis	"ankylosis, anchylosis"
el mogote	antler
el artrópodo	arthropod
*** 4291 - 4300 (/course/195613/spanish-nouns-4/432/)	
el regador	"irrigator, watering can"
la retentiva	retentive
la roldana	sheave
la semicircunferencia	semicircumference
la sobreimpresión	overprint
el subnivel	sublevel
el sueñecito	"nap, catnap"
el tambaleo	"stagger, lurch, sway"
la tarjetita	little card
la terribilidad	terribleness
*** 4311 - 4320 (/course/195613/spanish-nouns-4/433/)	
el placaje	tackle
la congratulación	congratulation
el guache	"rustic, peasant, hick"
el captador	sensor
la marisabidilla	know-all
la pescada	hake
el cafetero	"coffee grower, coffee planter"
el improperio	insult
la quisquilla	shrimp
(el)(la) tratadista	writer
*** 4331 - 4340 (/course/195613/spanish-nouns-4/434/)	
(el)(la) ascendente	ascendant
el cenizo	"ashen, jinx"
la azalea	azalea
el mochilero	backpacker
(el)(la) bautista	baptist
los cirrípedos	barnacles
los devenires	becomings
los estores	Blinds
la criadora	brooder
el verderón	"bunting, ortolan"
*** 4361 - 4370 (/course/195613/spanish-nouns-4/435/)	
la excomulgada	excommunicated
la expositora	exhibiting
el alimentador	"feeder, feed"
el franchute	"frog, froggy"
(el)(la) genealogista	genealogist
el ginebrino	Genevan
el gerifalte	gerfalcon
la habitud	habitude
el hawaiano	Hawaiian
la hemocromatosis	hemochromatosis
*** 4341 - 4350 (/course/195613/spanish-nouns-4/436/)	
los carnales	carnal
el chárter	charter
el extensor	chest expander
las clarisas	Clare
la clemátide	clematis
las faldillas	"coat-tails, tail"
la plebeya	"commoner, plebeian, pleb"
la compresa	"compress, sanitary napkin, pack"
(el)(la) conformista	conformist
el contribuidor	contributor
*** 4371 - 4380 (/course/195613/spanish-nouns-4/437/)	
la tenedora	holding
el cóncavo	"hollow, cavity"
el hipnótico	hypnotic
la plaquita	insert
la trapisonda	"intrigue, swindle, scuffle"
la cogujada	Lark
el linimento	liniment
el megavatio	megawatt
el malogro	"miscarriage, failure"
los monotremas	monotremes
*** 4351 - 4360 (/course/195613/spanish-nouns-4/438/)	
el discutidor	controversialist
el consocio	copartner
la definidora	defining
el disimulador	"dissembler, dissimulator"
la trainera	drifter
los resecos	dry
el volquete	"dump truck, dumper, tipper lorry"
la espaldera	"espalier, trellis, wall bars"
los evasores	evaders
el efugio	"evasion, subterfuge"
*** 4391 - 4400 (/course/195613/spanish-nouns-4/439/)	
los fócidos	phocids
el alfilerazo	"pinprick, prick"
la meada	piss
el plagiario	"plagiarist, plagiary"
las caquitas	poop
el propiciador	propitiator
la pústula	"pustule, blotch"
el retrovisor	"rearview, rear mirror"
el juncal	reed bed
el reps	rep
*** 4401 - 4410 (/course/195613/spanish-nouns-4/440/)	
la encuestada	respondent
la hueva	"roe, hard roe, spawn"
el lija	"sandpaper, dogfish"
el sardo	Sardinian
el raspador	"scraper, rasp"
la carilla	"side, side of paper, veneer"
la simia	simian
(los)(las) simples	simple
el eslizón	skink
la babucha	"slipper, mule, sleeper"
*** 4381 - 4390 (/course/195613/spanish-nouns-4/441/)	
los escopeteros	musketeers
el mitólogo	mythologist
(el)(la) narcisista	narcissist
(los)(las) norvietnamitas	North Vietnamese
el numerario	"numerary, member"
la osteoartritis	osteoarthritis
el oxalato	oxalate
los papeles	papers
la pagadora	paying
el afilador	"pencil sharpener, sharpener"
*** 4411 - 4420 (/course/195613/spanish-nouns-4/442/)	
la tría	sorting
el rociador	sprayer
el nublado	"storm cloud, threat"
la sobrevesta	surcoat
el porquerizo	swineherd
el pichel	tankard
los tasios	Tasios
la lanzada	thrust
el gamberro	"thug, hooligan, thuggish"
la tiroiditis	thyroiditis
*** 4421 - 4430 (/course/195613/spanish-nouns-4/443/)	
(el)(la) lameculos	"toady, smoothie, bootlicker"
el toreador	toreador
el rodado	track
el ugandés	Ugandan
el descarrío	waywardness
los atuneros	tuna
la católica	Catholic
el lacito	bow tie
la feligresa	parishioner
la lisonjera	flatterer
*** 4491 - 4500 (/course/195613/spanish-nouns-4/444/)	
la laparotomía	laparotomy
la leonesa	Leon
el limoneno	limonene
el ludo	ludo
la macedonia	"Macedonia, fruit salad"
el magenta	magenta
la maleficencia	maleficence
la maletita	suitcase
el mambrú	Mambrú
el mecate	"rope, cord"
*** 4431 - 4440 (/course/195613/spanish-nouns-4/445/)	
la mentirosa	"liar, deceiver"
la misionera	missionary
(el)(la) neandertal	Neanderthal
la neerlandesa	Netherlander
la rockera	rocker
la sarracena	Saracen
la certificadora	certification
el trinitario	Trinitarian
el abrasivo	abrasive
el acicalamiento	grooming
*** 4471 - 4480 (/course/195613/spanish-nouns-4/446/)	
el desollador	skinner
el despertamiento	"awakening, revival"
la dietética	dietetics
la disneylandia	disneyland
el echarpe	"shawl, scarf"
el encaprichamiento	whimsy
la esteva	"plowtail, ploughtail"
la estrafalaria	quirky
el fenobarbital	phenobarbital
la filmadora	imagesetter
*** 4441 - 4450 (/course/195613/spanish-nouns-4/447/)	
la acidia	acedia
el acorralamiento	round-up
la advección	advection
el agutí	agouti
el andantino	andantino
el angor	angina
el antejuicio	impeachment
el apagamiento	quenching
la automación	automation
la autopolinización	selfing
*** 4451 - 4460 (/course/195613/spanish-nouns-4/448/)	
el barrón	Marram
la biofísica	biophysics
el calicó	calico
el campaneo	chime
(el)(la) capricornio	Capricorn
la caracterología	characterology
el cariñito	sweetie
la causticidad	"causticity, acridity"
la centaura	Knapweed
el charlestón	Charleston
*** 4481 - 4490 (/course/195613/spanish-nouns-4/449/)	
el fototropismo	phototropism
el fuet	conceited
el galvanismo	galvanism
el glucocorticoide	glucocorticoid
la gravimetría	gravimetry
la inculpabilidad	innocence
la indagadora	inquiring
la insaciabilidad	insatiability
la jareta	seines
el jurisperito	jurist
*** 4511 - 4520 (/course/195613/spanish-nouns-4/450/)	
la pechblenda	pitchblende
el pichoncito	pigeon
el pinabete	hemlock
el pirograbado	"pyrography, pyrogravure"
el pirronismo	Pyrrhonism
la pituitaria	pituitary
la pollería	poulterer's shop
el prerrafaelismo	pre-Raphaelitism
el proconsulado	proconsulate
la progenitura	offspring
*** 4461 - 4470 (/course/195613/spanish-nouns-4/451/)	
la chasca	"brushwood, mop of hair"
la clavazón	nailing
el cloral	chloral
la coligación	colligation
el colodión	collodion
la combustibilidad	combustibility
la conminación	injunction
el coproductor	co-producer
la cromita	chromite
la dedada	"dab, pinch"
*** 4501 - 4510 (/course/195613/spanish-nouns-4/452/)	
el meconio	meconium
la metalistería	metalwork
el mimeógrafo	mimeograph
la moduladora	modulating
el molimiento	achiness
el moscatel	"muscat, muscatel"
el mújol	mullet
la noguera	walnut
el notocordio	notochord
el panamericanismo	Pan-Americanism
*** 4531 - 4540 (/course/195613/spanish-nouns-4/453/)	
el sinsonte	mockingbird
la somatización	somatization
el subreino	subkingdom
la subrogada	surrogate
la termometría	thermometry
la translucidez	translucence
la tuberculina	tuberculin
la ucrania	Ukraine
la ultraviolencia	ultraviolence
el vigués	Vigo
*** 4521 - 4530 (/course/195613/spanish-nouns-4/454/)	
la psicoquinesia	psychokinesis
la quincallería	ironmongery
el radiograma	radiogram
la retroventa	resale
el salsero	salsa
el saturnismo	"saturnism, lead poisoning, plumbism"
la senescalía	senechaussee
la seropositividad	seropositivity
(el)(la) sevillista	Sevilla
el silabeo	"syllabication, syllabification"
*** 4551 - 4560 (/course/195613/spanish-nouns-4/455/)	
el embotellado	bottling
las briquetas	briquettes
las cantiñas	"canteen, cantina, buffet"
la alcaparra	caper
la cariátide	caryatid
(el)(la) centralista	centralist
la fullería	"cheating, cardsharping"
el callejero	"city street guide, street map"
(el)(la) clasicista	classicist
el zueco	"clog, sabot, patten"
*** 4561 - 4570 (/course/195613/spanish-nouns-4/456/)	
la hormigonera	"concrete mixer, cement mixer"
los confucianos	Confucian
el dializador	dialyzer
la putada	"dirty trick, nasty trick, bastard of a trick"
el desaparecimiento	disappearance
la chochez	dotage
las orejeras	earmuff
la puñeta	"edging, trim, damn it"
el embalsamador	embalmer
las témporas	Ember
*** 4541 - 4550 (/course/195613/spanish-nouns-4/457/)	
(el)(la) avalista	guarantor
el batelero	boatman
(el)(la) costumbrista	writer specializing in local customs
el comisariato	administrative office
la afiliada	affiliated
el anofeles	anopheles
(el)(la) autista	"autistic, autistic person"
la bachillera	"bachelor, graduate"
los vascongados	Basques
el cospel	"blank, planchet"
*** 4601 - 4610 (/course/195613/spanish-nouns-4/458/)	
el revistero	magazine rack
la mastitis	mastitis
el metaloide	metalloid
el metatórax	metathorax
el microgramo	microgram
el conchero	midden
la motonave	motor ship
el murmurio	murmur
la mixomatosis	myxomatosis
el perdulario	ne'er-do-well
*** 4571 - 4580 (/course/195613/spanish-nouns-4/459/)	
la ensaimada	ensaimadas
el sobre	envelope
la epifonema	epiphoneme
(los)(las) epirotas	Epirotes
la exudación	exudation
(el)(la) fatalista	fatalist
la guedeja	"forelock, lock"
el frisón	Frisian
el fumigador	fumigator
el genital	genital
*** 4581 - 4590 (/course/195613/spanish-nouns-4/460/)	
la molleja	"gizzard, sweetbread"
el guantero	Glover
(los)(las) buscavidas	"go-getter, meddler, snooper"
el grafólogo	graphologist
la gramínea	grass
los hamos	Hamos
los henares	"hayfield, hayloft"
el chalán	horsedealer
(el)(la) onubense	Huelva
el achuchón	hugs
*** 4591 - 4600 (/course/195613/spanish-nouns-4/461/)	
los icneumónidos	ichneumonids
(el)(la) imperialista	imperialist
los jebuseos	Jebusites
el hervidor	"kettle, boiler"
el celeste	"light blue, sky blue"
el belfo	lip
(el)(la) radioescucha	listener
el bracito	little arm
el luso	Luso
la macis	mace
*** 4611 - 4620 (/course/195613/spanish-nouns-4/462/)	
el orix	oryx
el serón	pannier
la peticionaria	petitioner
el enchapado	"plating, veneer"
el poetastro	poetaster
el pámpano	"pompano, shoot, tendril"
el pollero	"poulterer, poultry dealer"
los sinapismos	poultices
la ptosis	ptosis
la chincheta	"pushpin, drawing pin, tack"
*** 4621 - 4630 (/course/195613/spanish-nouns-4/463/)	
la pirosis	pyrosis
el ranúnculo	"ranunculus, crowfoot"
el galopín	"rascal, tyke, mudlark"
los historiales	"record, background"
la gallineta	redfish
el reparador	"repairer, repairman, mender"
las revisiones	"review, revision, overhaul"
el sasafrás	sassafras
el sajón	"Saxon, person from Saxony"
el lacre	sealing wax
*** 4641 - 4650 (/course/195613/spanish-nouns-4/464/)	
el descreído	"unbeliever, disbeliever, misbeliever"
el descargador	unloader
(el)(la) arribista	"upstart, arriviste, pusher"
(el)(la) veraneante	vacationer
las minivacaciones	vacay
el vitoriano	Vitoria
la zorrita	Vixen
el vagido	wail
la lastimadura	"wound, injury, wounding"
la agrónoma	"agronomist, agriculturalist, agriculturist"
*** 4651 - 4660 (/course/195613/spanish-nouns-4/465/)	
la alicantina	Alicante
el ligustro	privet
la avasalladora	overwhelming
la casera	landlord
el geiser	geyser
la latinoamericana	Latin American
el moratón	bruise
la neoyorquina	New Yorker
la norteamericana	"American, North American"
la panameña	Panamanian
*** 4631 - 4640 (/course/195613/spanish-nouns-4/466/)	
la secoya	"sequoia, redwood"
la rociada	"spray, sprinkling, sprinkle"
el quitamanchas	"stain remover, cleaner, stain-remover"
la grapadora	stapler
los almidonados	starched
la estomatitis	stomatitis
la infravivienda	substandard housing
la ringlera	swath
el templario	templar
la triquinosis	trichinosis
*** 4681 - 4690 (/course/195613/spanish-nouns-4/467/)	
la asafétida	asafoetida
(el)(la) autoestopista	Hitchhiker
la auvernia	auvergne
el avéstico	Avestan
el avetoro	bittern
la bacinica	potty
el beige	"beige, fawn"
el benzoato	benzoate
el cambray	chambray
la cartomancia	cartomancy
*** 4661 - 4670 (/course/195613/spanish-nouns-4/468/)	
la piruleta	lollipop
la soñadora	"dreamer, daydreamer"
la toledana	Toledo
las trinitarias	Trinitarian
el volframio	"wolfram, tungsten"
la visionaria	visionary
la cellisca	sleet
el deformador	deforming
el preñado	pregnancy
el acetilo	acetyl
*** 4691 - 4700 (/course/195613/spanish-nouns-4/469/)	
la cenestesia	cenesthesia
el chateo	pub crawl
la cholla	"nut, nob"
la comemierda	asshole
el comercialismo	commercialism
la corticotropina	corticotropin
el cuatrimotor	quad
la depre	depression
la desga	Desga
la desmineralización	demineralization
*** 4671 - 4680 (/course/195613/spanish-nouns-4/470/)	
la adjunción	attachment
el agolpamiento	"throng, crush"
(el)(la) aislante	"insulation, insulator"
la aleurona	aleurone
la alopatía	allopathy
el ambo	"ambo, two-piece suit"
el antecristo	Antichrist
la antroponimia	anthroponymy
el aplacamiento	"satisfaction, propitiation"
el armarito	cabinet
*** 4721 - 4730 (/course/195613/spanish-nouns-4/471/)	
la indocilidad	intractability
la insolubilidad	"insolubility, intractability"
(el)(la) internista	internist
el jopo	broomrape
el kéfir	kefir
el macramé	"macrame, macramé"
(el)(la) manchú	Manchu
la marchitez	"wilting, withering"
la minicumbre	mini-summit
el monillo	Monilla
*** 4701 - 4710 (/course/195613/spanish-nouns-4/472/)	
el despachador	dispatcher
la desprogramación	deprogramming
la diamina	diamine
la disfuncionalidad	dysfunctionality
el druidismo	Druidry
la engolfa	engulfs
el envaramiento	"numbness, stiffness"
el excurso	excursus
la expansividad	expansiveness
(el)(la) facial	face value
*** 4711 - 4720 (/course/195613/spanish-nouns-4/473/)	
la flacidez	sagging
la formica	formica
la geofagia	geophagy
el gordinflón	"chubby, roly-poly, podgy"
el hexaedro	hexahedron
el hiperónimo	hypernym
el huecograbado	gravure
la imprimación	primer
la inatención	inattention
la indiana	printed calico
*** 4731 - 4740 (/course/195613/spanish-nouns-4/474/)	
la montadora	mounter
el naftaleno	naphthalene
el nativismo	nativism
el negror	blackness
la neguilla	corn cockle
la nitración	nitration
el nono	"ninth, drip"
la observadora	"observer, spotter"
la palinología	palynology
el paneslavismo	Pan-Slavism
*** 4751 - 4760 (/course/195613/spanish-nouns-4/475/)	
la reumatología	rheumatology
la revisita	revisits
la rotenona	rotenone
el salacot	pit helmet
la santiguada	sign of the Cross
la secretina	secretin
el sensorial	sensory
la sobredeterminación	overdetermination
la soñolencia	sleepiness
la supinación	supination
*** 4771 - 4780 (/course/195613/spanish-nouns-4/476/)	
el mudo	"dumb, mute, silent"
(el)(la) nutricionista	nutritionist
(el)(la) hablista	"good speaker, elegant user of language"
la desgarradura	tearing
(el)(la) abolicionista	abolitionist
(el)(la) ausente	"absentee, missing person"
el acrílico	acrylic
el alejandrino	Alexandrine
el aluminato	aluminate
el brazal	armband
*** 4781 - 4790 (/course/195613/spanish-nouns-4/477/)	
la arteriola	arteriole
el cesionario	"assignee, assign"
el asirio	Assyrian
(los)(las) atomistas	atomistic
la avitaminosis	avitaminosis
el cabezón	big head
los biopolímeros	biopolymers
(el)(la) chantajista	"blackmailer, racketeer"
el trompetazo	blare
la mamada	"blow job, suck, breastfeeding"
*** 4791 - 4800 (/course/195613/spanish-nouns-4/478/)	
la carda	"card, comb"
el caribeño	Caribbean
el castrado	castrate
la colelitiasis	cholelithiasis
las trepadoras	"climber, nuthatch"
el sufrido	complaisant husband
el cínico	"cynic, shameless person"
el decurión	decurion
(el)(la) disciplinante	disciplining
el desinfectante	disinfectant
*** 4801 - 4810 (/course/195613/spanish-nouns-4/479/)	
la disimilitud	"dissimilarity, dissimilitude"
la perforadora	"drill, punch, puncher"
(los)(las) ebionitas	Ebionites
la angula	elver
la enredadora	entangler
la arrastrada	entrained
el escondido	Escondido
la esofagitis	esophagitis
(el)(la) fabulista	fabulist
los abetales	fir
*** 4831 - 4840 (/course/195613/spanish-nouns-4/480/)	
la nonada	nothingness
la oprimida	oppressed
el similor	ormolu
el sobrestante	Overseer
el paquidermo	pachyderm
la hombrera	"pad, shoulder pad, epaulet"
la palizada	palisade
la empanadilla	"patty, small pasty, small turnover"
el pavón	peacock butterfly
el penitenciario	"penitentiary, confessor"
*** 4811 - 4820 (/course/195613/spanish-nouns-4/481/)	
la hojuela	"flake, leaflet, foil"
el saborizante	flavoring
la dedalera	foxglove
la tragaperras	"fruit machine, slot machine, one-armed bandit"
el cardillo	golden thistle
la verdulería	"greengrocery, fruit shop, greengrocer's"
(el)(la) hermafrodita	hermaphrodite
el hercio	hertz
el hesperidio	hesperidium
el conchabado	in cahoots
*** 4851 - 4860 (/course/195613/spanish-nouns-4/482/)	
el tostador	roaster
el bisoño	"rookie, greenhorn"
las arraigadas	rooted
las rutáceas	Rutaceae
el salicilato	salicylate
el saurio	saurian
el escolástico	"scholastic, schoolman"
(el)(la) semifinalista	semifinalist
los cequíes	sequins
la somera	shallow
*** 4741 - 4750 (/course/195613/spanish-nouns-4/483/)	
el pantallazo	screenshot
la pirimidina	pyrimidine
el poblacho	"dump, hole"
el prepósito	superior
el pretorio	"praetorium, pretorium"
el priapismo	priapism
la psicofarmacología	psychopharmacology
la puritana	Puritan
la rebatiña	"scramble, rush"
el refunfuño	grumble
*** 4821 - 4830 (/course/195613/spanish-nouns-4/484/)	
el inhalador	"inhaler, inhalant"
la cocha	kocha
la cargadora	loader
los palangreros	longliners
el barbado	"lower jaw, tree, chin-piece"
el magnetizador	magnetizer
el mamón	"mammon, sucker, suckling"
el megatón	megaton
el incomprendido	misunderstood person
(el)(la) inconformista	nonconformist
*** 4761 - 4770 (/course/195613/spanish-nouns-4/485/)	
la taciturnidad	taciturnity
el tarareo	hum
la tontita	silly
el trole	trolley
la velación	"veiling ceremony, nuptial benediction, veiling"
el vocalismo	vocalism
el mellizo	twin
el borceguí	"high shoe, laced boot, bootee"
el veinteañero	person in their twenties
el afrodisíaco	aphrodisiac
*** 4841 - 4850 (/course/195613/spanish-nouns-4/486/)	
el perforador	perforator
el frigio	Phrygian
la piastra	"piastre, piaster"
el ananá	"pineapple tree, pineapple"
el velludo	"plush, velvet"
el podólogo	"podiatrist, chiropodist"
(el)(la) europeísta	Pro-European
el prolegómeno	prolegomenon
el guisote	ratatouille
la sonaja	"rattle, jingle"
*** 4891 - 4900 (/course/195613/spanish-nouns-4/487/)	
el resucitador	respirator
el shekel	shekel
la mopa	mop
el albaceteño	Albacete
el algodonero	cotton grower
el chapucero	bungler
la fraternización	fraternization
el coy	hammock
la pancita	tripe
el panículo	panicle
*** 4871 - 4880 (/course/195613/spanish-nouns-4/488/)	
la sicosis	sycosis
el tronido	"thunderclap, thunder, boom"
la tortuosidad	tortuosity
el veinticuatro	twenty-four
el damnificado	victim
la visitadora	visiting
la cuchufleta	wisecrack
la ganada	won
la gusanera	worms
la camionera	truck driver
*** 4861 - 4870 (/course/195613/spanish-nouns-4/489/)	
la contraventana	shutter
la dermatosis	skin disease
la nevasca	snowstorm
(los)(las) sodomitas	sodomites
el engreído	"spoiled brat, swelled head"
la estereotipia	stereotyping
el estoma	stoma
la forastera	"stranger, outsider, visitor"
la gilipollez	"stupid comment, stupid act, nonsense"
(el)(la) submarinista	"submariner, frogman"
*** 4881 - 4890 (/course/195613/spanish-nouns-4/490/)	
la contrachapada	plywood
el telefax	facsimile
la guatemalteca	Guatemalan
los impedidos	disabled person
la libanesa	Lebanese
la lombarda	Lombard
la maníaca	maniac
la tortita	pancake
la polluela	"chick, baby bird, nestling"
el republicana	republican
*** 4901 - 4910 (/course/195613/spanish-nouns-4/491/)	
el urdidor	warping
la boloñesa	Bolognese
la acondroplasia	achondroplasia
el africanismo	Africanism
el antropoide	"anthropoid, anthropoid ape"
(el)(la) aprista	APRA supporter
la apuntación	"entry, note"
el aristarco	aristarch
la arteriografía	arteriography
el azotador	Lasher
*** 4921 - 4930 (/course/195613/spanish-nouns-4/492/)	
el crep	crepe
el cronógrafo	"stopwatch, chronograph"
la dactiloscopia	fingerprinting
el decágono	decagon
el demandador	plaintiff
el descorazonamiento	discouragement
el desolladero	renderer
la dexametasona	dexamethasone
el encabalgamiento	"support, frame, overlap"
el ensilado	ensilage
*** 4911 - 4920 (/course/195613/spanish-nouns-4/493/)	
el azur	azure
la baquelita	bakelite
la bioluminiscencia	bioluminescence
el botecito	little boat
el brécol	broccoli
el calentito	warm
el comburente	combustion
la contravigilancia	counter-surveillance
el corion	corium
la crasitud	fatness
*** 4941 - 4950 (/course/195613/spanish-nouns-4/494/)	
el gregarismo	gregariousness
la herbolaria	herbal
la iconoclasia	iconoclasm
el infantado	"appanage, apanage"
el interlineado	line spacing
la intraducibilidad	untranslatable
la jabonera	soap dish
el kayac	kayak
la lecha	"milt, soft roe"
la liofilización	lyophilization
*** 4931 - 4940 (/course/195613/spanish-nouns-4/495/)	
el equilibrismo	balancing
la escila	squill
el espectrofotómetro	spectrophotometer
la estaurolita	staurolite
la estenografía	stenography
el exantema	exanthema
la explicitud	explicitness
el factoraje	factoring
el furano	furan
el geco	gecko
*** 4951 - 4960 (/course/195613/spanish-nouns-4/496/)	
la loneta	thin canvas
el machaqueo	"crushing, pounding"
el manipuleo	handling
el máuser	Mauser
la miofibrilla	myofibril
la molaridad	molarity
el motivador	motivator
el naturismo	naturism
el nóbel	nobel
el olíbano	frankincense
*** 4971 - 4980 (/course/195613/spanish-nouns-4/497/)	
el puestito	cushy
el queloide	keloid
el rectificador	rectifier
el siríaco	Syriac
la subinspectora	Deputy Inspector
el ténder	tender
la toxemia	toxemia
el uzbeco	Uzbek
la valina	valine
(el)(la) violoncelista	"cellist, violoncellist"
*** 4961 - 4970 (/course/195613/spanish-nouns-4/498/)	
el ostensorio	monstrance
el paco	"paca, bale, pig"
la paprika	paprika
el pentotal	pentothal
el pestazo	stink
la pillada	"dirty trick, surprise revelation, surprise encounter"
la piperina	piperine
la policlínica	polyclinic
la procesadora	food processor
(el)(la) progre	progress
*** 4981 - 4990 (/course/195613/spanish-nouns-4/499/)	
la voladora	flying
la xerografía	xerography
la yaya	"boo boo, owie"
la pajilla	straw hat
los zunchos	"edge beam, ring beam, tie bar"
la digital	"foxglove, digitalis"
(el)(la) regatista	"yacht competitor, yachts person"
el afín	relation by marriage
el cortafrío	cold chisel
la adiposidad	adiposity
*** 4991 - 5000 (/course/195613/spanish-nouns-4/500/)	
el ailanto	ailanthus
la antocianina	anthocyanin
el anticoagulante	anticoagulant
el ateneo	athenaeum
el ajolote	axolotl
los bactrianos	Bactrian
(el)(la) recogepelotas	"ball boy, ball girl"
las balistas	ballistae
la dentellada	bite
el sangrador	bleeder
